,codigo_negociacao,data_referencia,release_date,ordinarias,preferenciais,totais
0,PATI3,2010-12-31,2011-04-01,8534,322,8856
1,PATI3,2011-03-31,2011-05-13,8534,322,8856
2,PATI3,2011-06-30,2011-08-11,8850,334,9184
3,PATI3,2011-09-30,2011-11-11,9135,345,9480
4,PATI3,2011-12-31,2012-03-20,9135,345,9480
5,PATI3,2012-03-31,2012-05-15,9135,345,9480
6,PATI3,2012-06-30,2012-08-14,9241,349,9590
7,PATI3,2012-09-30,2012-11-14,9423,355,9778
8,PATI3,2012-12-31,2013-03-08,9423,355,9778
9,PATI3,2013-03-31,2013-05-10,9423,355,9778
10,PATI3,2013-06-30,2013-08-13,9462,335,9797
11,PATI3,2013-09-30,2013-11-13,10785,679,11464
12,PATI3,2013-12-31,2014-03-18,11841,746,12587
13,PATI3,2014-03-31,2014-05-13,11841,746,12587
14,PATI3,2014-06-30,2014-08-12,13307,622,13929
15,PATI3,2014-09-30,2014-11-13,13307,622,13929
16,PATI3,2014-12-31,2015-03-05,15614,699,16313
17,PATI3,2015-03-31,2015-05-15,15614,699,16313
18,PATI3,2015-06-30,2015-08-13,15614,699,16313
19,PATI3,2015-09-30,2015-11-12,15614,699,16313
20,PATI3,2015-12-31,2016-03-18,15803,707,16510
21,PATI3,2016-03-31,2016-05-13,15803,707,16510
22,PATI3,2016-06-30,2016-08-15,15803,707,16510
23,PATI3,2016-09-30,2016-11-11,16572,742,17314
24,PATI3,2016-12-31,2017-03-17,16703,748,17451
25,PATI3,2017-03-31,2017-05-12,16703,748,17451
26,PATI3,2017-06-30,2017-08-11,16703,748,17451
27,PATI3,2017-09-30,2017-11-09,16703,748,17451
28,PATI3,2017-12-31,2018-02-26,16880,756,17636
29,PATI3,2018-03-31,2018-05-11,16880,756,17636
30,PATI3,2018-06-30,2018-08-15,16880,756,17636
31,PATI3,2018-09-30,2018-11-14,16880,756,17636
32,PATI3,2018-12-31,2019-02-28,17075,764,17839
33,PATI3,2019-03-31,2019-05-10,17075,764,17839
34,PATI3,2019-06-30,2019-08-13,17075,764,17839
35,PATI3,2019-09-30,2019-11-11,17075,764,17839
36,PATI3,2019-12-31,2020-02-28,17487,783,18270
37,PATI3,2020-03-31,2020-06-25,17487,783,18270
38,PATI3,2020-06-30,2020-08-26,17487,783,18270
39,PATI3,2020-09-30,2020-11-13,17487,783,18270
40,PATI3,2020-12-31,2021-02-26,17487,783,18270
41,PATI4,2010-12-31,2011-04-01,8534,322,8856
42,PATI4,2011-03-31,2011-05-13,8534,322,8856
43,PATI4,2011-06-30,2011-08-11,8850,334,9184
44,PATI4,2011-09-30,2011-11-11,9135,345,9480
45,PATI4,2011-12-31,2012-03-20,9135,345,9480
46,PATI4,2012-03-31,2012-05-15,9135,345,9480
47,PATI4,2012-06-30,2012-08-14,9241,349,9590
48,PATI4,2012-09-30,2012-11-14,9423,355,9778
49,PATI4,2012-12-31,2013-03-08,9423,355,9778
50,PATI4,2013-03-31,2013-05-10,9423,355,9778
51,PATI4,2013-06-30,2013-08-13,9462,335,9797
52,PATI4,2013-09-30,2013-11-13,10785,679,11464
53,PATI4,2013-12-31,2014-03-18,11841,746,12587
54,PATI4,2014-03-31,2014-05-13,11841,746,12587
55,PATI4,2014-06-30,2014-08-12,13307,622,13929
56,PATI4,2014-09-30,2014-11-13,13307,622,13929
57,PATI4,2014-12-31,2015-03-05,15614,699,16313
58,PATI4,2015-03-31,2015-05-15,15614,699,16313
59,PATI4,2015-06-30,2015-08-13,15614,699,16313
60,PATI4,2015-09-30,2015-11-12,15614,699,16313
61,PATI4,2015-12-31,2016-03-18,15803,707,16510
62,PATI4,2016-03-31,2016-05-13,15803,707,16510
63,PATI4,2016-06-30,2016-08-15,15803,707,16510
64,PATI4,2016-09-30,2016-11-11,16572,742,17314
65,PATI4,2016-12-31,2017-03-17,16703,748,17451
66,PATI4,2017-03-31,2017-05-12,16703,748,17451
67,PATI4,2017-06-30,2017-08-11,16703,748,17451
68,PATI4,2017-09-30,2017-11-09,16703,748,17451
69,PATI4,2017-12-31,2018-02-26,16880,756,17636
70,PATI4,2018-03-31,2018-05-11,16880,756,17636
71,PATI4,2018-06-30,2018-08-15,16880,756,17636
72,PATI4,2018-09-30,2018-11-14,16880,756,17636
73,PATI4,2018-12-31,2019-02-28,17075,764,17839
74,PATI4,2019-03-31,2019-05-10,17075,764,17839
75,PATI4,2019-06-30,2019-08-13,17075,764,17839
76,PATI4,2019-09-30,2019-11-11,17075,764,17839
77,PATI4,2019-12-31,2020-02-28,17487,783,18270
78,PATI4,2020-03-31,2020-06-25,17487,783,18270
79,PATI4,2020-06-30,2020-08-26,17487,783,18270
80,PATI4,2020-09-30,2020-11-13,17487,783,18270
81,PATI4,2020-12-31,2021-02-26,17487,783,18270
82,BAHI3,2010-12-31,2011-03-04,5451213,0,5451213
83,BAHI3,2011-03-31,2011-05-12,5451213,0,5451213
84,BAHI3,2011-06-30,2011-08-04,5996334,0,5996334
85,BAHI3,2011-09-30,2011-10-31,5996334,0,5996334
86,BAHI3,2011-12-31,2012-03-16,5996334,0,5996334
87,BAHI3,2012-03-31,2012-05-16,5996334,0,5996334
88,BAHI3,2012-06-30,2012-08-09,5996334,0,5996334
89,BAHI3,2012-09-30,2012-11-14,5996334,0,5996334
90,BAHI3,2012-12-31,2013-04-01,5996334,0,5996334
91,BAHI3,2013-03-31,2013-05-22,5996334,0,5996334
92,BAHI3,2013-06-30,2013-08-05,5996334,0,5996334
93,BAHI3,2013-09-30,2013-11-14,5996334,0,5996334
94,BAHI3,2013-12-31,2014-03-31,5996334,0,5996334
95,BAHI3,2014-03-31,2014-05-08,5996334,0,5996334
96,BAHI3,2014-06-30,2014-07-15,5996334,0,5996334
97,BAHI3,2014-09-30,2014-10-22,6038183,0,6038183
98,BAHI3,2014-12-31,2015-03-28,6038183,0,6038183
99,BAHI3,2015-03-31,2015-10-23,6038183,0,6038183
100,BAHI3,2015-06-30,2015-10-23,6038183,0,6038183
101,BAHI3,2015-09-30,2015-11-05,6038183,0,6038183
102,BAHI3,2015-12-31,2016-03-22,6038183,0,6038183
103,BAHI3,2016-03-31,2016-05-13,6038183,0,6038183
104,BAHI3,2016-06-30,2016-08-12,6038183,0,6038183
105,BAHI3,2016-09-30,2016-11-10,603818,0,603818
106,BAHI3,2016-12-31,2017-03-27,603818,0,603818
107,BAHI3,2017-03-31,2017-05-16,603818,0,603818
108,BAHI3,2017-06-30,2017-08-21,603818,0,603818
109,BAHI3,2017-09-30,2017-11-10,1171970,0,1171970
110,BAHI3,2017-12-31,2018-03-27,1171970,0,1171970
111,BAHI3,2018-03-31,2018-05-14,1171970,0,1171970
112,BAHI3,2018-06-30,2018-08-13,1171970,0,1171970
113,BAHI3,2018-09-30,2018-11-12,1171970,0,1171970
114,BAHI3,2018-12-31,2019-03-28,1171970,0,1171970
115,BAHI3,2019-03-31,2019-05-15,1171970,0,1171970
116,BAHI3,2019-06-30,2019-08-13,1171970,0,1171970
117,BAHI3,2019-09-30,2019-11-12,1171970,0,1171970
118,BAHI3,2019-12-31,2020-03-31,2219359,0,2219359
119,BAHI3,2020-03-31,2020-05-22,2219359,0,2219359
120,BAHI3,2020-06-30,2020-08-28,2219359,0,2219359
121,BAHI3,2020-09-30,2020-11-13,2219359,0,2219359
122,BBDC3,2010-12-31,2011-07-19,1881225,1881225,3762450
123,BBDC3,2011-03-31,2011-04-27,1912397,1912397,3824794
124,BBDC3,2011-06-30,2011-07-27,1912397,1912397,3824794
125,BBDC3,2011-09-30,2011-10-26,1912397,1912397,3824794
126,BBDC3,2011-12-31,2012-03-30,1912397,1912397,3824794
127,BBDC3,2012-03-31,2012-04-23,1912397,1912397,3824794
128,BBDC3,2012-06-30,2012-07-23,1912397,1912397,3824794
129,BBDC3,2012-09-30,2012-10-22,1912397,1912397,3824794
130,BBDC3,2012-12-31,2013-03-28,1912397,1912397,3824794
131,BBDC3,2013-03-31,2013-04-22,2103637,2103637,4207274
132,BBDC3,2013-06-30,2013-07-22,2103637,2103637,4207274
133,BBDC3,2013-09-30,2013-10-21,2103637,2103637,4207274
134,BBDC3,2013-12-31,2014-03-31,2103637,2103637,4207274
135,BBDC3,2014-03-31,2014-04-24,2103637,2103637,4207274
136,BBDC3,2014-06-30,2014-07-31,2103637,2103637,4207274
137,BBDC3,2014-09-30,2014-10-30,2103637,2103637,4207274
138,BBDC3,2014-12-31,2015-03-31,2103637,2103637,4207274
139,BBDC3,2015-03-31,2015-04-29,2524365,2524364,5048729
140,BBDC3,2015-06-30,2015-08-05,2524365,2524364,5048729
141,BBDC3,2015-09-30,2015-10-29,2524365,2524364,5048729
142,BBDC3,2015-12-31,2016-03-07,2524365,2524364,5048729
143,BBDC3,2016-03-31,2016-04-28,2524365,2524364,5048729
144,BBDC3,2016-06-30,2016-07-28,2776801,2776801,5553602
145,BBDC3,2016-09-30,2016-11-10,2776801,2776801,5553602
146,BBDC3,2016-12-31,2017-02-24,2776801,2776800,5553601
147,BBDC3,2017-03-31,2017-04-27,3054481,3054481,6108962
148,BBDC3,2017-06-30,2017-07-27,3054481,3054481,6108962
149,BBDC3,2017-09-30,2017-11-01,3054481,3054481,6108962
150,BBDC3,2017-12-31,2018-03-08,3054481,3054481,6108962
151,BBDC3,2018-03-31,2018-04-26,3359929,3359929,6719858
152,BBDC3,2018-06-30,2018-07-26,3359929,3359929,6719858
153,BBDC3,2018-09-30,2018-11-01,3359929,3359929,6719858
154,BBDC3,2018-12-31,2019-03-08,3359929,3359929,6719858
155,BBDC3,2019-03-31,2019-04-25,4031915,4031915,8063830
156,BBDC3,2019-06-30,2019-07-25,4031915,4031915,8063830
157,BBDC3,2019-09-30,2019-10-31,4031915,4031915,8063830
158,BBDC3,2019-12-31,2020-03-06,4031915,4031915,8063830
159,BBDC3,2020-03-31,2020-04-30,4435107,4435106,8870213
160,BBDC3,2020-06-30,2020-07-30,4435107,4435106,8870213
161,BBDC3,2020-09-30,2020-10-28,4435107,4435106,8870213
162,BBDC3,2020-12-31,2021-03-09,4435107,4435106,8870213
163,BBDC4,2010-12-31,2011-07-19,1881225,1881225,3762450
164,BBDC4,2011-03-31,2011-04-27,1912397,1912397,3824794
165,BBDC4,2011-06-30,2011-07-27,1912397,1912397,3824794
166,BBDC4,2011-09-30,2011-10-26,1912397,1912397,3824794
167,BBDC4,2011-12-31,2012-03-30,1912397,1912397,3824794
168,BBDC4,2012-03-31,2012-04-23,1912397,1912397,3824794
169,BBDC4,2012-06-30,2012-07-23,1912397,1912397,3824794
170,BBDC4,2012-09-30,2012-10-22,1912397,1912397,3824794
171,BBDC4,2012-12-31,2013-03-28,1912397,1912397,3824794
172,BBDC4,2013-03-31,2013-04-22,2103637,2103637,4207274
173,BBDC4,2013-06-30,2013-07-22,2103637,2103637,4207274
174,BBDC4,2013-09-30,2013-10-21,2103637,2103637,4207274
175,BBDC4,2013-12-31,2014-03-31,2103637,2103637,4207274
176,BBDC4,2014-03-31,2014-04-24,2103637,2103637,4207274
177,BBDC4,2014-06-30,2014-07-31,2103637,2103637,4207274
178,BBDC4,2014-09-30,2014-10-30,2103637,2103637,4207274
179,BBDC4,2014-12-31,2015-03-31,2103637,2103637,4207274
180,BBDC4,2015-03-31,2015-04-29,2524365,2524364,5048729
181,BBDC4,2015-06-30,2015-08-05,2524365,2524364,5048729
182,BBDC4,2015-09-30,2015-10-29,2524365,2524364,5048729
183,BBDC4,2015-12-31,2016-03-07,2524365,2524364,5048729
184,BBDC4,2016-03-31,2016-04-28,2524365,2524364,5048729
185,BBDC4,2016-06-30,2016-07-28,2776801,2776801,5553602
186,BBDC4,2016-09-30,2016-11-10,2776801,2776801,5553602
187,BBDC4,2016-12-31,2017-02-24,2776801,2776800,5553601
188,BBDC4,2017-03-31,2017-04-27,3054481,3054481,6108962
189,BBDC4,2017-06-30,2017-07-27,3054481,3054481,6108962
190,BBDC4,2017-09-30,2017-11-01,3054481,3054481,6108962
191,BBDC4,2017-12-31,2018-03-08,3054481,3054481,6108962
192,BBDC4,2018-03-31,2018-04-26,3359929,3359929,6719858
193,BBDC4,2018-06-30,2018-07-26,3359929,3359929,6719858
194,BBDC4,2018-09-30,2018-11-01,3359929,3359929,6719858
195,BBDC4,2018-12-31,2019-03-08,3359929,3359929,6719858
196,BBDC4,2019-03-31,2019-04-25,4031915,4031915,8063830
197,BBDC4,2019-06-30,2019-07-25,4031915,4031915,8063830
198,BBDC4,2019-09-30,2019-10-31,4031915,4031915,8063830
199,BBDC4,2019-12-31,2020-03-06,4031915,4031915,8063830
200,BBDC4,2020-03-31,2020-04-30,4435107,4435106,8870213
201,BBDC4,2020-06-30,2020-07-30,4435107,4435106,8870213
202,BBDC4,2020-09-30,2020-10-28,4435107,4435106,8870213
203,BBDC4,2020-12-31,2021-03-09,4435107,4435106,8870213
204,BAZA3,2010-12-31,2011-03-04,2964596,0,2964596
205,BAZA3,2011-03-31,2011-05-16,2964596,0,2964596
206,BAZA3,2011-06-30,2011-08-23,2964596,0,2964596
207,BAZA3,2011-09-30,2011-12-16,2964596,0,2964596
208,BAZA3,2011-12-31,2012-03-20,2964596,0,2964596
209,BAZA3,2012-03-31,2012-05-14,2964596,0,2964596
210,BAZA3,2012-06-30,2012-08-23,2964596,0,2964596
211,BAZA3,2012-09-30,2012-11-14,2964596,0,2964596
212,BAZA3,2012-12-31,2013-02-04,2964596,0,2964596
213,BAZA3,2013-03-31,2013-05-15,2964596,0,2964596
214,BAZA3,2013-06-30,2013-09-11,2964596,0,2964596
215,BAZA3,2013-09-30,2013-11-14,2964596,0,2964596
216,BAZA3,2013-12-31,2014-02-13,2964596762,0,2964596762
217,BAZA3,2014-03-31,2014-05-15,2964596762,0,2964596762
218,BAZA3,2014-06-30,2014-08-13,2964596762,0,2964596762
219,BAZA3,2014-09-30,2014-11-14,2964596762,0,2964596762
220,BAZA3,2014-12-31,2015-02-12,2964596762,0,2964596762
221,BAZA3,2015-03-31,2015-05-15,2964596762,0,2964596762
222,BAZA3,2015-06-30,2015-08-14,2964596762,0,2964596762
223,BAZA3,2015-09-30,2015-11-13,2964596762,0,2964596762
224,BAZA3,2015-12-31,2016-03-02,2964596762,0,2964596762
225,BAZA3,2016-03-31,2016-05-13,2964596762,0,2964596762
226,BAZA3,2016-06-30,2016-08-12,2964596762,0,2964596762
227,BAZA3,2016-09-30,2016-11-14,29645967,0,29645967
228,BAZA3,2016-12-31,2017-03-01,29645967,0,29645967
229,BAZA3,2017-03-31,2017-05-12,29645967,0,29645967
230,BAZA3,2017-06-30,2017-08-14,29645967,0,29645967
231,BAZA3,2017-09-30,2017-11-13,29645967,0,29645967
232,BAZA3,2017-12-31,2018-03-20,29645967,0,29645967
233,BAZA3,2018-03-31,2018-05-15,29645967,0,29645967
234,BAZA3,2018-06-30,2018-08-23,29645967,0,29645967
235,BAZA3,2018-09-30,2018-11-16,29645967,0,29645967
236,BAZA3,2018-12-31,2019-03-14,29645967,0,29645967
237,BAZA3,2019-03-31,2019-05-16,29645967,0,29645967
238,BAZA3,2019-06-30,2019-08-16,29645967,0,29645967
239,BAZA3,2019-09-30,2019-11-14,29645967,0,29645967
240,BAZA3,2019-12-31,2020-03-11,29645967,0,29645967
241,BAZA3,2020-03-31,2020-06-23,29645967,0,29645967
242,BAZA3,2020-06-30,2020-08-31,29645967,0,29645967
243,BAZA3,2020-09-30,2020-11-16,29645967,0,29645967
244,BAZA3,2020-12-31,2021-03-19,29645967,0,29645967
245,BBAS11,2010-12-31,2011-04-30,2860729247,0,2860729247
246,BBAS11,2011-03-31,2011-05-10,2860729247,0,2860729247
247,BBAS11,2011-06-30,2011-08-09,2860729247,0,2860729247
248,BBAS11,2011-09-30,2011-11-03,2860729247,0,2860729247
249,BBAS11,2011-12-31,2012-04-09,2865416988,0,2865416988
250,BBAS11,2012-03-31,2012-05-03,2865416973,0,2865416973
251,BBAS11,2012-06-30,2012-08-14,2865416973,0,2865416973
252,BBAS11,2012-09-30,2012-11-08,2858171973,0,2858171973
253,BBAS11,2012-12-31,2013-03-25,2865417020,0,2865417020
254,BBAS11,2013-03-31,2013-05-15,2865417020,0,2865417020
255,BBAS11,2013-06-30,2013-08-13,2865417020,0,2865417020
256,BBAS11,2013-09-30,2013-11-12,2865417020,0,2865417020
257,BBAS11,2013-12-31,2014-09-25,2865417020,0,2865417020
258,BBAS11,2014-03-31,2014-05-07,2865417020,0,2865417020
259,BBAS11,2014-06-30,2014-08-14,2865417020,0,2865417020
260,BBAS11,2014-09-30,2014-11-05,2865417020,0,2865417020
261,BBAS11,2014-12-31,2015-03-27,2865417020,0,2865417020
262,BBAS11,2015-03-31,2015-05-14,2865417020,0,2865417020
263,BBAS11,2015-06-30,2015-08-13,2865417020,0,2865417020
264,BBAS11,2015-09-30,2015-11-12,2865417020,0,2865417020
265,BBAS11,2015-12-31,2016-06-02,2865417020,0,2865417020
266,BBAS11,2016-03-31,2016-05-12,2865417020,0,2865417020
267,BBAS11,2016-06-30,2016-08-11,2865417020,0,2865417020
268,BBAS11,2016-09-30,2016-11-10,2865417020,0,2865417020
269,BBAS11,2016-12-31,2017-03-24,2865417020,0,2865417020
270,BBAS11,2017-03-31,2017-05-11,2865417020,0,2865417020
271,BBAS11,2017-06-30,2017-08-10,2865417020,0,2865417020
272,BBAS11,2017-09-30,2017-11-09,2865417020,0,2865417020
273,BBAS11,2017-12-31,2018-03-23,2865417020,0,2865417020
274,BBAS11,2018-03-31,2018-05-10,2865417020,0,2865417020
275,BBAS11,2018-06-30,2018-08-09,2865417020,0,2865417020
276,BBAS11,2018-09-30,2018-11-08,2865417020,0,2865417020
277,BBAS11,2018-12-31,2019-03-22,2865417020,0,2865417020
278,BBAS11,2019-03-31,2019-05-09,2865417020,0,2865417020
279,BBAS11,2019-06-30,2019-08-08,2865417020,0,2865417020
280,BBAS11,2019-09-30,2019-11-07,2865417020,0,2865417020
281,BBAS11,2019-12-31,2020-05-06,2865417020,0,2865417020
282,BBAS11,2020-03-31,2020-05-07,2865417020,0,2865417020
283,BBAS11,2020-06-30,2020-08-06,2865417020,0,2865417020
284,BBAS11,2020-09-30,2020-11-05,2865417020,0,2865417020
285,BBAS11,2020-12-31,2021-02-11,2865417020,0,2865417020
286,BBAS12,2010-12-31,2011-04-30,2860729247,0,2860729247
287,BBAS12,2011-03-31,2011-05-10,2860729247,0,2860729247
288,BBAS12,2011-06-30,2011-08-09,2860729247,0,2860729247
289,BBAS12,2011-09-30,2011-11-03,2860729247,0,2860729247
290,BBAS12,2011-12-31,2012-04-09,2865416988,0,2865416988
291,BBAS12,2012-03-31,2012-05-03,2865416973,0,2865416973
292,BBAS12,2012-06-30,2012-08-14,2865416973,0,2865416973
293,BBAS12,2012-09-30,2012-11-08,2858171973,0,2858171973
294,BBAS12,2012-12-31,2013-03-25,2865417020,0,2865417020
295,BBAS12,2013-03-31,2013-05-15,2865417020,0,2865417020
296,BBAS12,2013-06-30,2013-08-13,2865417020,0,2865417020
297,BBAS12,2013-09-30,2013-11-12,2865417020,0,2865417020
298,BBAS12,2013-12-31,2014-09-25,2865417020,0,2865417020
299,BBAS12,2014-03-31,2014-05-07,2865417020,0,2865417020
300,BBAS12,2014-06-30,2014-08-14,2865417020,0,2865417020
301,BBAS12,2014-09-30,2014-11-05,2865417020,0,2865417020
302,BBAS12,2014-12-31,2015-03-27,2865417020,0,2865417020
303,BBAS12,2015-03-31,2015-05-14,2865417020,0,2865417020
304,BBAS12,2015-06-30,2015-08-13,2865417020,0,2865417020
305,BBAS12,2015-09-30,2015-11-12,2865417020,0,2865417020
306,BBAS12,2015-12-31,2016-06-02,2865417020,0,2865417020
307,BBAS12,2016-03-31,2016-05-12,2865417020,0,2865417020
308,BBAS12,2016-06-30,2016-08-11,2865417020,0,2865417020
309,BBAS12,2016-09-30,2016-11-10,2865417020,0,2865417020
310,BBAS12,2016-12-31,2017-03-24,2865417020,0,2865417020
311,BBAS12,2017-03-31,2017-05-11,2865417020,0,2865417020
312,BBAS12,2017-06-30,2017-08-10,2865417020,0,2865417020
313,BBAS12,2017-09-30,2017-11-09,2865417020,0,2865417020
314,BBAS12,2017-12-31,2018-03-23,2865417020,0,2865417020
315,BBAS12,2018-03-31,2018-05-10,2865417020,0,2865417020
316,BBAS12,2018-06-30,2018-08-09,2865417020,0,2865417020
317,BBAS12,2018-09-30,2018-11-08,2865417020,0,2865417020
318,BBAS12,2018-12-31,2019-03-22,2865417020,0,2865417020
319,BBAS12,2019-03-31,2019-05-09,2865417020,0,2865417020
320,BBAS12,2019-06-30,2019-08-08,2865417020,0,2865417020
321,BBAS12,2019-09-30,2019-11-07,2865417020,0,2865417020
322,BBAS12,2019-12-31,2020-05-06,2865417020,0,2865417020
323,BBAS12,2020-03-31,2020-05-07,2865417020,0,2865417020
324,BBAS12,2020-06-30,2020-08-06,2865417020,0,2865417020
325,BBAS12,2020-09-30,2020-11-05,2865417020,0,2865417020
326,BBAS12,2020-12-31,2021-02-11,2865417020,0,2865417020
327,BBAS3,2010-12-31,2011-04-30,2860729247,0,2860729247
328,BBAS3,2011-03-31,2011-05-10,2860729247,0,2860729247
329,BBAS3,2011-06-30,2011-08-09,2860729247,0,2860729247
330,BBAS3,2011-09-30,2011-11-03,2860729247,0,2860729247
331,BBAS3,2011-12-31,2012-04-09,2865416988,0,2865416988
332,BBAS3,2012-03-31,2012-05-03,2865416973,0,2865416973
333,BBAS3,2012-06-30,2012-08-14,2865416973,0,2865416973
334,BBAS3,2012-09-30,2012-11-08,2858171973,0,2858171973
335,BBAS3,2012-12-31,2013-03-25,2865417020,0,2865417020
336,BBAS3,2013-03-31,2013-05-15,2865417020,0,2865417020
337,BBAS3,2013-06-30,2013-08-13,2865417020,0,2865417020
338,BBAS3,2013-09-30,2013-11-12,2865417020,0,2865417020
339,BBAS3,2013-12-31,2014-09-25,2865417020,0,2865417020
340,BBAS3,2014-03-31,2014-05-07,2865417020,0,2865417020
341,BBAS3,2014-06-30,2014-08-14,2865417020,0,2865417020
342,BBAS3,2014-09-30,2014-11-05,2865417020,0,2865417020
343,BBAS3,2014-12-31,2015-03-27,2865417020,0,2865417020
344,BBAS3,2015-03-31,2015-05-14,2865417020,0,2865417020
345,BBAS3,2015-06-30,2015-08-13,2865417020,0,2865417020
346,BBAS3,2015-09-30,2015-11-12,2865417020,0,2865417020
347,BBAS3,2015-12-31,2016-06-02,2865417020,0,2865417020
348,BBAS3,2016-03-31,2016-05-12,2865417020,0,2865417020
349,BBAS3,2016-06-30,2016-08-11,2865417020,0,2865417020
350,BBAS3,2016-09-30,2016-11-10,2865417020,0,2865417020
351,BBAS3,2016-12-31,2017-03-24,2865417020,0,2865417020
352,BBAS3,2017-03-31,2017-05-11,2865417020,0,2865417020
353,BBAS3,2017-06-30,2017-08-10,2865417020,0,2865417020
354,BBAS3,2017-09-30,2017-11-09,2865417020,0,2865417020
355,BBAS3,2017-12-31,2018-03-23,2865417020,0,2865417020
356,BBAS3,2018-03-31,2018-05-10,2865417020,0,2865417020
357,BBAS3,2018-06-30,2018-08-09,2865417020,0,2865417020
358,BBAS3,2018-09-30,2018-11-08,2865417020,0,2865417020
359,BBAS3,2018-12-31,2019-03-22,2865417020,0,2865417020
360,BBAS3,2019-03-31,2019-05-09,2865417020,0,2865417020
361,BBAS3,2019-06-30,2019-08-08,2865417020,0,2865417020
362,BBAS3,2019-09-30,2019-11-07,2865417020,0,2865417020
363,BBAS3,2019-12-31,2020-05-06,2865417020,0,2865417020
364,BBAS3,2020-03-31,2020-05-07,2865417020,0,2865417020
365,BBAS3,2020-06-30,2020-08-06,2865417020,0,2865417020
366,BBAS3,2020-09-30,2020-11-05,2865417020,0,2865417020
367,BBAS3,2020-12-31,2021-02-11,2865417020,0,2865417020
368,BGIP3,2010-12-31,2011-05-13,5270721,5270721,10541442
369,BGIP3,2011-03-31,2011-05-18,5270721,5270721,10541442
370,BGIP3,2011-06-30,2011-09-20,5270721,5270721,10541442
371,BGIP3,2011-09-30,2012-02-07,5271221,5271221,10542442
372,BGIP3,2011-12-31,2012-03-08,5270721,5270721,10541442
373,BGIP3,2012-03-31,2012-06-18,5271221,5271221,10542442
374,BGIP3,2012-06-30,2012-08-13,5271221,5271221,10542442
375,BGIP3,2012-09-30,2012-11-09,5271221,5271221,10542442
376,BGIP3,2012-12-31,2013-02-28,5270721,5270721,10541442
377,BGIP3,2013-03-31,2013-05-10,5270721,5270721,10541442
378,BGIP3,2013-06-30,2013-08-15,5271,5271,10542
379,BGIP3,2013-09-30,2013-11-14,5271,5271,10542
380,BGIP3,2013-12-31,2014-03-06,5271,5271,10542
381,BGIP3,2014-03-31,2014-05-15,5271,5271,10542
382,BGIP3,2014-06-30,2014-08-15,5271,5271,10542
383,BGIP3,2014-09-30,2014-11-12,7642545,7642545,15285090
384,BGIP3,2014-12-31,2015-03-20,7642545,7642545,15285090
385,BGIP3,2015-03-31,2015-05-20,7642545,7642545,15285090
386,BGIP3,2015-06-30,2015-08-18,7642545,7642545,15285090
387,BGIP3,2015-09-30,2015-11-12,7642545,7642545,15285090
388,BGIP3,2015-12-31,2016-03-29,7642545,7642545,15285090
389,BGIP3,2016-03-31,2016-05-13,7642545,7642545,15285090
390,BGIP3,2016-06-30,2017-08-18,7642545,7642545,15285090
391,BGIP3,2016-09-30,2016-11-14,7642545,7642545,15285090
392,BGIP3,2016-12-31,2017-02-21,7642545,7642545,15285090
393,BGIP3,2017-03-31,2017-08-17,7642545,7642545,15285090
394,BGIP3,2017-06-30,2017-08-21,7642545,7642545,15285090
395,BGIP3,2017-09-30,2017-11-13,7642545,7642545,15285090
396,BGIP3,2017-12-31,2018-03-27,7642545,7642545,15285090
397,BGIP3,2018-03-31,2018-06-28,7642545,7642545,15285090
398,BGIP3,2018-06-30,2018-08-13,7642545,7642545,15285090
399,BGIP3,2018-09-30,2018-11-13,7642545,7642545,15285090
400,BGIP3,2018-12-31,2019-02-26,7642545,7642545,15285090
401,BGIP3,2019-03-31,2019-07-16,7642545,7642545,15285090
402,BGIP3,2019-06-30,2019-08-23,7642545,7642545,15285090
403,BGIP3,2019-09-30,2019-11-14,7642545,7642545,15285090
404,BGIP3,2019-12-31,2020-02-26,7642545,7642545,15285090
405,BGIP3,2020-03-31,2020-05-29,7642545,7642545,15285090
406,BGIP3,2020-06-30,2020-08-24,7642545,7642545,15285090
407,BGIP3,2020-09-30,2020-12-30,7642545,7642545,15285090
408,BGIP3,2020-12-31,2021-02-26,7642545,7642545,15285090
409,BGIP4,2010-12-31,2011-05-13,5270721,5270721,10541442
410,BGIP4,2011-03-31,2011-05-18,5270721,5270721,10541442
411,BGIP4,2011-06-30,2011-09-20,5270721,5270721,10541442
412,BGIP4,2011-09-30,2012-02-07,5271221,5271221,10542442
413,BGIP4,2011-12-31,2012-03-08,5270721,5270721,10541442
414,BGIP4,2012-03-31,2012-06-18,5271221,5271221,10542442
415,BGIP4,2012-06-30,2012-08-13,5271221,5271221,10542442
416,BGIP4,2012-09-30,2012-11-09,5271221,5271221,10542442
417,BGIP4,2012-12-31,2013-02-28,5270721,5270721,10541442
418,BGIP4,2013-03-31,2013-05-10,5270721,5270721,10541442
419,BGIP4,2013-06-30,2013-08-15,5271,5271,10542
420,BGIP4,2013-09-30,2013-11-14,5271,5271,10542
421,BGIP4,2013-12-31,2014-03-06,5271,5271,10542
422,BGIP4,2014-03-31,2014-05-15,5271,5271,10542
423,BGIP4,2014-06-30,2014-08-15,5271,5271,10542
424,BGIP4,2014-09-30,2014-11-12,7642545,7642545,15285090
425,BGIP4,2014-12-31,2015-03-20,7642545,7642545,15285090
426,BGIP4,2015-03-31,2015-05-20,7642545,7642545,15285090
427,BGIP4,2015-06-30,2015-08-18,7642545,7642545,15285090
428,BGIP4,2015-09-30,2015-11-12,7642545,7642545,15285090
429,BGIP4,2015-12-31,2016-03-29,7642545,7642545,15285090
430,BGIP4,2016-03-31,2016-05-13,7642545,7642545,15285090
431,BGIP4,2016-06-30,2017-08-18,7642545,7642545,15285090
432,BGIP4,2016-09-30,2016-11-14,7642545,7642545,15285090
433,BGIP4,2016-12-31,2017-02-21,7642545,7642545,15285090
434,BGIP4,2017-03-31,2017-08-17,7642545,7642545,15285090
435,BGIP4,2017-06-30,2017-08-21,7642545,7642545,15285090
436,BGIP4,2017-09-30,2017-11-13,7642545,7642545,15285090
437,BGIP4,2017-12-31,2018-03-27,7642545,7642545,15285090
438,BGIP4,2018-03-31,2018-06-28,7642545,7642545,15285090
439,BGIP4,2018-06-30,2018-08-13,7642545,7642545,15285090
440,BGIP4,2018-09-30,2018-11-13,7642545,7642545,15285090
441,BGIP4,2018-12-31,2019-02-26,7642545,7642545,15285090
442,BGIP4,2019-03-31,2019-07-16,7642545,7642545,15285090
443,BGIP4,2019-06-30,2019-08-23,7642545,7642545,15285090
444,BGIP4,2019-09-30,2019-11-14,7642545,7642545,15285090
445,BGIP4,2019-12-31,2020-02-26,7642545,7642545,15285090
446,BGIP4,2020-03-31,2020-05-29,7642545,7642545,15285090
447,BGIP4,2020-06-30,2020-08-24,7642545,7642545,15285090
448,BGIP4,2020-09-30,2020-12-30,7642545,7642545,15285090
449,BGIP4,2020-12-31,2021-02-26,7642545,7642545,15285090
450,BEES3,2010-12-31,2011-05-20,109305,42183,151488
451,BEES3,2011-03-31,2011-05-13,109305,42183,151488
452,BEES3,2011-06-30,2011-08-17,109305,42183,151488
453,BEES3,2011-09-30,2013-07-04,109305,42183,151488
454,BEES3,2011-12-31,2012-04-09,109305,42183,151488
455,BEES3,2012-03-31,2012-05-15,109305,42183,151488
456,BEES3,2012-06-30,2012-08-15,109332,42183,151515
457,BEES3,2012-09-30,2012-11-12,1093320,421832,1515152
458,BEES3,2012-12-31,2013-03-28,1093320,421832,1515152
459,BEES3,2013-03-31,2013-05-15,1093320,421832,1515152
460,BEES3,2013-06-30,2013-08-14,1093320,421832,1515152
461,BEES3,2013-09-30,2013-11-14,1093320,421832,1515152
462,BEES3,2013-12-31,2014-03-28,1157732,421832,1579564
463,BEES3,2014-03-31,2014-05-14,1157732,421832,1579564
464,BEES3,2014-06-30,2014-08-14,1157732,421832,1579564
465,BEES3,2014-09-30,2014-11-11,1157732,421832,1579564
466,BEES3,2014-12-31,2015-03-27,1157732,421832,1579564
467,BEES3,2015-03-31,2015-05-07,231547,84366,315913
468,BEES3,2015-06-30,2015-08-13,231546,84366,315912
469,BEES3,2015-09-30,2015-11-12,231546,84366,315912
470,BEES3,2015-12-31,2016-05-31,231546,84366,315912
471,BEES3,2016-03-31,2016-05-11,231546,84366,315912
472,BEES3,2016-06-30,2016-08-11,231546,84366,315912
473,BEES3,2016-09-30,2016-11-10,231546,84366,315912
474,BEES3,2016-12-31,2017-03-28,231546,84366,315912
475,BEES3,2017-03-31,2017-05-12,231546,84366,315912
476,BEES3,2017-06-30,2017-08-10,231356,84556,315912
477,BEES3,2017-09-30,2017-11-13,231356,84556,315912
478,BEES3,2017-12-31,2018-03-28,231356,84556,315912
479,BEES3,2018-03-31,2018-05-14,231356,84556,315912
480,BEES3,2018-06-30,2018-08-13,231356,84556,315912
481,BEES3,2018-09-30,2018-11-08,231355,84557,315912
482,BEES3,2018-12-31,2019-05-08,231355,84557,315912
483,BEES3,2019-03-31,2019-05-14,231355,84557,315912
484,BEES3,2019-06-30,2019-08-20,231355,84557,315912
485,BEES3,2019-09-30,2019-11-12,231355,84557,315912
486,BEES3,2019-12-31,2020-03-25,231355,84557,315912
487,BEES3,2020-03-31,2020-05-26,231329,84583,315912
488,BEES3,2020-06-30,2020-08-11,231329,84583,315912
489,BEES3,2020-09-30,2020-11-25,231329,84583,315912
490,BEES3,2020-12-31,2021-03-23,231329,84583,315912
491,BEES4,2010-12-31,2011-05-20,109305,42183,151488
492,BEES4,2011-03-31,2011-05-13,109305,42183,151488
493,BEES4,2011-06-30,2011-08-17,109305,42183,151488
494,BEES4,2011-09-30,2013-07-04,109305,42183,151488
495,BEES4,2011-12-31,2012-04-09,109305,42183,151488
496,BEES4,2012-03-31,2012-05-15,109305,42183,151488
497,BEES4,2012-06-30,2012-08-15,109332,42183,151515
498,BEES4,2012-09-30,2012-11-12,1093320,421832,1515152
499,BEES4,2012-12-31,2013-03-28,1093320,421832,1515152
500,BEES4,2013-03-31,2013-05-15,1093320,421832,1515152
501,BEES4,2013-06-30,2013-08-14,1093320,421832,1515152
502,BEES4,2013-09-30,2013-11-14,1093320,421832,1515152
503,BEES4,2013-12-31,2014-03-28,1157732,421832,1579564
504,BEES4,2014-03-31,2014-05-14,1157732,421832,1579564
505,BEES4,2014-06-30,2014-08-14,1157732,421832,1579564
506,BEES4,2014-09-30,2014-11-11,1157732,421832,1579564
507,BEES4,2014-12-31,2015-03-27,1157732,421832,1579564
508,BEES4,2015-03-31,2015-05-07,231547,84366,315913
509,BEES4,2015-06-30,2015-08-13,231546,84366,315912
510,BEES4,2015-09-30,2015-11-12,231546,84366,315912
511,BEES4,2015-12-31,2016-05-31,231546,84366,315912
512,BEES4,2016-03-31,2016-05-11,231546,84366,315912
513,BEES4,2016-06-30,2016-08-11,231546,84366,315912
514,BEES4,2016-09-30,2016-11-10,231546,84366,315912
515,BEES4,2016-12-31,2017-03-28,231546,84366,315912
516,BEES4,2017-03-31,2017-05-12,231546,84366,315912
517,BEES4,2017-06-30,2017-08-10,231356,84556,315912
518,BEES4,2017-09-30,2017-11-13,231356,84556,315912
519,BEES4,2017-12-31,2018-03-28,231356,84556,315912
520,BEES4,2018-03-31,2018-05-14,231356,84556,315912
521,BEES4,2018-06-30,2018-08-13,231356,84556,315912
522,BEES4,2018-09-30,2018-11-08,231355,84557,315912
523,BEES4,2018-12-31,2019-05-08,231355,84557,315912
524,BEES4,2019-03-31,2019-05-14,231355,84557,315912
525,BEES4,2019-06-30,2019-08-20,231355,84557,315912
526,BEES4,2019-09-30,2019-11-12,231355,84557,315912
527,BEES4,2019-12-31,2020-03-25,231355,84557,315912
528,BEES4,2020-03-31,2020-05-26,231329,84583,315912
529,BEES4,2020-06-30,2020-08-11,231329,84583,315912
530,BEES4,2020-09-30,2020-11-25,231329,84583,315912
531,BEES4,2020-12-31,2021-03-23,231329,84583,315912
532,BPAR3,2010-12-31,2011-03-24,9521649,0,9521649
533,BPAR3,2011-03-31,2011-05-16,9521649,0,9521649
534,BPAR3,2011-06-30,2011-08-18,9521649,0,9521649
535,BPAR3,2011-09-30,2011-11-14,9521649,0,9521649
536,BPAR3,2011-12-31,2012-02-28,9521649,0,9521649
537,BPAR3,2012-03-31,2012-05-15,9521649,0,9521649
538,BPAR3,2012-06-30,2012-08-15,9521649,0,9521649
539,BPAR3,2012-09-30,2012-11-14,9521649,0,9521649
540,BPAR3,2012-12-31,2013-02-25,9521649,0,9521649
541,BPAR3,2013-03-31,2013-05-15,9521649,0,9521649
542,BPAR3,2013-06-30,2013-08-14,9521649,0,9521649
543,BPAR3,2013-09-30,2014-01-09,9521649,0,9521649
544,BPAR3,2013-12-31,2014-02-26,9521649,0,9521649
545,BPAR3,2014-03-31,2014-05-15,9521649,0,9521649
546,BPAR3,2014-06-30,2014-08-25,9521649,0,9521649
547,BPAR3,2014-09-30,2014-11-14,9521649,0,9521649
548,BPAR3,2014-12-31,2015-02-27,9521649,0,9521649
549,BPAR3,2015-03-31,2015-05-15,9521649,0,9521649
550,BPAR3,2015-06-30,2015-08-28,9521649,0,9521649
551,BPAR3,2015-09-30,2015-11-16,9521649,0,9521649
552,BPAR3,2015-12-31,2016-03-15,9521649,0,9521649
553,BPAR3,2016-03-31,2016-05-13,9521649,0,9521649
554,BPAR3,2016-06-30,2016-08-12,9521649,0,9521649
555,BPAR3,2016-09-30,2016-11-14,9521649,0,9521649
556,BPAR3,2016-12-31,2017-03-02,9521649,0,9521649
557,BPAR3,2017-03-31,2017-05-15,9521649,0,9521649
558,BPAR3,2017-06-30,2017-08-11,9521649,0,9521649
559,BPAR3,2017-09-30,2017-11-14,9521649,0,9521649
560,BPAR3,2017-12-31,2018-02-23,9521649,0,9521649
561,BPAR3,2018-03-31,2018-05-15,9521649,0,9521649
562,BPAR3,2018-06-30,2018-08-14,9521649,0,9521649
563,BPAR3,2018-09-30,2018-11-14,9521649,0,9521649
564,BPAR3,2018-12-31,2019-02-22,9521649,0,9521649
565,BPAR3,2019-03-31,2019-05-16,9521649,0,9521649
566,BPAR3,2019-06-30,2019-09-13,9521649,0,9521649
567,BPAR3,2019-09-30,2019-11-14,9521649,0,9521649
568,BPAR3,2019-12-31,2020-02-20,9521649,0,9521649
569,BPAR3,2020-03-31,2020-05-29,9521649,0,9521649
570,BPAR3,2020-06-30,2020-08-26,9521649,0,9521649
571,BPAR3,2020-09-30,2020-11-16,9521649,0,9521649
572,BPAR3,2020-12-31,2021-02-24,9521649,0,9521649
573,BRSR3,2010-12-31,2011-05-02,205043,203931,408974
574,BRSR3,2011-03-31,2011-05-12,205043,203931,408974
575,BRSR3,2011-06-30,2011-08-11,205043,203931,408974
576,BRSR3,2011-09-30,2011-11-07,205043,203931,408974
577,BRSR3,2011-12-31,2012-03-29,205043,203931,408974
578,BRSR3,2012-03-31,2012-05-14,205043,203931,408974
579,BRSR3,2012-06-30,2012-08-13,205043,203931,408974
580,BRSR3,2012-09-30,2012-11-12,205043,203931,408974
581,BRSR3,2012-12-31,2013-03-27,205043,203931,408974
582,BRSR3,2013-03-31,2013-05-15,205043,203931,408974
583,BRSR3,2013-06-30,2013-08-13,205043,203931,408974
584,BRSR3,2013-09-30,2013-11-13,205043,203931,408974
585,BRSR3,2013-12-31,2014-03-14,205043,203931,408974
586,BRSR3,2014-03-31,2014-05-13,205043,203931,408974
587,BRSR3,2014-06-30,2014-08-13,205043,203931,408974
588,BRSR3,2014-09-30,2014-11-12,205043,203931,408974
589,BRSR3,2014-12-31,2015-03-06,205043,203931,408974
590,BRSR3,2015-03-31,2015-05-13,205043,203931,408974
591,BRSR3,2015-06-30,2015-08-12,205043,203931,408974
592,BRSR3,2015-09-30,2015-11-11,205044,203930,408974
593,BRSR3,2015-12-31,2016-03-11,205051,203923,408974
594,BRSR3,2016-03-31,2016-05-11,205052,203922,408974
595,BRSR3,2016-06-30,2016-08-10,205054,203920,408974
596,BRSR3,2016-09-30,2016-11-09,205044,203930,408974
597,BRSR3,2016-12-31,2017-03-13,205054,203920,408974
598,BRSR3,2017-03-31,2017-05-15,205057,203917,408974
599,BRSR3,2017-06-30,2017-08-14,205057,203917,408974
600,BRSR3,2017-09-30,2017-11-13,205057,203917,408974
601,BRSR3,2017-12-31,2018-03-27,205058,203916,408974
602,BRSR3,2018-03-31,2018-05-14,205059,203915,408974
603,BRSR3,2018-06-30,2018-08-14,205060,203914,408974
604,BRSR3,2018-09-30,2018-11-13,205060,203914,408974
605,BRSR3,2018-12-31,2019-03-19,205062,203912,408974
606,BRSR3,2019-03-31,2019-05-14,205062,203912,408974
607,BRSR3,2019-06-30,2019-08-13,205062,203912,408974
608,BRSR3,2019-09-30,2019-11-11,205062,203912,408974
609,BRSR3,2019-12-31,2020-03-17,205065,203909,408974
610,BRSR3,2020-03-31,2020-05-12,205065,203909,408974
611,BRSR3,2020-06-30,2020-08-12,205065,203909,408974
612,BRSR3,2020-09-30,2020-11-10,205065,203909,408974
613,BRSR3,2020-12-31,2021-03-15,205065,203909,408974
614,BRSR5,2010-12-31,2011-05-02,205043,203931,408974
615,BRSR5,2011-03-31,2011-05-12,205043,203931,408974
616,BRSR5,2011-06-30,2011-08-11,205043,203931,408974
617,BRSR5,2011-09-30,2011-11-07,205043,203931,408974
618,BRSR5,2011-12-31,2012-03-29,205043,203931,408974
619,BRSR5,2012-03-31,2012-05-14,205043,203931,408974
620,BRSR5,2012-06-30,2012-08-13,205043,203931,408974
621,BRSR5,2012-09-30,2012-11-12,205043,203931,408974
622,BRSR5,2012-12-31,2013-03-27,205043,203931,408974
623,BRSR5,2013-03-31,2013-05-15,205043,203931,408974
624,BRSR5,2013-06-30,2013-08-13,205043,203931,408974
625,BRSR5,2013-09-30,2013-11-13,205043,203931,408974
626,BRSR5,2013-12-31,2014-03-14,205043,203931,408974
627,BRSR5,2014-03-31,2014-05-13,205043,203931,408974
628,BRSR5,2014-06-30,2014-08-13,205043,203931,408974
629,BRSR5,2014-09-30,2014-11-12,205043,203931,408974
630,BRSR5,2014-12-31,2015-03-06,205043,203931,408974
631,BRSR5,2015-03-31,2015-05-13,205043,203931,408974
632,BRSR5,2015-06-30,2015-08-12,205043,203931,408974
633,BRSR5,2015-09-30,2015-11-11,205044,203930,408974
634,BRSR5,2015-12-31,2016-03-11,205051,203923,408974
635,BRSR5,2016-03-31,2016-05-11,205052,203922,408974
636,BRSR5,2016-06-30,2016-08-10,205054,203920,408974
637,BRSR5,2016-09-30,2016-11-09,205044,203930,408974
638,BRSR5,2016-12-31,2017-03-13,205054,203920,408974
639,BRSR5,2017-03-31,2017-05-15,205057,203917,408974
640,BRSR5,2017-06-30,2017-08-14,205057,203917,408974
641,BRSR5,2017-09-30,2017-11-13,205057,203917,408974
642,BRSR5,2017-12-31,2018-03-27,205058,203916,408974
643,BRSR5,2018-03-31,2018-05-14,205059,203915,408974
644,BRSR5,2018-06-30,2018-08-14,205060,203914,408974
645,BRSR5,2018-09-30,2018-11-13,205060,203914,408974
646,BRSR5,2018-12-31,2019-03-19,205062,203912,408974
647,BRSR5,2019-03-31,2019-05-14,205062,203912,408974
648,BRSR5,2019-06-30,2019-08-13,205062,203912,408974
649,BRSR5,2019-09-30,2019-11-11,205062,203912,408974
650,BRSR5,2019-12-31,2020-03-17,205065,203909,408974
651,BRSR5,2020-03-31,2020-05-12,205065,203909,408974
652,BRSR5,2020-06-30,2020-08-12,205065,203909,408974
653,BRSR5,2020-09-30,2020-11-10,205065,203909,408974
654,BRSR5,2020-12-31,2021-03-15,205065,203909,408974
655,BRSR6,2010-12-31,2011-05-02,205043,203931,408974
656,BRSR6,2011-03-31,2011-05-12,205043,203931,408974
657,BRSR6,2011-06-30,2011-08-11,205043,203931,408974
658,BRSR6,2011-09-30,2011-11-07,205043,203931,408974
659,BRSR6,2011-12-31,2012-03-29,205043,203931,408974
660,BRSR6,2012-03-31,2012-05-14,205043,203931,408974
661,BRSR6,2012-06-30,2012-08-13,205043,203931,408974
662,BRSR6,2012-09-30,2012-11-12,205043,203931,408974
663,BRSR6,2012-12-31,2013-03-27,205043,203931,408974
664,BRSR6,2013-03-31,2013-05-15,205043,203931,408974
665,BRSR6,2013-06-30,2013-08-13,205043,203931,408974
666,BRSR6,2013-09-30,2013-11-13,205043,203931,408974
667,BRSR6,2013-12-31,2014-03-14,205043,203931,408974
668,BRSR6,2014-03-31,2014-05-13,205043,203931,408974
669,BRSR6,2014-06-30,2014-08-13,205043,203931,408974
670,BRSR6,2014-09-30,2014-11-12,205043,203931,408974
671,BRSR6,2014-12-31,2015-03-06,205043,203931,408974
672,BRSR6,2015-03-31,2015-05-13,205043,203931,408974
673,BRSR6,2015-06-30,2015-08-12,205043,203931,408974
674,BRSR6,2015-09-30,2015-11-11,205044,203930,408974
675,BRSR6,2015-12-31,2016-03-11,205051,203923,408974
676,BRSR6,2016-03-31,2016-05-11,205052,203922,408974
677,BRSR6,2016-06-30,2016-08-10,205054,203920,408974
678,BRSR6,2016-09-30,2016-11-09,205044,203930,408974
679,BRSR6,2016-12-31,2017-03-13,205054,203920,408974
680,BRSR6,2017-03-31,2017-05-15,205057,203917,408974
681,BRSR6,2017-06-30,2017-08-14,205057,203917,408974
682,BRSR6,2017-09-30,2017-11-13,205057,203917,408974
683,BRSR6,2017-12-31,2018-03-27,205058,203916,408974
684,BRSR6,2018-03-31,2018-05-14,205059,203915,408974
685,BRSR6,2018-06-30,2018-08-14,205060,203914,408974
686,BRSR6,2018-09-30,2018-11-13,205060,203914,408974
687,BRSR6,2018-12-31,2019-03-19,205062,203912,408974
688,BRSR6,2019-03-31,2019-05-14,205062,203912,408974
689,BRSR6,2019-06-30,2019-08-13,205062,203912,408974
690,BRSR6,2019-09-30,2019-11-11,205062,203912,408974
691,BRSR6,2019-12-31,2020-03-17,205065,203909,408974
692,BRSR6,2020-03-31,2020-05-12,205065,203909,408974
693,BRSR6,2020-06-30,2020-08-12,205065,203909,408974
694,BRSR6,2020-09-30,2020-11-10,205065,203909,408974
695,BRSR6,2020-12-31,2021-03-15,205065,203909,408974
696,BNBR3,2010-12-31,2011-02-16,48485,38517,87002
697,BNBR3,2011-03-31,2011-05-16,48485,38517,87002
698,BNBR3,2011-06-30,2011-08-11,48485,38517,87002
699,BNBR3,2011-09-30,2011-11-14,48485,38517,87002
700,BNBR3,2011-12-31,2012-02-15,48485,38517,87002
701,BNBR3,2012-03-31,2012-05-15,48485,38517,87002
702,BNBR3,2012-06-30,2012-08-14,48485,38517,87002
703,BNBR3,2012-09-30,2012-11-14,48485,38517,87002
704,BNBR3,2012-12-31,2013-02-19,48485,38517,87002
705,BNBR3,2013-03-31,2013-05-20,48485,38517,87002
706,BNBR3,2013-06-30,2013-08-14,48485,38517,87002
707,BNBR3,2013-09-30,2013-11-14,48485,38517,87002
708,BNBR3,2013-12-31,2014-02-25,48485,38517,87002
709,BNBR3,2014-03-31,2014-05-15,86371,0,86371
710,BNBR3,2014-06-30,2014-08-13,86371,0,86371
711,BNBR3,2014-09-30,2014-11-13,86371,0,86371
712,BNBR3,2014-12-31,2015-03-23,86371464,0,86371464
713,BNBR3,2015-03-31,2015-05-13,86371,0,86371
714,BNBR3,2015-06-30,2015-08-14,86371,0,86371
715,BNBR3,2015-09-30,2015-11-12,86371,0,86371
716,BNBR3,2015-12-31,2016-02-26,86371,0,86371
717,BNBR3,2016-03-31,2016-05-16,86371,0,86371
718,BNBR3,2016-06-30,2016-08-12,86371,0,86371
719,BNBR3,2016-09-30,2016-11-14,86371,0,86371
720,BNBR3,2016-12-31,2017-02-16,86371,0,86371
721,BNBR3,2017-03-31,2017-05-12,86371,0,86371
722,BNBR3,2017-06-30,2017-08-11,86371,0,86371
723,BNBR3,2017-09-30,2017-11-13,86371,0,86371
724,BNBR3,2017-12-31,2018-02-22,86371,0,86371
725,BNBR3,2018-03-31,2018-05-10,86371,0,86371
726,BNBR3,2018-06-30,2018-08-14,86371,0,86371
727,BNBR3,2018-09-30,2018-11-16,86371,0,86371
728,BNBR3,2018-12-31,2019-03-21,86371,0,86371
729,BNBR3,2019-03-31,2019-05-15,86371,0,86371
730,BNBR3,2019-06-30,2019-09-12,86371,0,86371
731,BNBR3,2019-09-30,2019-11-25,86371,0,86371
732,BNBR3,2019-12-31,2020-02-19,86371,0,86371
733,BNBR3,2020-03-31,2020-06-02,86371,0,86371
734,BNBR3,2020-06-30,2020-11-18,86371,0,86371
735,BNBR3,2020-09-30,2020-11-13,86371,0,86371
736,BNBR3,2020-12-31,2021-02-25,86371,0,86371
737,BMIN3,2010-12-31,2011-02-28,111506,71014,182520
738,BMIN3,2011-03-31,2011-05-16,111506,71014,182520
739,BMIN3,2011-06-30,2011-08-12,111506,71014,182520
740,BMIN3,2011-09-30,2011-11-14,111506,71014,182520
741,BMIN3,2011-12-31,2012-03-01,111506,71014,182520
742,BMIN3,2012-03-31,2012-05-23,111506,71014,182520
743,BMIN3,2012-06-30,2012-08-14,111506,71014,182520
744,BMIN3,2012-09-30,2012-11-14,111506,71014,182520
745,BMIN3,2012-12-31,2013-02-27,111506,71014,182520
746,BMIN3,2013-03-31,2013-05-14,111506,71014,182520
747,BMIN3,2013-06-30,2013-08-14,111506,71014,182520
748,BMIN3,2013-09-30,2013-11-13,111506,71014,182520
749,BMIN3,2013-12-31,2014-03-12,111506,71014,182520
750,BMIN3,2014-03-31,2014-05-15,111506,71014,182520
751,BMIN3,2014-06-30,2014-08-14,111506,71014,182520
752,BMIN3,2014-09-30,2014-11-14,111506,71014,182520
753,BMIN3,2014-12-31,2015-03-05,111506,71014,182520
754,BMIN3,2015-03-31,2015-05-15,111506,71014,182520
755,BMIN3,2015-06-30,2015-08-14,111506,71014,182520
756,BMIN3,2015-09-30,2015-10-26,111506,71014,182520
757,BMIN3,2015-12-31,2016-03-16,111506,71014,182520
758,BMIN3,2016-03-31,2016-05-13,464127,295588,759715
759,BMIN3,2016-06-30,2016-08-12,464127,295588,759715
760,BMIN3,2016-09-30,2016-11-11,464127,295588,759715
761,BMIN3,2016-12-31,2017-03-07,111506,71014,182520
762,BMIN3,2017-03-31,2017-05-15,111506,71014,182520
763,BMIN3,2017-06-30,2017-08-14,111506,71014,182520
764,BMIN3,2017-09-30,2017-11-14,1115,710,1825
765,BMIN3,2017-12-31,2018-02-28,1115,710,1825
766,BMIN3,2018-03-31,2018-05-15,1115,710,1825
767,BMIN3,2018-06-30,2018-08-14,4115,710,4825
768,BMIN3,2018-09-30,2018-11-14,4115,710,4825
769,BMIN3,2018-12-31,2019-02-28,4115,710,4825
770,BMIN3,2019-03-31,2019-05-15,4115,710,4825
771,BMIN3,2019-06-30,2019-08-14,4115,710,4825
772,BMIN3,2019-09-30,2019-11-14,4115,710,4825
773,BMIN3,2019-12-31,2020-03-03,4115,710,4825
774,BMIN3,2020-03-31,2020-05-15,4115,710,4825
775,BMIN3,2020-06-30,2020-08-14,4115,710,4825
776,BMIN3,2020-09-30,2020-11-13,4115,710,4825
777,BMIN3,2020-12-31,2021-02-24,4115,710,4825
778,BMIN4,2010-12-31,2011-02-28,111506,71014,182520
779,BMIN4,2011-03-31,2011-05-16,111506,71014,182520
780,BMIN4,2011-06-30,2011-08-12,111506,71014,182520
781,BMIN4,2011-09-30,2011-11-14,111506,71014,182520
782,BMIN4,2011-12-31,2012-03-01,111506,71014,182520
783,BMIN4,2012-03-31,2012-05-23,111506,71014,182520
784,BMIN4,2012-06-30,2012-08-14,111506,71014,182520
785,BMIN4,2012-09-30,2012-11-14,111506,71014,182520
786,BMIN4,2012-12-31,2013-02-27,111506,71014,182520
787,BMIN4,2013-03-31,2013-05-14,111506,71014,182520
788,BMIN4,2013-06-30,2013-08-14,111506,71014,182520
789,BMIN4,2013-09-30,2013-11-13,111506,71014,182520
790,BMIN4,2013-12-31,2014-03-12,111506,71014,182520
791,BMIN4,2014-03-31,2014-05-15,111506,71014,182520
792,BMIN4,2014-06-30,2014-08-14,111506,71014,182520
793,BMIN4,2014-09-30,2014-11-14,111506,71014,182520
794,BMIN4,2014-12-31,2015-03-05,111506,71014,182520
795,BMIN4,2015-03-31,2015-05-15,111506,71014,182520
796,BMIN4,2015-06-30,2015-08-14,111506,71014,182520
797,BMIN4,2015-09-30,2015-10-26,111506,71014,182520
798,BMIN4,2015-12-31,2016-03-16,111506,71014,182520
799,BMIN4,2016-03-31,2016-05-13,464127,295588,759715
800,BMIN4,2016-06-30,2016-08-12,464127,295588,759715
801,BMIN4,2016-09-30,2016-11-11,464127,295588,759715
802,BMIN4,2016-12-31,2017-03-07,111506,71014,182520
803,BMIN4,2017-03-31,2017-05-15,111506,71014,182520
804,BMIN4,2017-06-30,2017-08-14,111506,71014,182520
805,BMIN4,2017-09-30,2017-11-14,1115,710,1825
806,BMIN4,2017-12-31,2018-02-28,1115,710,1825
807,BMIN4,2018-03-31,2018-05-15,1115,710,1825
808,BMIN4,2018-06-30,2018-08-14,4115,710,4825
809,BMIN4,2018-09-30,2018-11-14,4115,710,4825
810,BMIN4,2018-12-31,2019-02-28,4115,710,4825
811,BMIN4,2019-03-31,2019-05-15,4115,710,4825
812,BMIN4,2019-06-30,2019-08-14,4115,710,4825
813,BMIN4,2019-09-30,2019-11-14,4115,710,4825
814,BMIN4,2019-12-31,2020-03-03,4115,710,4825
815,BMIN4,2020-03-31,2020-05-15,4115,710,4825
816,BMIN4,2020-06-30,2020-08-14,4115,710,4825
817,BMIN4,2020-09-30,2020-11-13,4115,710,4825
818,BMIN4,2020-12-31,2021-02-24,4115,710,4825
819,BMEB3,2010-12-31,2011-04-29,26262,9138,35400
820,BMEB3,2011-03-31,2011-05-17,26262,9138,35400
821,BMEB3,2011-06-30,2011-08-08,26262,9138,35400
822,BMEB3,2011-09-30,2011-11-14,26262,9138,35400
823,BMEB3,2011-12-31,2012-04-05,26262,9138,35400
824,BMEB3,2012-03-31,2012-05-15,26262,9138,35400
825,BMEB3,2012-06-30,2012-08-14,26262,9138,35400
826,BMEB3,2012-09-30,2012-11-14,26262,16238,42500
827,BMEB3,2012-12-31,2013-03-27,26262,16238,42500
828,BMEB3,2013-03-31,2013-05-14,26262,16238,42500
829,BMEB3,2013-06-30,2013-08-13,26262,16238,42500
830,BMEB3,2013-09-30,2013-11-13,26262,16238,42500
831,BMEB3,2013-12-31,2014-03-31,26262,19838,46100
832,BMEB3,2014-03-31,2014-05-15,26262,19838,46100
833,BMEB3,2014-06-30,2014-08-13,26262,19838,46100
834,BMEB3,2014-09-30,2014-11-14,26262,19838,46100
835,BMEB3,2014-12-31,2015-03-31,26262,19838,46100
836,BMEB3,2015-03-31,2015-05-15,26262,19838,46100
837,BMEB3,2015-06-30,2015-08-12,26262,19838,46100
838,BMEB3,2015-09-30,2015-11-13,26262,19838,46100
839,BMEB3,2015-12-31,2016-03-30,26262,19838,46100
840,BMEB3,2016-03-31,2016-05-13,26262,19838,46100
841,BMEB3,2016-06-30,2016-08-11,26262,19838,46100
842,BMEB3,2016-09-30,2016-11-11,26262,19838,46100
843,BMEB3,2016-12-31,2017-03-31,26262,19838,46100
844,BMEB3,2017-03-31,2017-05-15,26262,19838,46100
845,BMEB3,2017-06-30,2017-08-10,26262,19838,46100
846,BMEB3,2017-09-30,2017-11-14,26262,19838,46100
847,BMEB3,2017-12-31,2018-03-29,26262,19838,46100
848,BMEB3,2018-03-31,2018-05-15,26262,19838,46100
849,BMEB3,2018-06-30,2018-08-13,26262,19838,46100
850,BMEB3,2018-09-30,2018-11-14,32578,19838,52416
851,BMEB3,2018-12-31,2019-03-29,32578,19838,52416
852,BMEB3,2019-03-31,2019-05-15,32578,19838,52416
853,BMEB3,2019-06-30,2019-08-14,32578,19838,52416
854,BMEB3,2019-09-30,2019-11-14,32578,19838,52416
855,BMEB3,2019-12-31,2020-03-27,32578,19838,52416
856,BMEB3,2020-03-31,2020-05-15,32578,19838,52416
857,BMEB3,2020-06-30,2020-08-14,32578,19838,52416
858,BMEB3,2020-09-30,2020-10-26,32578,19838,52416
859,BMEB3,2020-12-31,2021-03-02,32578,19838,52416
860,BMEB4,2010-12-31,2011-04-29,26262,9138,35400
861,BMEB4,2011-03-31,2011-05-17,26262,9138,35400
862,BMEB4,2011-06-30,2011-08-08,26262,9138,35400
863,BMEB4,2011-09-30,2011-11-14,26262,9138,35400
864,BMEB4,2011-12-31,2012-04-05,26262,9138,35400
865,BMEB4,2012-03-31,2012-05-15,26262,9138,35400
866,BMEB4,2012-06-30,2012-08-14,26262,9138,35400
867,BMEB4,2012-09-30,2012-11-14,26262,16238,42500
868,BMEB4,2012-12-31,2013-03-27,26262,16238,42500
869,BMEB4,2013-03-31,2013-05-14,26262,16238,42500
870,BMEB4,2013-06-30,2013-08-13,26262,16238,42500
871,BMEB4,2013-09-30,2013-11-13,26262,16238,42500
872,BMEB4,2013-12-31,2014-03-31,26262,19838,46100
873,BMEB4,2014-03-31,2014-05-15,26262,19838,46100
874,BMEB4,2014-06-30,2014-08-13,26262,19838,46100
875,BMEB4,2014-09-30,2014-11-14,26262,19838,46100
876,BMEB4,2014-12-31,2015-03-31,26262,19838,46100
877,BMEB4,2015-03-31,2015-05-15,26262,19838,46100
878,BMEB4,2015-06-30,2015-08-12,26262,19838,46100
879,BMEB4,2015-09-30,2015-11-13,26262,19838,46100
880,BMEB4,2015-12-31,2016-03-30,26262,19838,46100
881,BMEB4,2016-03-31,2016-05-13,26262,19838,46100
882,BMEB4,2016-06-30,2016-08-11,26262,19838,46100
883,BMEB4,2016-09-30,2016-11-11,26262,19838,46100
884,BMEB4,2016-12-31,2017-03-31,26262,19838,46100
885,BMEB4,2017-03-31,2017-05-15,26262,19838,46100
886,BMEB4,2017-06-30,2017-08-10,26262,19838,46100
887,BMEB4,2017-09-30,2017-11-14,26262,19838,46100
888,BMEB4,2017-12-31,2018-03-29,26262,19838,46100
889,BMEB4,2018-03-31,2018-05-15,26262,19838,46100
890,BMEB4,2018-06-30,2018-08-13,26262,19838,46100
891,BMEB4,2018-09-30,2018-11-14,32578,19838,52416
892,BMEB4,2018-12-31,2019-03-29,32578,19838,52416
893,BMEB4,2019-03-31,2019-05-15,32578,19838,52416
894,BMEB4,2019-06-30,2019-08-14,32578,19838,52416
895,BMEB4,2019-09-30,2019-11-14,32578,19838,52416
896,BMEB4,2019-12-31,2020-03-27,32578,19838,52416
897,BMEB4,2020-03-31,2020-05-15,32578,19838,52416
898,BMEB4,2020-06-30,2020-08-14,32578,19838,52416
899,BMEB4,2020-09-30,2020-10-26,32578,19838,52416
900,BMEB4,2020-12-31,2021-03-02,32578,19838,52416
901,BRIV3,2010-12-31,2011-03-25,53949,36275,90224
902,BRIV3,2011-03-31,2011-05-16,53949,36275,90224
903,BRIV3,2011-06-30,2011-08-12,53949,36275,90224
904,BRIV3,2011-09-30,2011-11-10,53949,36275,90224
905,BRIV3,2011-12-31,2012-03-23,53949,36275,90224
906,BRIV3,2012-03-31,2012-05-15,53949,36275,90224
907,BRIV3,2012-06-30,2012-08-14,53949,36275,90224
908,BRIV3,2012-09-30,2012-11-14,53949,36275,90224
909,BRIV3,2012-12-31,2013-03-14,53949,36275,90224
910,BRIV3,2013-03-31,2013-05-14,53949,36275,90224
911,BRIV3,2013-06-30,2013-09-02,53949,36275,90224
912,BRIV3,2013-09-30,2013-11-14,53949,36275,90224
913,BRIV3,2013-12-31,2014-03-20,53949,36275,90224
914,BRIV3,2014-03-31,2014-05-14,53949,36275,90224
915,BRIV3,2014-06-30,2014-08-26,53949,36275,90224
916,BRIV3,2014-09-30,2014-11-14,53949,36275,90224
917,BRIV3,2014-12-31,2015-03-20,53949,36275,90224
918,BRIV3,2015-03-31,2015-05-14,53949,36275,90224
919,BRIV3,2015-06-30,2015-08-13,53949,36275,90224
920,BRIV3,2015-09-30,2015-11-12,53949,36275,90224
921,BRIV3,2015-12-31,2016-04-11,53812,35118,88930
922,BRIV3,2016-03-31,2016-05-13,53812,35118,88930
923,BRIV3,2016-06-30,2016-08-11,53812,35118,88930
924,BRIV3,2016-09-30,2016-11-10,53812129,35118455,88930584
925,BRIV3,2016-12-31,2017-03-17,53812129,35118455,88930584
926,BRIV3,2017-03-31,2017-05-12,53812129,35118455,88930584
927,BRIV3,2017-06-30,2017-08-14,53812129,35118455,88930584
928,BRIV3,2017-09-30,2017-11-10,53812129,35118455,88930584
929,BRIV3,2017-12-31,2018-03-16,53812129,35118455,88930584
930,BRIV3,2018-03-31,2018-05-11,53535329,35118455,88653784
931,BRIV3,2018-06-30,2018-08-10,53482129,35118455,88600584
932,BRIV3,2018-09-30,2018-11-09,53482129,35118455,88600584
933,BRIV3,2018-12-31,2019-03-15,53482129,35118455,88600584
934,BRIV3,2019-03-31,2019-05-10,53482129,35118445,88600574
935,BRIV3,2019-06-30,2019-08-09,53482129,35118455,88600584
936,BRIV3,2019-09-30,2019-11-08,53482129,35118455,88600584
937,BRIV3,2019-12-31,2020-03-19,53482129,35118455,88600584
938,BRIV3,2020-03-31,2020-05-12,53482129,35118455,88600584
939,BRIV3,2020-06-30,2020-08-12,53482129,35118455,88600584
940,BRIV3,2020-09-30,2020-11-11,53482129,35118455,88600584
941,BRIV3,2020-12-31,2021-03-12,53482129,35118455,88600584
942,BRIV4,2010-12-31,2011-03-25,53949,36275,90224
943,BRIV4,2011-03-31,2011-05-16,53949,36275,90224
944,BRIV4,2011-06-30,2011-08-12,53949,36275,90224
945,BRIV4,2011-09-30,2011-11-10,53949,36275,90224
946,BRIV4,2011-12-31,2012-03-23,53949,36275,90224
947,BRIV4,2012-03-31,2012-05-15,53949,36275,90224
948,BRIV4,2012-06-30,2012-08-14,53949,36275,90224
949,BRIV4,2012-09-30,2012-11-14,53949,36275,90224
950,BRIV4,2012-12-31,2013-03-14,53949,36275,90224
951,BRIV4,2013-03-31,2013-05-14,53949,36275,90224
952,BRIV4,2013-06-30,2013-09-02,53949,36275,90224
953,BRIV4,2013-09-30,2013-11-14,53949,36275,90224
954,BRIV4,2013-12-31,2014-03-20,53949,36275,90224
955,BRIV4,2014-03-31,2014-05-14,53949,36275,90224
956,BRIV4,2014-06-30,2014-08-26,53949,36275,90224
957,BRIV4,2014-09-30,2014-11-14,53949,36275,90224
958,BRIV4,2014-12-31,2015-03-20,53949,36275,90224
959,BRIV4,2015-03-31,2015-05-14,53949,36275,90224
960,BRIV4,2015-06-30,2015-08-13,53949,36275,90224
961,BRIV4,2015-09-30,2015-11-12,53949,36275,90224
962,BRIV4,2015-12-31,2016-04-11,53812,35118,88930
963,BRIV4,2016-03-31,2016-05-13,53812,35118,88930
964,BRIV4,2016-06-30,2016-08-11,53812,35118,88930
965,BRIV4,2016-09-30,2016-11-10,53812129,35118455,88930584
966,BRIV4,2016-12-31,2017-03-17,53812129,35118455,88930584
967,BRIV4,2017-03-31,2017-05-12,53812129,35118455,88930584
968,BRIV4,2017-06-30,2017-08-14,53812129,35118455,88930584
969,BRIV4,2017-09-30,2017-11-10,53812129,35118455,88930584
970,BRIV4,2017-12-31,2018-03-16,53812129,35118455,88930584
971,BRIV4,2018-03-31,2018-05-11,53535329,35118455,88653784
972,BRIV4,2018-06-30,2018-08-10,53482129,35118455,88600584
973,BRIV4,2018-09-30,2018-11-09,53482129,35118455,88600584
974,BRIV4,2018-12-31,2019-03-15,53482129,35118455,88600584
975,BRIV4,2019-03-31,2019-05-10,53482129,35118445,88600574
976,BRIV4,2019-06-30,2019-08-09,53482129,35118455,88600584
977,BRIV4,2019-09-30,2019-11-08,53482129,35118455,88600584
978,BRIV4,2019-12-31,2020-03-19,53482129,35118455,88600584
979,BRIV4,2020-03-31,2020-05-12,53482129,35118455,88600584
980,BRIV4,2020-06-30,2020-08-12,53482129,35118455,88600584
981,BRIV4,2020-09-30,2020-11-11,53482129,35118455,88600584
982,BRIV4,2020-12-31,2021-03-12,53482129,35118455,88600584
983,BDLL3,2010-12-31,2011-04-06,607192,992808,1600000
984,BDLL3,2011-03-31,2011-05-27,607192,992808,1600000
985,BDLL3,2011-06-30,2011-08-15,607192,992808,1600000
986,BDLL3,2011-09-30,2011-11-11,607192,992808,1600000
987,BDLL3,2011-12-31,2012-03-23,607192,992808,1600000
988,BDLL3,2012-03-31,2012-05-15,607192,992808,1600000
989,BDLL3,2012-06-30,2012-08-14,607192,992808,1600000
990,BDLL3,2012-09-30,2012-11-14,607192,992808,1600000
991,BDLL3,2012-12-31,2013-03-28,607192,992808,1600000
992,BDLL3,2013-03-31,2013-05-24,607192,992808,1600000
993,BDLL3,2013-06-30,2013-08-14,607192,992808,1600000
994,BDLL3,2013-09-30,2013-11-14,607192,992808,1600000
995,BDLL3,2013-12-31,2014-03-28,607192,992808,1600000
996,BDLL3,2014-03-31,2014-05-19,607192,992808,1600000
997,BDLL3,2014-06-30,2014-08-14,607192,992808,1600000
998,BDLL3,2014-09-30,2014-11-14,607192,992808,1600000
999,BDLL3,2014-12-31,2015-03-31,607192,992808,1600000
1000,BDLL3,2015-03-31,2015-05-22,607192,992808,1600000
1001,BDLL3,2015-06-30,2015-08-24,607192,992808,1600000
1002,BDLL3,2015-09-30,2015-11-23,607192,992808,1600000
1003,BDLL3,2015-12-31,2016-03-29,607192,992808,1600000
1004,BDLL3,2016-03-31,2016-06-07,607192,992808,1600000
1005,BDLL3,2016-06-30,2016-08-29,607192,992808,1600000
1006,BDLL3,2016-09-30,2016-12-06,607192,992808,1600000
1007,BDLL3,2016-12-31,2017-03-31,607192,992808,1600000
1008,BDLL3,2017-03-31,2017-05-15,607192,992808,1600000
1009,BDLL3,2017-06-30,2017-08-14,607192,992808,1600000
1010,BDLL3,2017-09-30,2017-12-06,607192,992808,1600000
1011,BDLL3,2017-12-31,2018-03-28,607192,992808,1600000
1012,BDLL3,2018-03-31,2018-07-21,607192,992808,1600000
1013,BDLL3,2018-06-30,2018-10-31,607192,992808,1600000
1014,BDLL3,2018-09-30,2019-03-02,607192,992808,1600000
1015,BDLL3,2018-12-31,2019-03-31,607192,992808,1600000
1016,BDLL3,2019-03-31,2019-08-26,607192,992808,1600000
1017,BDLL3,2019-06-30,2019-12-02,607192,992808,1600000
1018,BDLL3,2019-09-30,2020-03-23,607192,992808,1600000
1019,BDLL3,2019-12-31,2020-07-11,607192,992808,1600000
1020,BDLL3,2020-03-31,2020-08-19,607192,992808,1600000
1021,BDLL3,2020-06-30,2020-11-26,607192,992808,1600000
1022,BDLL3,2020-09-30,2020-11-30,607192,992808,1600000
1023,BDLL4,2010-12-31,2011-04-06,607192,992808,1600000
1024,BDLL4,2011-03-31,2011-05-27,607192,992808,1600000
1025,BDLL4,2011-06-30,2011-08-15,607192,992808,1600000
1026,BDLL4,2011-09-30,2011-11-11,607192,992808,1600000
1027,BDLL4,2011-12-31,2012-03-23,607192,992808,1600000
1028,BDLL4,2012-03-31,2012-05-15,607192,992808,1600000
1029,BDLL4,2012-06-30,2012-08-14,607192,992808,1600000
1030,BDLL4,2012-09-30,2012-11-14,607192,992808,1600000
1031,BDLL4,2012-12-31,2013-03-28,607192,992808,1600000
1032,BDLL4,2013-03-31,2013-05-24,607192,992808,1600000
1033,BDLL4,2013-06-30,2013-08-14,607192,992808,1600000
1034,BDLL4,2013-09-30,2013-11-14,607192,992808,1600000
1035,BDLL4,2013-12-31,2014-03-28,607192,992808,1600000
1036,BDLL4,2014-03-31,2014-05-19,607192,992808,1600000
1037,BDLL4,2014-06-30,2014-08-14,607192,992808,1600000
1038,BDLL4,2014-09-30,2014-11-14,607192,992808,1600000
1039,BDLL4,2014-12-31,2015-03-31,607192,992808,1600000
1040,BDLL4,2015-03-31,2015-05-22,607192,992808,1600000
1041,BDLL4,2015-06-30,2015-08-24,607192,992808,1600000
1042,BDLL4,2015-09-30,2015-11-23,607192,992808,1600000
1043,BDLL4,2015-12-31,2016-03-29,607192,992808,1600000
1044,BDLL4,2016-03-31,2016-06-07,607192,992808,1600000
1045,BDLL4,2016-06-30,2016-08-29,607192,992808,1600000
1046,BDLL4,2016-09-30,2016-12-06,607192,992808,1600000
1047,BDLL4,2016-12-31,2017-03-31,607192,992808,1600000
1048,BDLL4,2017-03-31,2017-05-15,607192,992808,1600000
1049,BDLL4,2017-06-30,2017-08-14,607192,992808,1600000
1050,BDLL4,2017-09-30,2017-12-06,607192,992808,1600000
1051,BDLL4,2017-12-31,2018-03-28,607192,992808,1600000
1052,BDLL4,2018-03-31,2018-07-21,607192,992808,1600000
1053,BDLL4,2018-06-30,2018-10-31,607192,992808,1600000
1054,BDLL4,2018-09-30,2019-03-02,607192,992808,1600000
1055,BDLL4,2018-12-31,2019-03-31,607192,992808,1600000
1056,BDLL4,2019-03-31,2019-08-26,607192,992808,1600000
1057,BDLL4,2019-06-30,2019-12-02,607192,992808,1600000
1058,BDLL4,2019-09-30,2020-03-23,607192,992808,1600000
1059,BDLL4,2019-12-31,2020-07-11,607192,992808,1600000
1060,BDLL4,2020-03-31,2020-08-19,607192,992808,1600000
1061,BDLL4,2020-06-30,2020-11-26,607192,992808,1600000
1062,BDLL4,2020-09-30,2020-11-30,607192,992808,1600000
1063,BALM3,2010-12-31,2011-04-07,490000,490000,980000
1064,BALM3,2011-03-31,2011-05-17,490000,490000,980000
1065,BALM3,2011-06-30,2011-08-24,490000,490000,980000
1066,BALM3,2011-09-30,2011-11-14,490000,490000,980000
1067,BALM3,2011-12-31,2012-04-02,490000,490000,980000
1068,BALM3,2012-03-31,2012-05-15,490000,490000,980000
1069,BALM3,2012-06-30,2012-08-14,490000,490000,980000
1070,BALM3,2012-09-30,2012-11-14,490000,490000,980000
1071,BALM3,2012-12-31,2013-04-02,490000,490000,980000
1072,BALM3,2013-03-31,2013-05-16,490000,490000,980000
1073,BALM3,2013-06-30,2013-08-14,490000,490000,980000
1074,BALM3,2013-09-30,2013-11-14,490000,490000,980000
1075,BALM3,2013-12-31,2014-04-01,490000,490000,980000
1076,BALM3,2014-03-31,2014-05-14,490000,490000,980000
1077,BALM3,2014-06-30,2014-08-15,4900000,4900000,9800000
1078,BALM3,2014-09-30,2014-11-14,4900000,4900000,9800000
1079,BALM3,2014-12-31,2015-03-31,4900000,4900000,9800000
1080,BALM3,2015-03-31,2015-05-15,4900000,4900000,9800000
1081,BALM3,2015-06-30,2015-08-14,4900000,4900000,9800000
1082,BALM3,2015-09-30,2015-11-14,4900000,4900000,9800000
1083,BALM3,2015-12-31,2016-04-01,4900000,4900000,9800000
1084,BALM3,2016-03-31,2016-05-14,4900000,4900000,9800000
1085,BALM3,2016-06-30,2016-08-13,4900000,4900000,9800000
1086,BALM3,2016-09-30,2016-11-14,4900000,4900000,9800000
1087,BALM3,2016-12-31,2017-03-31,4900000,4900000,9800000
1088,BALM3,2017-03-31,2017-05-15,4900000,4900000,9800000
1089,BALM3,2017-06-30,2017-08-15,4900000,4900000,9800000
1090,BALM3,2017-09-30,2017-11-14,4900000,4900000,9800000
1091,BALM3,2017-12-31,2018-03-28,4900000,4900000,9800000
1092,BALM3,2018-03-31,2018-05-14,4900000,4900000,9800000
1093,BALM3,2018-06-30,2018-08-14,4900000,4900000,9800000
1094,BALM3,2018-09-30,2018-11-14,4900000,4900000,9800000
1095,BALM3,2018-12-31,2019-03-28,4900000,4900000,9800000
1096,BALM3,2019-03-31,2019-05-14,4888100,4896900,9785000
1097,BALM3,2019-06-30,2019-08-14,4888100,4896900,9785000
1098,BALM3,2019-09-30,2019-11-14,4900000,4900000,9800000
1099,BALM3,2019-12-31,2020-03-30,4900000,4900000,9800000
1100,BALM3,2020-03-31,2020-06-29,4900000,4900000,9800000
1101,BALM3,2020-06-30,2020-08-31,4900000,4900000,9800000
1102,BALM3,2020-09-30,2020-11-16,4900000,4900000,9800000
1103,BALM4,2010-12-31,2011-04-07,490000,490000,980000
1104,BALM4,2011-03-31,2011-05-17,490000,490000,980000
1105,BALM4,2011-06-30,2011-08-24,490000,490000,980000
1106,BALM4,2011-09-30,2011-11-14,490000,490000,980000
1107,BALM4,2011-12-31,2012-04-02,490000,490000,980000
1108,BALM4,2012-03-31,2012-05-15,490000,490000,980000
1109,BALM4,2012-06-30,2012-08-14,490000,490000,980000
1110,BALM4,2012-09-30,2012-11-14,490000,490000,980000
1111,BALM4,2012-12-31,2013-04-02,490000,490000,980000
1112,BALM4,2013-03-31,2013-05-16,490000,490000,980000
1113,BALM4,2013-06-30,2013-08-14,490000,490000,980000
1114,BALM4,2013-09-30,2013-11-14,490000,490000,980000
1115,BALM4,2013-12-31,2014-04-01,490000,490000,980000
1116,BALM4,2014-03-31,2014-05-14,490000,490000,980000
1117,BALM4,2014-06-30,2014-08-15,4900000,4900000,9800000
1118,BALM4,2014-09-30,2014-11-14,4900000,4900000,9800000
1119,BALM4,2014-12-31,2015-03-31,4900000,4900000,9800000
1120,BALM4,2015-03-31,2015-05-15,4900000,4900000,9800000
1121,BALM4,2015-06-30,2015-08-14,4900000,4900000,9800000
1122,BALM4,2015-09-30,2015-11-14,4900000,4900000,9800000
1123,BALM4,2015-12-31,2016-04-01,4900000,4900000,9800000
1124,BALM4,2016-03-31,2016-05-14,4900000,4900000,9800000
1125,BALM4,2016-06-30,2016-08-13,4900000,4900000,9800000
1126,BALM4,2016-09-30,2016-11-14,4900000,4900000,9800000
1127,BALM4,2016-12-31,2017-03-31,4900000,4900000,9800000
1128,BALM4,2017-03-31,2017-05-15,4900000,4900000,9800000
1129,BALM4,2017-06-30,2017-08-15,4900000,4900000,9800000
1130,BALM4,2017-09-30,2017-11-14,4900000,4900000,9800000
1131,BALM4,2017-12-31,2018-03-28,4900000,4900000,9800000
1132,BALM4,2018-03-31,2018-05-14,4900000,4900000,9800000
1133,BALM4,2018-06-30,2018-08-14,4900000,4900000,9800000
1134,BALM4,2018-09-30,2018-11-14,4900000,4900000,9800000
1135,BALM4,2018-12-31,2019-03-28,4900000,4900000,9800000
1136,BALM4,2019-03-31,2019-05-14,4888100,4896900,9785000
1137,BALM4,2019-06-30,2019-08-14,4888100,4896900,9785000
1138,BALM4,2019-09-30,2019-11-14,4900000,4900000,9800000
1139,BALM4,2019-12-31,2020-03-30,4900000,4900000,9800000
1140,BALM4,2020-03-31,2020-06-29,4900000,4900000,9800000
1141,BALM4,2020-06-30,2020-08-31,4900000,4900000,9800000
1142,BALM4,2020-09-30,2020-11-16,4900000,4900000,9800000
1143,BAUH3,2010-12-31,2011-03-24,2847,2375,5222
1144,BAUH3,2011-03-31,2011-05-13,2846929,2375293,5222222
1145,BAUH3,2011-06-30,2011-08-15,2846929,2375293,5222222
1146,BAUH3,2011-09-30,2011-10-27,2846929,2375293,5222222
1147,BAUH3,2011-12-31,2012-03-23,2847,2375,5222
1148,BAUH3,2012-03-31,2012-05-16,2847,2375,5222
1149,BAUH3,2012-06-30,2012-08-14,2847,2375,5222
1150,BAUH3,2012-09-30,2012-10-24,2847,2375,5222
1151,BAUH3,2012-12-31,2013-03-25,2847,2375,5222
1152,BAUH3,2013-03-31,2013-05-14,2847,2375,5222
1153,BAUH3,2013-06-30,2013-08-08,2847,2375,5222
1154,BAUH3,2013-09-30,2013-11-13,2847,2375,5222
1155,BAUH3,2013-12-31,2014-03-25,2847,2375,5222
1156,BAUH3,2014-03-31,2014-05-14,2847,2375,5222
1157,BAUH3,2014-06-30,2014-08-14,2847,2375,5222
1158,BAUH3,2014-09-30,2014-11-12,2847,2375,5222
1159,BAUH3,2014-12-31,2015-03-16,2847,2375,5222
1160,BAUH3,2015-03-31,2015-05-15,2847,2375,5222
1161,BAUH3,2015-06-30,2015-08-13,2847,2375,5222
1162,BAUH3,2015-09-30,2015-11-11,2847,2375,5222
1163,BAUH3,2015-12-31,2016-03-16,2847,2375,5222
1164,BAUH3,2016-03-31,2016-05-11,2847,2375,5222
1165,BAUH3,2016-06-30,2016-08-10,2847,2375,5222
1166,BAUH3,2016-09-30,2016-11-14,2847,2375,5222
1167,BAUH3,2016-12-31,2017-03-13,2847,2375,5222
1168,BAUH3,2017-03-31,2017-05-15,2847,2375,5222
1169,BAUH3,2017-06-30,2017-08-10,2847,2375,5222
1170,BAUH3,2017-09-30,2017-11-10,2847,2375,5222
1171,BAUH3,2017-12-31,2018-02-23,2847,2375,5222
1172,BAUH3,2018-03-31,2018-05-14,2847,2375,5222
1173,BAUH3,2018-06-30,2018-08-10,2847,2375,5222
1174,BAUH3,2018-09-30,2018-11-08,2847,2375,5222
1175,BAUH3,2018-12-31,2019-02-21,2847,2375,5222
1176,BAUH3,2019-03-31,2019-05-12,2847,2375,5222
1177,BAUH3,2019-06-30,2019-08-09,2847,2375,5222
1178,BAUH3,2019-09-30,2019-11-07,2847,2375,5222
1179,BAUH3,2019-12-31,2020-02-18,2847,2375,5222
1180,BAUH3,2020-03-31,2020-07-21,2847,2375,5222
1181,BAUH3,2020-06-30,2020-12-01,2847,2375,5222
1182,BAUH3,2020-09-30,2020-12-01,2847,2375,5222
1183,BAUH3,2020-12-31,2021-02-19,2847,2375,5222
1184,BAUH4,2010-12-31,2011-03-24,2847,2375,5222
1185,BAUH4,2011-03-31,2011-05-13,2846929,2375293,5222222
1186,BAUH4,2011-06-30,2011-08-15,2846929,2375293,5222222
1187,BAUH4,2011-09-30,2011-10-27,2846929,2375293,5222222
1188,BAUH4,2011-12-31,2012-03-23,2847,2375,5222
1189,BAUH4,2012-03-31,2012-05-16,2847,2375,5222
1190,BAUH4,2012-06-30,2012-08-14,2847,2375,5222
1191,BAUH4,2012-09-30,2012-10-24,2847,2375,5222
1192,BAUH4,2012-12-31,2013-03-25,2847,2375,5222
1193,BAUH4,2013-03-31,2013-05-14,2847,2375,5222
1194,BAUH4,2013-06-30,2013-08-08,2847,2375,5222
1195,BAUH4,2013-09-30,2013-11-13,2847,2375,5222
1196,BAUH4,2013-12-31,2014-03-25,2847,2375,5222
1197,BAUH4,2014-03-31,2014-05-14,2847,2375,5222
1198,BAUH4,2014-06-30,2014-08-14,2847,2375,5222
1199,BAUH4,2014-09-30,2014-11-12,2847,2375,5222
1200,BAUH4,2014-12-31,2015-03-16,2847,2375,5222
1201,BAUH4,2015-03-31,2015-05-15,2847,2375,5222
1202,BAUH4,2015-06-30,2015-08-13,2847,2375,5222
1203,BAUH4,2015-09-30,2015-11-11,2847,2375,5222
1204,BAUH4,2015-12-31,2016-03-16,2847,2375,5222
1205,BAUH4,2016-03-31,2016-05-11,2847,2375,5222
1206,BAUH4,2016-06-30,2016-08-10,2847,2375,5222
1207,BAUH4,2016-09-30,2016-11-14,2847,2375,5222
1208,BAUH4,2016-12-31,2017-03-13,2847,2375,5222
1209,BAUH4,2017-03-31,2017-05-15,2847,2375,5222
1210,BAUH4,2017-06-30,2017-08-10,2847,2375,5222
1211,BAUH4,2017-09-30,2017-11-10,2847,2375,5222
1212,BAUH4,2017-12-31,2018-02-23,2847,2375,5222
1213,BAUH4,2018-03-31,2018-05-14,2847,2375,5222
1214,BAUH4,2018-06-30,2018-08-10,2847,2375,5222
1215,BAUH4,2018-09-30,2018-11-08,2847,2375,5222
1216,BAUH4,2018-12-31,2019-02-21,2847,2375,5222
1217,BAUH4,2019-03-31,2019-05-12,2847,2375,5222
1218,BAUH4,2019-06-30,2019-08-09,2847,2375,5222
1219,BAUH4,2019-09-30,2019-11-07,2847,2375,5222
1220,BAUH4,2019-12-31,2020-02-18,2847,2375,5222
1221,BAUH4,2020-03-31,2020-07-21,2847,2375,5222
1222,BAUH4,2020-06-30,2020-12-01,2847,2375,5222
1223,BAUH4,2020-09-30,2020-12-01,2847,2375,5222
1224,BAUH4,2020-12-31,2021-02-19,2847,2375,5222
1225,BMKS3,2010-12-31,2011-03-28,454750,0,454750
1226,BMKS3,2011-03-31,2011-05-16,454750,0,454750
1227,BMKS3,2011-06-30,2011-08-15,454750,0,454750
1228,BMKS3,2011-09-30,2011-11-11,454750,0,454750
1229,BMKS3,2011-12-31,2012-03-28,454750,0,454750
1230,BMKS3,2012-03-31,2012-05-15,454750,0,454750
1231,BMKS3,2012-06-30,2012-08-16,454750,0,454750
1232,BMKS3,2012-09-30,2012-11-13,454750,0,454750
1233,BMKS3,2012-12-31,2013-03-25,454750,0,454750
1234,BMKS3,2013-03-31,2013-05-14,454750,0,454750
1235,BMKS3,2013-06-30,2013-08-13,454750,0,454750
1236,BMKS3,2013-09-30,2013-11-12,454750,0,454750
1237,BMKS3,2013-12-31,2014-03-25,454750,0,454750
1238,BMKS3,2014-03-31,2014-05-14,454750,0,454750
1239,BMKS3,2014-06-30,2014-08-13,454750,0,454750
1240,BMKS3,2014-09-30,2014-11-13,454750,0,454750
1241,BMKS3,2014-12-31,2015-04-06,454750,0,454750
1242,BMKS3,2015-03-31,2015-05-13,454750,0,454750
1243,BMKS3,2015-06-30,2015-08-10,454750,0,454750
1244,BMKS3,2015-09-30,2015-11-12,454750,0,454750
1245,BMKS3,2015-12-31,2016-03-17,454750,0,454750
1246,BMKS3,2016-03-31,2016-05-11,454750,0,454750
1247,BMKS3,2016-06-30,2016-08-03,454750,0,454750
1248,BMKS3,2016-09-30,2016-11-04,454750,0,454750
1249,BMKS3,2016-12-31,2017-03-20,454750,0,454750
1250,BMKS3,2017-03-31,2017-05-05,454750,0,454750
1251,BMKS3,2017-06-30,2017-08-09,454750,0,454750
1252,BMKS3,2017-09-30,2017-11-13,454750,0,454750
1253,BMKS3,2017-12-31,2018-03-19,454750,0,454750
1254,BMKS3,2018-03-31,2018-05-14,454750,0,454750
1255,BMKS3,2018-06-30,2018-08-14,454750,0,454750
1256,BMKS3,2018-09-30,2018-11-12,454750,0,454750
1257,BMKS3,2018-12-31,2019-03-15,454750,0,454750
1258,BMKS3,2019-03-31,2019-05-14,454750,0,454750
1259,BMKS3,2019-06-30,2019-08-12,454750,0,454750
1260,BMKS3,2019-09-30,2019-11-11,454750,0,454750
1261,BMKS3,2019-12-31,2020-03-20,454750,0,454750
1262,BMKS3,2020-03-31,2020-05-22,454750,0,454750
1263,BMKS3,2020-06-30,2020-08-20,454750,0,454750
1264,BMKS3,2020-09-30,2020-11-11,454750,0,454750
1265,CAMB3,2010-12-31,2011-03-25,12421,24539,36960
1266,CAMB3,2011-03-31,2011-05-12,12421,24539,36960
1267,CAMB3,2011-06-30,2011-08-15,12421,24539,36960
1268,CAMB3,2011-09-30,2011-11-11,12421,24539,36960
1269,CAMB3,2011-12-31,2012-03-23,12421,24539,36960
1270,CAMB3,2012-03-31,2012-05-14,12421,24539,36960
1271,CAMB3,2012-06-30,2012-08-09,12421,24539,36960
1272,CAMB3,2012-09-30,2012-11-13,12421,24539,36960
1273,CAMB3,2012-12-31,2013-03-28,12421,24539,36960
1274,CAMB3,2013-03-31,2013-05-14,12421,24539,36960
1275,CAMB3,2013-06-30,2013-08-15,12421,24539,36960
1276,CAMB3,2013-09-30,2013-11-14,12421,24539,36960
1277,CAMB3,2013-12-31,2014-05-29,13087,25465,38552
1278,CAMB3,2014-03-31,2014-05-29,13087,25465,38552
1279,CAMB3,2014-06-30,2014-08-14,13087,25465,38552
1280,CAMB3,2014-09-30,2014-11-14,13087,25465,38552
1281,CAMB3,2014-12-31,2015-03-30,13087,25465,38552
1282,CAMB3,2015-03-31,2015-05-15,13087,25465,38552
1283,CAMB3,2015-06-30,2015-08-18,13087,25465,38552
1284,CAMB3,2015-09-30,2015-11-13,13087,25465,38552
1285,CAMB3,2015-12-31,2016-05-26,13087,25465,38552
1286,CAMB3,2016-03-31,2016-06-24,13087,25465,38552
1287,CAMB3,2016-06-30,2016-08-12,1309,2546,3855
1288,CAMB3,2016-09-30,2016-11-10,1309,2546,3855
1289,CAMB3,2016-12-31,2017-03-24,1309,2546,3855
1290,CAMB3,2017-03-31,2017-05-15,1309,2546,3855
1291,CAMB3,2017-06-30,2017-08-15,1309,2546,3855
1292,CAMB3,2017-09-30,2017-11-13,1309,2546,3855
1293,CAMB3,2017-12-31,2018-04-20,1309,2546,3855
1294,CAMB3,2018-03-31,2018-06-01,1309,2546,3855
1295,CAMB3,2018-06-30,2018-08-14,1309,2546,3855
1296,CAMB3,2018-09-30,2018-11-13,1309,2546,3855
1297,CAMB3,2018-12-31,2019-03-15,1309,2546,3855
1298,CAMB3,2019-03-31,2019-05-08,1309,2546,3855
1299,CAMB3,2019-06-30,2019-08-01,1429,2769,4198
1300,CAMB3,2019-09-30,2019-10-31,14292,27688,41980
1301,CAMB3,2019-12-31,2020-03-06,41980080,0,41980080
1302,CAMB3,2020-03-31,2020-04-30,41980080,0,41980080
1303,CAMB3,2020-06-30,2020-07-30,41980080,0,41980080
1304,CAMB3,2020-09-30,2020-10-29,42100080,0,42100080
1305,CAMB3,2020-12-31,2021-02-12,42100080,0,42100080
1306,CAMB4,2010-12-31,2011-03-25,12421,24539,36960
1307,CAMB4,2011-03-31,2011-05-12,12421,24539,36960
1308,CAMB4,2011-06-30,2011-08-15,12421,24539,36960
1309,CAMB4,2011-09-30,2011-11-11,12421,24539,36960
1310,CAMB4,2011-12-31,2012-03-23,12421,24539,36960
1311,CAMB4,2012-03-31,2012-05-14,12421,24539,36960
1312,CAMB4,2012-06-30,2012-08-09,12421,24539,36960
1313,CAMB4,2012-09-30,2012-11-13,12421,24539,36960
1314,CAMB4,2012-12-31,2013-03-28,12421,24539,36960
1315,CAMB4,2013-03-31,2013-05-14,12421,24539,36960
1316,CAMB4,2013-06-30,2013-08-15,12421,24539,36960
1317,CAMB4,2013-09-30,2013-11-14,12421,24539,36960
1318,CAMB4,2013-12-31,2014-05-29,13087,25465,38552
1319,CAMB4,2014-03-31,2014-05-29,13087,25465,38552
1320,CAMB4,2014-06-30,2014-08-14,13087,25465,38552
1321,CAMB4,2014-09-30,2014-11-14,13087,25465,38552
1322,CAMB4,2014-12-31,2015-03-30,13087,25465,38552
1323,CAMB4,2015-03-31,2015-05-15,13087,25465,38552
1324,CAMB4,2015-06-30,2015-08-18,13087,25465,38552
1325,CAMB4,2015-09-30,2015-11-13,13087,25465,38552
1326,CAMB4,2015-12-31,2016-05-26,13087,25465,38552
1327,CAMB4,2016-03-31,2016-06-24,13087,25465,38552
1328,CAMB4,2016-06-30,2016-08-12,1309,2546,3855
1329,CAMB4,2016-09-30,2016-11-10,1309,2546,3855
1330,CAMB4,2016-12-31,2017-03-24,1309,2546,3855
1331,CAMB4,2017-03-31,2017-05-15,1309,2546,3855
1332,CAMB4,2017-06-30,2017-08-15,1309,2546,3855
1333,CAMB4,2017-09-30,2017-11-13,1309,2546,3855
1334,CAMB4,2017-12-31,2018-04-20,1309,2546,3855
1335,CAMB4,2018-03-31,2018-06-01,1309,2546,3855
1336,CAMB4,2018-06-30,2018-08-14,1309,2546,3855
1337,CAMB4,2018-09-30,2018-11-13,1309,2546,3855
1338,CAMB4,2018-12-31,2019-03-15,1309,2546,3855
1339,CAMB4,2019-03-31,2019-05-08,1309,2546,3855
1340,CAMB4,2019-06-30,2019-08-01,1429,2769,4198
1341,CAMB4,2019-09-30,2019-10-31,14292,27688,41980
1342,CAMB4,2019-12-31,2020-03-06,41980080,0,41980080
1343,CAMB4,2020-03-31,2020-04-30,41980080,0,41980080
1344,CAMB4,2020-06-30,2020-07-30,41980080,0,41980080
1345,CAMB4,2020-09-30,2020-10-29,42100080,0,42100080
1346,CAMB4,2020-12-31,2021-02-12,42100080,0,42100080
1347,RANI3,2010-12-31,2011-03-29,7464,640,8104
1348,RANI3,2011-03-31,2011-05-13,7464,640,8104
1349,RANI3,2011-06-30,2011-08-05,7464,640,8104
1350,RANI3,2011-09-30,2011-11-03,7464,640,8104
1351,RANI3,2011-12-31,2012-03-07,7464,640,8104
1352,RANI3,2012-03-31,2012-04-16,7464,640,8104
1353,RANI3,2012-06-30,2013-02-25,149280,12810,162090
1354,RANI3,2012-09-30,2012-10-30,149280,12810,162090
1355,RANI3,2012-12-31,2013-03-20,149280,12810,162090
1356,RANI3,2013-03-31,2013-04-30,149280,12810,162090
1357,RANI3,2013-06-30,2013-07-31,149280,12810,162090
1358,RANI3,2013-09-30,2013-10-31,149280,12810,162090
1359,RANI3,2013-12-31,2014-02-28,153910,12810,166720
1360,RANI3,2014-03-31,2014-04-30,153910,12810,166720
1361,RANI3,2014-06-30,2014-08-05,153910,12810,166720
1362,RANI3,2014-09-30,2014-10-31,153910,12810,166720
1363,RANI3,2014-12-31,2015-02-27,153910,12810,166720
1364,RANI3,2015-03-31,2015-04-30,153910,12810,166720
1365,RANI3,2015-06-30,2015-07-31,153910,12810,166720
1366,RANI3,2015-09-30,2015-10-30,153910,12810,166720
1367,RANI3,2015-12-31,2016-02-29,153910,12810,166720
1368,RANI3,2016-03-31,2016-04-29,153910,12810,166720
1369,RANI3,2016-06-30,2016-07-29,153910,12810,166720
1370,RANI3,2016-09-30,2016-10-17,153910,12810,166720
1371,RANI3,2016-12-31,2017-02-24,153910,12810,166720
1372,RANI3,2017-03-31,2017-04-28,153910,12810,166720
1373,RANI3,2017-06-30,2017-08-11,153910,12810,166720
1374,RANI3,2017-09-30,2017-11-06,153910,12810,166720
1375,RANI3,2017-12-31,2018-04-27,153910,12810,166720
1376,RANI3,2018-03-31,2018-06-21,153910,12810,166720
1377,RANI3,2018-06-30,2018-07-31,153910,12810,166720
1378,RANI3,2018-09-30,2018-10-31,153910,12810,166720
1379,RANI3,2018-12-31,2019-03-01,153910,12810,166720
1380,RANI3,2019-03-31,2019-04-30,153910,12810,166720
1381,RANI3,2019-06-30,2019-08-05,153910,12810,166720
1382,RANI3,2019-09-30,2019-10-31,153910,12810,166720
1383,RANI3,2019-12-31,2020-03-13,153910,12810,166720
1384,RANI3,2020-03-31,2020-05-06,153910,12810,166720
1385,RANI3,2020-06-30,2020-07-31,153910,12810,166720
1386,RANI3,2020-09-30,2020-10-30,243910,12810,256720
1387,RANI3,2020-12-31,2021-02-26,256720,0,256720
1388,RANI4,2010-12-31,2011-03-29,7464,640,8104
1389,RANI4,2011-03-31,2011-05-13,7464,640,8104
1390,RANI4,2011-06-30,2011-08-05,7464,640,8104
1391,RANI4,2011-09-30,2011-11-03,7464,640,8104
1392,RANI4,2011-12-31,2012-03-07,7464,640,8104
1393,RANI4,2012-03-31,2012-04-16,7464,640,8104
1394,RANI4,2012-06-30,2013-02-25,149280,12810,162090
1395,RANI4,2012-09-30,2012-10-30,149280,12810,162090
1396,RANI4,2012-12-31,2013-03-20,149280,12810,162090
1397,RANI4,2013-03-31,2013-04-30,149280,12810,162090
1398,RANI4,2013-06-30,2013-07-31,149280,12810,162090
1399,RANI4,2013-09-30,2013-10-31,149280,12810,162090
1400,RANI4,2013-12-31,2014-02-28,153910,12810,166720
1401,RANI4,2014-03-31,2014-04-30,153910,12810,166720
1402,RANI4,2014-06-30,2014-08-05,153910,12810,166720
1403,RANI4,2014-09-30,2014-10-31,153910,12810,166720
1404,RANI4,2014-12-31,2015-02-27,153910,12810,166720
1405,RANI4,2015-03-31,2015-04-30,153910,12810,166720
1406,RANI4,2015-06-30,2015-07-31,153910,12810,166720
1407,RANI4,2015-09-30,2015-10-30,153910,12810,166720
1408,RANI4,2015-12-31,2016-02-29,153910,12810,166720
1409,RANI4,2016-03-31,2016-04-29,153910,12810,166720
1410,RANI4,2016-06-30,2016-07-29,153910,12810,166720
1411,RANI4,2016-09-30,2016-10-17,153910,12810,166720
1412,RANI4,2016-12-31,2017-02-24,153910,12810,166720
1413,RANI4,2017-03-31,2017-04-28,153910,12810,166720
1414,RANI4,2017-06-30,2017-08-11,153910,12810,166720
1415,RANI4,2017-09-30,2017-11-06,153910,12810,166720
1416,RANI4,2017-12-31,2018-04-27,153910,12810,166720
1417,RANI4,2018-03-31,2018-06-21,153910,12810,166720
1418,RANI4,2018-06-30,2018-07-31,153910,12810,166720
1419,RANI4,2018-09-30,2018-10-31,153910,12810,166720
1420,RANI4,2018-12-31,2019-03-01,153910,12810,166720
1421,RANI4,2019-03-31,2019-04-30,153910,12810,166720
1422,RANI4,2019-06-30,2019-08-05,153910,12810,166720
1423,RANI4,2019-09-30,2019-10-31,153910,12810,166720
1424,RANI4,2019-12-31,2020-03-13,153910,12810,166720
1425,RANI4,2020-03-31,2020-05-06,153910,12810,166720
1426,RANI4,2020-06-30,2020-07-31,153910,12810,166720
1427,RANI4,2020-09-30,2020-10-30,243910,12810,256720
1428,RANI4,2020-12-31,2021-02-26,256720,0,256720
1429,ELET3,2010-12-31,2012-03-20,905023527,227333563,1132357090
1430,ELET3,2011-03-31,2011-06-20,1087050297,265583803,1352634100
1431,ELET3,2011-06-30,2011-08-26,1087050297,265583803,1352634100
1432,ELET3,2011-09-30,2011-11-16,1087050297,265583803,1352634100
1433,ELET3,2011-12-31,2012-04-17,1087050297,265583803,1352634100
1434,ELET3,2012-03-31,2012-06-01,1087050297,265583803,1352634100
1435,ELET3,2012-06-30,2012-08-14,1087050297,265583803,1352634100
1436,ELET3,2012-09-30,2012-11-14,1087050297,265583803,1352634100
1437,ELET3,2012-12-31,2013-04-12,1087050297,265583803,1352634100
1438,ELET3,2013-03-31,2013-05-15,1087050297,265583803,1352634100
1439,ELET3,2013-06-30,2013-08-14,1087050297,265583803,1352634100
1440,ELET3,2013-09-30,2013-11-14,1087050297,265583803,1352634100
1441,ELET3,2013-12-31,2014-04-03,1087050297,265583803,1352634100
1442,ELET3,2014-03-31,2014-05-15,1087050297,265583803,1352634100
1443,ELET3,2014-06-30,2014-08-12,1087050297,265583803,1352634100
1444,ELET3,2014-09-30,2014-11-14,1087050297,265583803,1352634100
1445,ELET3,2014-12-31,2015-04-09,1087050297,265583803,1352634100
1446,ELET3,2015-03-31,2015-05-15,1087050297,265583803,1352634100
1447,ELET3,2015-06-30,2015-08-14,1087050297,265583803,1352634100
1448,ELET3,2015-09-30,2015-11-12,1087050297,265583803,1352634100
1449,ELET3,2015-12-31,2016-03-31,1087050297,265583803,1352634100
1450,ELET3,2016-03-31,2016-05-11,1087050297,265583803,1352634100
1451,ELET3,2016-06-30,2016-08-15,1087050297,265583803,1352634100
1452,ELET3,2016-09-30,2016-11-09,1087050297,265583803,1352634100
1453,ELET3,2016-12-31,2017-03-27,1087050297,265583803,1352634100
1454,ELET3,2017-03-31,2017-05-12,1087050297,265583803,1352634100
1455,ELET3,2017-06-30,2017-08-14,1087050297,265583803,1352634100
1456,ELET3,2017-09-30,2017-11-13,1087050297,265583803,1352634100
1457,ELET3,2017-12-31,2018-03-27,1087050297,265583803,1352634100
1458,ELET3,2018-03-31,2018-05-15,1087050297,265583803,1352634100
1459,ELET3,2018-06-30,2018-08-14,1087050297,265583803,1352634100
1460,ELET3,2018-09-30,2018-11-12,1087050297,265583803,1352634100
1461,ELET3,2018-12-31,2019-03-27,1087050297,265583803,1352634100
1462,ELET3,2019-03-31,2019-05-13,1087050297,265583803,1352634100
1463,ELET3,2019-06-30,2019-08-12,1087050297,265583803,1352634100
1464,ELET3,2019-09-30,2019-11-11,1087050297,265583803,1352634100
1465,ELET3,2019-12-31,2020-03-27,1087050297,265583803,1352634100
1466,ELET3,2020-03-31,2020-05-28,1288842596,280088314,1568930910
1467,ELET3,2020-06-30,2020-08-12,1288842596,280088314,1568930910
1468,ELET3,2020-09-30,2020-11-11,1288842596,280088314,1568930910
1469,ELET3,2020-12-31,2021-03-19,1288842596,280088314,1568930910
1470,ELET5,2010-12-31,2012-03-20,905023527,227333563,1132357090
1471,ELET5,2011-03-31,2011-06-20,1087050297,265583803,1352634100
1472,ELET5,2011-06-30,2011-08-26,1087050297,265583803,1352634100
1473,ELET5,2011-09-30,2011-11-16,1087050297,265583803,1352634100
1474,ELET5,2011-12-31,2012-04-17,1087050297,265583803,1352634100
1475,ELET5,2012-03-31,2012-06-01,1087050297,265583803,1352634100
1476,ELET5,2012-06-30,2012-08-14,1087050297,265583803,1352634100
1477,ELET5,2012-09-30,2012-11-14,1087050297,265583803,1352634100
1478,ELET5,2012-12-31,2013-04-12,1087050297,265583803,1352634100
1479,ELET5,2013-03-31,2013-05-15,1087050297,265583803,1352634100
1480,ELET5,2013-06-30,2013-08-14,1087050297,265583803,1352634100
1481,ELET5,2013-09-30,2013-11-14,1087050297,265583803,1352634100
1482,ELET5,2013-12-31,2014-04-03,1087050297,265583803,1352634100
1483,ELET5,2014-03-31,2014-05-15,1087050297,265583803,1352634100
1484,ELET5,2014-06-30,2014-08-12,1087050297,265583803,1352634100
1485,ELET5,2014-09-30,2014-11-14,1087050297,265583803,1352634100
1486,ELET5,2014-12-31,2015-04-09,1087050297,265583803,1352634100
1487,ELET5,2015-03-31,2015-05-15,1087050297,265583803,1352634100
1488,ELET5,2015-06-30,2015-08-14,1087050297,265583803,1352634100
1489,ELET5,2015-09-30,2015-11-12,1087050297,265583803,1352634100
1490,ELET5,2015-12-31,2016-03-31,1087050297,265583803,1352634100
1491,ELET5,2016-03-31,2016-05-11,1087050297,265583803,1352634100
1492,ELET5,2016-06-30,2016-08-15,1087050297,265583803,1352634100
1493,ELET5,2016-09-30,2016-11-09,1087050297,265583803,1352634100
1494,ELET5,2016-12-31,2017-03-27,1087050297,265583803,1352634100
1495,ELET5,2017-03-31,2017-05-12,1087050297,265583803,1352634100
1496,ELET5,2017-06-30,2017-08-14,1087050297,265583803,1352634100
1497,ELET5,2017-09-30,2017-11-13,1087050297,265583803,1352634100
1498,ELET5,2017-12-31,2018-03-27,1087050297,265583803,1352634100
1499,ELET5,2018-03-31,2018-05-15,1087050297,265583803,1352634100
1500,ELET5,2018-06-30,2018-08-14,1087050297,265583803,1352634100
1501,ELET5,2018-09-30,2018-11-12,1087050297,265583803,1352634100
1502,ELET5,2018-12-31,2019-03-27,1087050297,265583803,1352634100
1503,ELET5,2019-03-31,2019-05-13,1087050297,265583803,1352634100
1504,ELET5,2019-06-30,2019-08-12,1087050297,265583803,1352634100
1505,ELET5,2019-09-30,2019-11-11,1087050297,265583803,1352634100
1506,ELET5,2019-12-31,2020-03-27,1087050297,265583803,1352634100
1507,ELET5,2020-03-31,2020-05-28,1288842596,280088314,1568930910
1508,ELET5,2020-06-30,2020-08-12,1288842596,280088314,1568930910
1509,ELET5,2020-09-30,2020-11-11,1288842596,280088314,1568930910
1510,ELET5,2020-12-31,2021-03-19,1288842596,280088314,1568930910
1511,ELET6,2010-12-31,2012-03-20,905023527,227333563,1132357090
1512,ELET6,2011-03-31,2011-06-20,1087050297,265583803,1352634100
1513,ELET6,2011-06-30,2011-08-26,1087050297,265583803,1352634100
1514,ELET6,2011-09-30,2011-11-16,1087050297,265583803,1352634100
1515,ELET6,2011-12-31,2012-04-17,1087050297,265583803,1352634100
1516,ELET6,2012-03-31,2012-06-01,1087050297,265583803,1352634100
1517,ELET6,2012-06-30,2012-08-14,1087050297,265583803,1352634100
1518,ELET6,2012-09-30,2012-11-14,1087050297,265583803,1352634100
1519,ELET6,2012-12-31,2013-04-12,1087050297,265583803,1352634100
1520,ELET6,2013-03-31,2013-05-15,1087050297,265583803,1352634100
1521,ELET6,2013-06-30,2013-08-14,1087050297,265583803,1352634100
1522,ELET6,2013-09-30,2013-11-14,1087050297,265583803,1352634100
1523,ELET6,2013-12-31,2014-04-03,1087050297,265583803,1352634100
1524,ELET6,2014-03-31,2014-05-15,1087050297,265583803,1352634100
1525,ELET6,2014-06-30,2014-08-12,1087050297,265583803,1352634100
1526,ELET6,2014-09-30,2014-11-14,1087050297,265583803,1352634100
1527,ELET6,2014-12-31,2015-04-09,1087050297,265583803,1352634100
1528,ELET6,2015-03-31,2015-05-15,1087050297,265583803,1352634100
1529,ELET6,2015-06-30,2015-08-14,1087050297,265583803,1352634100
1530,ELET6,2015-09-30,2015-11-12,1087050297,265583803,1352634100
1531,ELET6,2015-12-31,2016-03-31,1087050297,265583803,1352634100
1532,ELET6,2016-03-31,2016-05-11,1087050297,265583803,1352634100
1533,ELET6,2016-06-30,2016-08-15,1087050297,265583803,1352634100
1534,ELET6,2016-09-30,2016-11-09,1087050297,265583803,1352634100
1535,ELET6,2016-12-31,2017-03-27,1087050297,265583803,1352634100
1536,ELET6,2017-03-31,2017-05-12,1087050297,265583803,1352634100
1537,ELET6,2017-06-30,2017-08-14,1087050297,265583803,1352634100
1538,ELET6,2017-09-30,2017-11-13,1087050297,265583803,1352634100
1539,ELET6,2017-12-31,2018-03-27,1087050297,265583803,1352634100
1540,ELET6,2018-03-31,2018-05-15,1087050297,265583803,1352634100
1541,ELET6,2018-06-30,2018-08-14,1087050297,265583803,1352634100
1542,ELET6,2018-09-30,2018-11-12,1087050297,265583803,1352634100
1543,ELET6,2018-12-31,2019-03-27,1087050297,265583803,1352634100
1544,ELET6,2019-03-31,2019-05-13,1087050297,265583803,1352634100
1545,ELET6,2019-06-30,2019-08-12,1087050297,265583803,1352634100
1546,ELET6,2019-09-30,2019-11-11,1087050297,265583803,1352634100
1547,ELET6,2019-12-31,2020-03-27,1087050297,265583803,1352634100
1548,ELET6,2020-03-31,2020-05-28,1288842596,280088314,1568930910
1549,ELET6,2020-06-30,2020-08-12,1288842596,280088314,1568930910
1550,ELET6,2020-09-30,2020-11-11,1288842596,280088314,1568930910
1551,ELET6,2020-12-31,2021-03-19,1288842596,280088314,1568930910
1552,CMIG3,2010-12-31,2011-04-20,298270,384145,682415
1553,CMIG3,2011-03-31,2011-05-17,298270,384145,682415
1554,CMIG3,2011-06-30,2011-08-22,298269668,384144914,682414582
1555,CMIG3,2011-09-30,2011-11-14,298269668,384144914,682414582
1556,CMIG3,2011-12-31,2012-03-28,298270,384145,682415
1557,CMIG3,2012-03-31,2012-05-30,298270,384145,682415
1558,CMIG3,2012-06-30,2012-08-14,372837,480181,853018
1559,CMIG3,2012-09-30,2012-11-14,372837,480181,853018
1560,CMIG3,2012-12-31,2013-04-16,372837,479818,852655
1561,CMIG3,2013-03-31,2013-05-15,372837,480181,853018
1562,CMIG3,2013-06-30,2013-08-14,420765,541907,962672
1563,CMIG3,2013-09-30,2013-11-14,420765,541907,962672
1564,CMIG3,2013-12-31,2014-04-04,420765,838077,1258842
1565,CMIG3,2014-03-31,2014-05-15,420765,838077,1258842
1566,CMIG3,2014-06-30,2014-08-13,420765,838077,1258842
1567,CMIG3,2014-09-30,2014-11-13,420765,838077,1258842
1568,CMIG3,2014-12-31,2015-03-27,420765,838077,1258842
1569,CMIG3,2015-03-31,2015-05-15,420765,838077,1258842
1570,CMIG3,2015-06-30,2015-08-14,420765,838077,1258842
1571,CMIG3,2015-09-30,2015-11-13,420765,838077,1258842
1572,CMIG3,2015-12-31,2016-11-12,420765,838077,1258842
1573,CMIG3,2016-03-31,2017-04-29,420765,838077,1258842
1574,CMIG3,2016-06-30,2017-04-29,420765,838077,1258842
1575,CMIG3,2016-09-30,2017-04-29,420765,838077,1258842
1576,CMIG3,2016-12-31,2017-04-11,420765,838077,1258842
1577,CMIG3,2017-03-31,2017-05-15,420765,838077,1258842
1578,CMIG3,2017-06-30,2017-08-11,420765,838077,1258842
1579,CMIG3,2017-09-30,2017-11-14,420765,838077,1258842
1580,CMIG3,2017-12-31,2018-03-29,420765,838077,1258842
1581,CMIG3,2018-03-31,2018-05-16,420765,838077,1258842
1582,CMIG3,2018-06-30,2018-11-29,487614,971138,1458752
1583,CMIG3,2018-09-30,2018-11-27,487614,971138,1458752
1584,CMIG3,2018-12-31,2019-04-01,487614,971138,1458752
1585,CMIG3,2019-03-31,2019-05-16,487614,971138,1458752
1586,CMIG3,2019-06-30,2019-08-15,487614,971138,1458752
1587,CMIG3,2019-09-30,2019-11-14,487614,971138,1458752
1588,CMIG3,2019-12-31,2020-04-01,487614,971138,1458752
1589,CMIG3,2020-03-31,2020-05-15,487614,971138,1458752
1590,CMIG3,2020-06-30,2020-08-14,487614,971138,1458752
1591,CMIG3,2020-09-30,2020-11-13,507670,1011082,1518752
1592,CMIG4,2010-12-31,2011-04-20,298270,384145,682415
1593,CMIG4,2011-03-31,2011-05-17,298270,384145,682415
1594,CMIG4,2011-06-30,2011-08-22,298269668,384144914,682414582
1595,CMIG4,2011-09-30,2011-11-14,298269668,384144914,682414582
1596,CMIG4,2011-12-31,2012-03-28,298270,384145,682415
1597,CMIG4,2012-03-31,2012-05-30,298270,384145,682415
1598,CMIG4,2012-06-30,2012-08-14,372837,480181,853018
1599,CMIG4,2012-09-30,2012-11-14,372837,480181,853018
1600,CMIG4,2012-12-31,2013-04-16,372837,479818,852655
1601,CMIG4,2013-03-31,2013-05-15,372837,480181,853018
1602,CMIG4,2013-06-30,2013-08-14,420765,541907,962672
1603,CMIG4,2013-09-30,2013-11-14,420765,541907,962672
1604,CMIG4,2013-12-31,2014-04-04,420765,838077,1258842
1605,CMIG4,2014-03-31,2014-05-15,420765,838077,1258842
1606,CMIG4,2014-06-30,2014-08-13,420765,838077,1258842
1607,CMIG4,2014-09-30,2014-11-13,420765,838077,1258842
1608,CMIG4,2014-12-31,2015-03-27,420765,838077,1258842
1609,CMIG4,2015-03-31,2015-05-15,420765,838077,1258842
1610,CMIG4,2015-06-30,2015-08-14,420765,838077,1258842
1611,CMIG4,2015-09-30,2015-11-13,420765,838077,1258842
1612,CMIG4,2015-12-31,2016-11-12,420765,838077,1258842
1613,CMIG4,2016-03-31,2017-04-29,420765,838077,1258842
1614,CMIG4,2016-06-30,2017-04-29,420765,838077,1258842
1615,CMIG4,2016-09-30,2017-04-29,420765,838077,1258842
1616,CMIG4,2016-12-31,2017-04-11,420765,838077,1258842
1617,CMIG4,2017-03-31,2017-05-15,420765,838077,1258842
1618,CMIG4,2017-06-30,2017-08-11,420765,838077,1258842
1619,CMIG4,2017-09-30,2017-11-14,420765,838077,1258842
1620,CMIG4,2017-12-31,2018-03-29,420765,838077,1258842
1621,CMIG4,2018-03-31,2018-05-16,420765,838077,1258842
1622,CMIG4,2018-06-30,2018-11-29,487614,971138,1458752
1623,CMIG4,2018-09-30,2018-11-27,487614,971138,1458752
1624,CMIG4,2018-12-31,2019-04-01,487614,971138,1458752
1625,CMIG4,2019-03-31,2019-05-16,487614,971138,1458752
1626,CMIG4,2019-06-30,2019-08-15,487614,971138,1458752
1627,CMIG4,2019-09-30,2019-11-14,487614,971138,1458752
1628,CMIG4,2019-12-31,2020-04-01,487614,971138,1458752
1629,CMIG4,2020-03-31,2020-05-15,487614,971138,1458752
1630,CMIG4,2020-06-30,2020-08-14,487614,971138,1458752
1631,CMIG4,2020-09-30,2020-11-13,507670,1011082,1518752
1632,CLSC3,2010-12-31,2011-03-30,15527,23044,38571
1633,CLSC3,2011-03-31,2011-05-16,15527,23044,38571
1634,CLSC3,2011-06-30,2011-08-12,15527,23044,38571
1635,CLSC3,2011-09-30,2011-11-11,15527,23044,38571
1636,CLSC3,2011-12-31,2012-04-03,15527,23044,38571
1637,CLSC3,2012-03-31,2012-05-15,15527,23044,38571
1638,CLSC3,2012-06-30,2012-08-14,15527,23044,38571
1639,CLSC3,2012-09-30,2012-11-13,15527,23044,38571
1640,CLSC3,2012-12-31,2013-04-24,15527,23044,38571
1641,CLSC3,2013-03-31,2013-05-15,15527,23044,38571
1642,CLSC3,2013-06-30,2013-08-14,15527,23044,38571
1643,CLSC3,2013-09-30,2013-11-18,15527,23044,38571
1644,CLSC3,2013-12-31,2014-03-28,15527,23044,38571
1645,CLSC3,2014-03-31,2014-05-15,15527,23044,38571
1646,CLSC3,2014-06-30,2014-08-14,15527,23044,38571
1647,CLSC3,2014-09-30,2014-11-14,15527,23044,38571
1648,CLSC3,2014-12-31,2015-03-27,15527,23044,38571
1649,CLSC3,2015-03-31,2015-05-15,15527,23044,38571
1650,CLSC3,2015-06-30,2015-08-14,15527,23044,38571
1651,CLSC3,2015-09-30,2015-11-13,15527,23044,38571
1652,CLSC3,2015-12-31,2016-03-29,15527,23044,38571
1653,CLSC3,2016-03-31,2016-05-16,15527,23044,38571
1654,CLSC3,2016-06-30,2016-08-15,15527,23044,38571
1655,CLSC3,2016-09-30,2016-11-11,15527,23044,38571
1656,CLSC3,2016-12-31,2017-04-11,15527,23044,38571
1657,CLSC3,2017-03-31,2017-05-15,15527,23044,38571
1658,CLSC3,2017-06-30,2017-08-14,15527,23044,38571
1659,CLSC3,2017-09-30,2017-11-14,15527,23044,38571
1660,CLSC3,2017-12-31,2018-04-16,15527,23044,38571
1661,CLSC3,2018-03-31,2018-05-15,15527,23044,38571
1662,CLSC3,2018-06-30,2018-08-14,15527,23044,38571
1663,CLSC3,2018-09-30,2018-11-14,15527,23044,38571
1664,CLSC3,2018-12-31,2019-04-18,15527,23044,38571
1665,CLSC3,2019-03-31,2019-05-15,15527,23044,38571
1666,CLSC3,2019-06-30,2019-08-14,15527,23044,38571
1667,CLSC3,2019-09-30,2019-11-14,15527,23044,38571
1668,CLSC3,2019-12-31,2020-03-27,15527,23044,38571
1669,CLSC3,2020-03-31,2020-05-08,15527,23044,38571
1670,CLSC3,2020-06-30,2020-08-14,15527,23044,38571
1671,CLSC3,2020-09-30,2020-11-13,15527,23044,38571
1672,CLSC3,2020-12-31,2021-03-12,15527,23044,38571
1673,CLSC4,2010-12-31,2011-03-30,15527,23044,38571
1674,CLSC4,2011-03-31,2011-05-16,15527,23044,38571
1675,CLSC4,2011-06-30,2011-08-12,15527,23044,38571
1676,CLSC4,2011-09-30,2011-11-11,15527,23044,38571
1677,CLSC4,2011-12-31,2012-04-03,15527,23044,38571
1678,CLSC4,2012-03-31,2012-05-15,15527,23044,38571
1679,CLSC4,2012-06-30,2012-08-14,15527,23044,38571
1680,CLSC4,2012-09-30,2012-11-13,15527,23044,38571
1681,CLSC4,2012-12-31,2013-04-24,15527,23044,38571
1682,CLSC4,2013-03-31,2013-05-15,15527,23044,38571
1683,CLSC4,2013-06-30,2013-08-14,15527,23044,38571
1684,CLSC4,2013-09-30,2013-11-18,15527,23044,38571
1685,CLSC4,2013-12-31,2014-03-28,15527,23044,38571
1686,CLSC4,2014-03-31,2014-05-15,15527,23044,38571
1687,CLSC4,2014-06-30,2014-08-14,15527,23044,38571
1688,CLSC4,2014-09-30,2014-11-14,15527,23044,38571
1689,CLSC4,2014-12-31,2015-03-27,15527,23044,38571
1690,CLSC4,2015-03-31,2015-05-15,15527,23044,38571
1691,CLSC4,2015-06-30,2015-08-14,15527,23044,38571
1692,CLSC4,2015-09-30,2015-11-13,15527,23044,38571
1693,CLSC4,2015-12-31,2016-03-29,15527,23044,38571
1694,CLSC4,2016-03-31,2016-05-16,15527,23044,38571
1695,CLSC4,2016-06-30,2016-08-15,15527,23044,38571
1696,CLSC4,2016-09-30,2016-11-11,15527,23044,38571
1697,CLSC4,2016-12-31,2017-04-11,15527,23044,38571
1698,CLSC4,2017-03-31,2017-05-15,15527,23044,38571
1699,CLSC4,2017-06-30,2017-08-14,15527,23044,38571
1700,CLSC4,2017-09-30,2017-11-14,15527,23044,38571
1701,CLSC4,2017-12-31,2018-04-16,15527,23044,38571
1702,CLSC4,2018-03-31,2018-05-15,15527,23044,38571
1703,CLSC4,2018-06-30,2018-08-14,15527,23044,38571
1704,CLSC4,2018-09-30,2018-11-14,15527,23044,38571
1705,CLSC4,2018-12-31,2019-04-18,15527,23044,38571
1706,CLSC4,2019-03-31,2019-05-15,15527,23044,38571
1707,CLSC4,2019-06-30,2019-08-14,15527,23044,38571
1708,CLSC4,2019-09-30,2019-11-14,15527,23044,38571
1709,CLSC4,2019-12-31,2020-03-27,15527,23044,38571
1710,CLSC4,2020-03-31,2020-05-08,15527,23044,38571
1711,CLSC4,2020-06-30,2020-08-14,15527,23044,38571
1712,CLSC4,2020-09-30,2020-11-13,15527,23044,38571
1713,CLSC4,2020-12-31,2021-03-12,15527,23044,38571
1714,CESP3,2010-12-31,2011-04-05,109168,218335,327503
1715,CESP3,2011-03-31,2011-05-16,109168,218335,327503
1716,CESP3,2011-06-30,2011-08-08,109168,218335,327503
1717,CESP3,2011-09-30,2011-11-10,109168,218335,327503
1718,CESP3,2011-12-31,2012-03-22,109168,218335,327503
1719,CESP3,2012-03-31,2012-05-11,109168,218335,327503
1720,CESP3,2012-06-30,2012-08-10,109168,218335,327503
1721,CESP3,2012-09-30,2012-11-09,109168,218335,327503
1722,CESP3,2012-12-31,2013-03-22,109168,218335,327503
1723,CESP3,2013-03-31,2013-05-09,109168,218335,327503
1724,CESP3,2013-06-30,2013-08-14,109168,218335,327503
1725,CESP3,2013-09-30,2013-11-14,109168,218335,327503
1726,CESP3,2013-12-31,2014-03-21,109168,218335,327503
1727,CESP3,2014-03-31,2014-05-15,109168,218335,327503
1728,CESP3,2014-06-30,2014-08-14,109168,218335,327503
1729,CESP3,2014-09-30,2014-11-14,109168,218335,327503
1730,CESP3,2014-12-31,2015-03-27,109168,218335,327503
1731,CESP3,2015-03-31,2015-05-15,109168,218335,327503
1732,CESP3,2015-06-30,2015-08-14,109168,218335,327503
1733,CESP3,2015-09-30,2015-11-13,109168,218335,327503
1734,CESP3,2015-12-31,2016-03-24,109168,218335,327503
1735,CESP3,2016-03-31,2016-05-13,109168,218335,327503
1736,CESP3,2016-06-30,2016-08-12,109168,218335,327503
1737,CESP3,2016-09-30,2016-11-11,109168,218335,327503
1738,CESP3,2016-12-31,2017-03-24,109168,218335,327503
1739,CESP3,2017-03-31,2017-05-15,109168,218335,327503
1740,CESP3,2017-06-30,2017-08-11,109168,218335,327503
1741,CESP3,2017-09-30,2017-11-10,109168,218335,327503
1742,CESP3,2017-12-31,2018-03-21,109168,218335,327503
1743,CESP3,2018-03-31,2018-05-11,109168,218335,327503
1744,CESP3,2018-06-30,2018-08-14,109168,218335,327503
1745,CESP3,2018-09-30,2018-11-21,109168,218335,327503
1746,CESP3,2018-12-31,2019-03-22,109168,218335,327503
1747,CESP3,2019-03-31,2019-05-13,109168,218335,327503
1748,CESP3,2019-06-30,2019-08-06,109168,218335,327503
1749,CESP3,2019-09-30,2019-10-30,109168,218335,327503
1750,CESP3,2019-12-31,2020-02-17,109168,218335,327503
1751,CESP3,2020-03-31,2020-05-13,109168,218335,327503
1752,CESP3,2020-06-30,2020-07-29,109168,218335,327503
1753,CESP3,2020-09-30,2020-10-28,109168,218335,327503
1754,CESP3,2020-12-31,2021-03-01,109168,218335,327503
1755,CESP5,2010-12-31,2011-04-05,109168,218335,327503
1756,CESP5,2011-03-31,2011-05-16,109168,218335,327503
1757,CESP5,2011-06-30,2011-08-08,109168,218335,327503
1758,CESP5,2011-09-30,2011-11-10,109168,218335,327503
1759,CESP5,2011-12-31,2012-03-22,109168,218335,327503
1760,CESP5,2012-03-31,2012-05-11,109168,218335,327503
1761,CESP5,2012-06-30,2012-08-10,109168,218335,327503
1762,CESP5,2012-09-30,2012-11-09,109168,218335,327503
1763,CESP5,2012-12-31,2013-03-22,109168,218335,327503
1764,CESP5,2013-03-31,2013-05-09,109168,218335,327503
1765,CESP5,2013-06-30,2013-08-14,109168,218335,327503
1766,CESP5,2013-09-30,2013-11-14,109168,218335,327503
1767,CESP5,2013-12-31,2014-03-21,109168,218335,327503
1768,CESP5,2014-03-31,2014-05-15,109168,218335,327503
1769,CESP5,2014-06-30,2014-08-14,109168,218335,327503
1770,CESP5,2014-09-30,2014-11-14,109168,218335,327503
1771,CESP5,2014-12-31,2015-03-27,109168,218335,327503
1772,CESP5,2015-03-31,2015-05-15,109168,218335,327503
1773,CESP5,2015-06-30,2015-08-14,109168,218335,327503
1774,CESP5,2015-09-30,2015-11-13,109168,218335,327503
1775,CESP5,2015-12-31,2016-03-24,109168,218335,327503
1776,CESP5,2016-03-31,2016-05-13,109168,218335,327503
1777,CESP5,2016-06-30,2016-08-12,109168,218335,327503
1778,CESP5,2016-09-30,2016-11-11,109168,218335,327503
1779,CESP5,2016-12-31,2017-03-24,109168,218335,327503
1780,CESP5,2017-03-31,2017-05-15,109168,218335,327503
1781,CESP5,2017-06-30,2017-08-11,109168,218335,327503
1782,CESP5,2017-09-30,2017-11-10,109168,218335,327503
1783,CESP5,2017-12-31,2018-03-21,109168,218335,327503
1784,CESP5,2018-03-31,2018-05-11,109168,218335,327503
1785,CESP5,2018-06-30,2018-08-14,109168,218335,327503
1786,CESP5,2018-09-30,2018-11-21,109168,218335,327503
1787,CESP5,2018-12-31,2019-03-22,109168,218335,327503
1788,CESP5,2019-03-31,2019-05-13,109168,218335,327503
1789,CESP5,2019-06-30,2019-08-06,109168,218335,327503
1790,CESP5,2019-09-30,2019-10-30,109168,218335,327503
1791,CESP5,2019-12-31,2020-02-17,109168,218335,327503
1792,CESP5,2020-03-31,2020-05-13,109168,218335,327503
1793,CESP5,2020-06-30,2020-07-29,109168,218335,327503
1794,CESP5,2020-09-30,2020-10-28,109168,218335,327503
1795,CESP5,2020-12-31,2021-03-01,109168,218335,327503
1796,CESP6,2010-12-31,2011-04-05,109168,218335,327503
1797,CESP6,2011-03-31,2011-05-16,109168,218335,327503
1798,CESP6,2011-06-30,2011-08-08,109168,218335,327503
1799,CESP6,2011-09-30,2011-11-10,109168,218335,327503
1800,CESP6,2011-12-31,2012-03-22,109168,218335,327503
1801,CESP6,2012-03-31,2012-05-11,109168,218335,327503
1802,CESP6,2012-06-30,2012-08-10,109168,218335,327503
1803,CESP6,2012-09-30,2012-11-09,109168,218335,327503
1804,CESP6,2012-12-31,2013-03-22,109168,218335,327503
1805,CESP6,2013-03-31,2013-05-09,109168,218335,327503
1806,CESP6,2013-06-30,2013-08-14,109168,218335,327503
1807,CESP6,2013-09-30,2013-11-14,109168,218335,327503
1808,CESP6,2013-12-31,2014-03-21,109168,218335,327503
1809,CESP6,2014-03-31,2014-05-15,109168,218335,327503
1810,CESP6,2014-06-30,2014-08-14,109168,218335,327503
1811,CESP6,2014-09-30,2014-11-14,109168,218335,327503
1812,CESP6,2014-12-31,2015-03-27,109168,218335,327503
1813,CESP6,2015-03-31,2015-05-15,109168,218335,327503
1814,CESP6,2015-06-30,2015-08-14,109168,218335,327503
1815,CESP6,2015-09-30,2015-11-13,109168,218335,327503
1816,CESP6,2015-12-31,2016-03-24,109168,218335,327503
1817,CESP6,2016-03-31,2016-05-13,109168,218335,327503
1818,CESP6,2016-06-30,2016-08-12,109168,218335,327503
1819,CESP6,2016-09-30,2016-11-11,109168,218335,327503
1820,CESP6,2016-12-31,2017-03-24,109168,218335,327503
1821,CESP6,2017-03-31,2017-05-15,109168,218335,327503
1822,CESP6,2017-06-30,2017-08-11,109168,218335,327503
1823,CESP6,2017-09-30,2017-11-10,109168,218335,327503
1824,CESP6,2017-12-31,2018-03-21,109168,218335,327503
1825,CESP6,2018-03-31,2018-05-11,109168,218335,327503
1826,CESP6,2018-06-30,2018-08-14,109168,218335,327503
1827,CESP6,2018-09-30,2018-11-21,109168,218335,327503
1828,CESP6,2018-12-31,2019-03-22,109168,218335,327503
1829,CESP6,2019-03-31,2019-05-13,109168,218335,327503
1830,CESP6,2019-06-30,2019-08-06,109168,218335,327503
1831,CESP6,2019-09-30,2019-10-30,109168,218335,327503
1832,CESP6,2019-12-31,2020-02-17,109168,218335,327503
1833,CESP6,2020-03-31,2020-05-13,109168,218335,327503
1834,CESP6,2020-06-30,2020-07-29,109168,218335,327503
1835,CESP6,2020-09-30,2020-10-28,109168,218335,327503
1836,CESP6,2020-12-31,2021-03-01,109168,218335,327503
1837,CBEE3,2010-12-31,2011-05-21,3922515918,0,3922515918
1838,CBEE3,2011-03-31,2011-05-26,3922515918,0,3922515918
1839,CBEE3,2011-06-30,2011-08-08,3922515918,0,3922515918
1840,CBEE3,2011-09-30,2011-10-31,3922515918,0,3922515918
1841,CBEE3,2011-12-31,2012-03-26,3922515918,0,3922515918
1842,CBEE3,2012-03-31,2012-05-11,3922515918,0,3922515918
1843,CBEE3,2012-06-30,2012-08-17,3922515918,0,3922515918
1844,CBEE3,2012-09-30,2012-11-13,3922515918,0,3922515918
1845,CBEE3,2012-12-31,2013-03-28,3922515918,0,3922515918
1846,CBEE3,2013-03-31,2013-05-15,3922515918,0,3922515918
1847,CBEE3,2013-06-30,2013-07-31,3922515918,0,3922515918
1848,CBEE3,2013-09-30,2013-10-29,3922515918,0,3922515918
1849,CBEE3,2013-12-31,2014-02-14,3922515918,0,3922515918
1850,CBEE3,2014-03-31,2014-05-05,3922515918,0,3922515918
1851,CBEE3,2014-06-30,2014-07-28,3922515918,0,3922515918
1852,CBEE3,2014-09-30,2014-10-28,3922515918,0,3922515918
1853,CBEE3,2014-12-31,2015-03-27,3922515918,0,3922515918
1854,CBEE3,2015-03-31,2015-04-27,3922515918,0,3922515918
1855,CBEE3,2015-06-30,2015-07-26,3922515918,0,3922515918
1856,CBEE3,2015-09-30,2015-10-28,3922515915,0,3922515915
1857,CBEE3,2015-12-31,2016-02-11,3922515918,0,3922515918
1858,CBEE3,2016-03-31,2016-05-05,98062,0,98062
1859,CBEE3,2016-06-30,2016-08-30,98063,0,98063
1860,CBEE3,2016-09-30,2016-11-03,98063,0,98063
1861,CBEE3,2016-12-31,2017-02-22,98063,0,98063
1862,CBEE3,2017-03-31,2017-05-04,98062,0,98062
1863,CBEE3,2017-06-30,2017-07-25,98063,0,98063
1864,CBEE3,2017-09-30,2017-10-31,98063,0,98063
1865,CBEE3,2017-12-31,2018-02-27,166634,0,166634
1866,CBEE3,2018-03-31,2018-05-02,166634,0,166634
1867,CBEE3,2018-06-30,2018-07-26,166634,0,166634
1868,CBEE3,2018-09-30,2018-10-29,166634,0,166634
1869,CBEE3,2018-12-31,2019-02-26,166634,0,166634
1870,CBEE3,2019-03-31,2019-04-24,166634,0,166634
1871,CBEE3,2019-06-30,2019-07-30,166634,0,166634
1872,CBEE3,2019-09-30,2019-10-25,166634,0,166634
1873,CBEE3,2019-12-31,2020-02-21,166634,0,166634
1874,CBEE3,2020-03-31,2020-04-30,166634,0,166634
1875,CBEE3,2020-06-30,2020-07-27,166634,0,166634
1876,CBEE3,2020-09-30,2020-11-03,166634,0,166634
1877,CBEE3,2020-12-31,2021-02-24,166634,0,166634
1878,FESA3,2010-12-31,2011-03-29,29440000,58880000,88320000
1879,FESA3,2011-03-31,2011-05-16,29440,58880,88320
1880,FESA3,2011-06-30,2011-08-15,29440,58880,88320
1881,FESA3,2011-09-30,2011-11-14,29440,58880,88320
1882,FESA3,2011-12-31,2012-03-12,29440000,58880000,88320000
1883,FESA3,2012-03-31,2012-05-16,29440,58880,88320
1884,FESA3,2012-06-30,2012-08-14,29440,58880,88320
1885,FESA3,2012-09-30,2012-11-09,29440,58880,88320
1886,FESA3,2012-12-31,2013-03-15,29440000,58880000,88320000
1887,FESA3,2013-03-31,2013-05-15,29440,58880,88320
1888,FESA3,2013-06-30,2013-08-13,29440,58880,88320
1889,FESA3,2013-09-30,2013-11-13,29440,58880,88320
1890,FESA3,2013-12-31,2014-03-20,29440000,58880000,88320000
1891,FESA3,2014-03-31,2014-05-15,29440000,58880000,88320000
1892,FESA3,2014-06-30,2014-08-08,29440000,58880000,88320000
1893,FESA3,2014-09-30,2014-11-11,29440000,58880000,88320000
1894,FESA3,2014-12-31,2015-02-27,29440000,58880000,88320000
1895,FESA3,2015-03-31,2015-05-08,29440000,58880000,88320000
1896,FESA3,2015-06-30,2015-08-07,29440000,58880000,88320000
1897,FESA3,2015-09-30,2015-11-09,29440000,58880000,88320000
1898,FESA3,2015-12-31,2016-03-04,29440000,58880000,88320000
1899,FESA3,2016-03-31,2016-05-06,29440000,58880000,88320000
1900,FESA3,2016-06-30,2016-08-05,29440000,58880000,88320000
1901,FESA3,2016-09-30,2016-11-04,29440000,58880000,88320000
1902,FESA3,2016-12-31,2017-03-10,29440000,58880000,88320000
1903,FESA3,2017-03-31,2017-05-12,29440000,58880000,88320000
1904,FESA3,2017-06-30,2017-08-14,29440000,58880000,88320000
1905,FESA3,2017-09-30,2017-11-17,29440000,58880000,88320000
1906,FESA3,2017-12-31,2018-03-05,29440000,58880000,88320000
1907,FESA3,2018-03-31,2018-05-11,29440000,58880000,88320000
1908,FESA3,2018-06-30,2018-08-14,29440000,58880000,88320000
1909,FESA3,2018-09-30,2018-11-14,29440000,58880000,88320000
1910,FESA3,2018-12-31,2019-03-11,29440000,58880000,88320000
1911,FESA3,2019-03-31,2019-05-15,29440000,58880000,88320000
1912,FESA3,2019-06-30,2019-08-28,29440000,58880000,88320000
1913,FESA3,2019-09-30,2019-11-13,29440000,58880000,88320000
1914,FESA3,2019-12-31,2020-03-03,29440000,58880000,88320000
1915,FESA3,2020-03-31,2020-05-22,29440000,58880000,88320000
1916,FESA3,2020-06-30,2020-08-13,29440000,58880000,88320000
1917,FESA3,2020-09-30,2020-11-12,29440000,58880000,88320000
1918,FESA3,2020-12-31,2021-03-03,29440000,58880000,88320000
1919,FESA4,2010-12-31,2011-03-29,29440000,58880000,88320000
1920,FESA4,2011-03-31,2011-05-16,29440,58880,88320
1921,FESA4,2011-06-30,2011-08-15,29440,58880,88320
1922,FESA4,2011-09-30,2011-11-14,29440,58880,88320
1923,FESA4,2011-12-31,2012-03-12,29440000,58880000,88320000
1924,FESA4,2012-03-31,2012-05-16,29440,58880,88320
1925,FESA4,2012-06-30,2012-08-14,29440,58880,88320
1926,FESA4,2012-09-30,2012-11-09,29440,58880,88320
1927,FESA4,2012-12-31,2013-03-15,29440000,58880000,88320000
1928,FESA4,2013-03-31,2013-05-15,29440,58880,88320
1929,FESA4,2013-06-30,2013-08-13,29440,58880,88320
1930,FESA4,2013-09-30,2013-11-13,29440,58880,88320
1931,FESA4,2013-12-31,2014-03-20,29440000,58880000,88320000
1932,FESA4,2014-03-31,2014-05-15,29440000,58880000,88320000
1933,FESA4,2014-06-30,2014-08-08,29440000,58880000,88320000
1934,FESA4,2014-09-30,2014-11-11,29440000,58880000,88320000
1935,FESA4,2014-12-31,2015-02-27,29440000,58880000,88320000
1936,FESA4,2015-03-31,2015-05-08,29440000,58880000,88320000
1937,FESA4,2015-06-30,2015-08-07,29440000,58880000,88320000
1938,FESA4,2015-09-30,2015-11-09,29440000,58880000,88320000
1939,FESA4,2015-12-31,2016-03-04,29440000,58880000,88320000
1940,FESA4,2016-03-31,2016-05-06,29440000,58880000,88320000
1941,FESA4,2016-06-30,2016-08-05,29440000,58880000,88320000
1942,FESA4,2016-09-30,2016-11-04,29440000,58880000,88320000
1943,FESA4,2016-12-31,2017-03-10,29440000,58880000,88320000
1944,FESA4,2017-03-31,2017-05-12,29440000,58880000,88320000
1945,FESA4,2017-06-30,2017-08-14,29440000,58880000,88320000
1946,FESA4,2017-09-30,2017-11-17,29440000,58880000,88320000
1947,FESA4,2017-12-31,2018-03-05,29440000,58880000,88320000
1948,FESA4,2018-03-31,2018-05-11,29440000,58880000,88320000
1949,FESA4,2018-06-30,2018-08-14,29440000,58880000,88320000
1950,FESA4,2018-09-30,2018-11-14,29440000,58880000,88320000
1951,FESA4,2018-12-31,2019-03-11,29440000,58880000,88320000
1952,FESA4,2019-03-31,2019-05-15,29440000,58880000,88320000
1953,FESA4,2019-06-30,2019-08-28,29440000,58880000,88320000
1954,FESA4,2019-09-30,2019-11-13,29440000,58880000,88320000
1955,FESA4,2019-12-31,2020-03-03,29440000,58880000,88320000
1956,FESA4,2020-03-31,2020-05-22,29440000,58880000,88320000
1957,FESA4,2020-06-30,2020-08-13,29440000,58880000,88320000
1958,FESA4,2020-09-30,2020-11-12,29440000,58880000,88320000
1959,FESA4,2020-12-31,2021-03-03,29440000,58880000,88320000
1960,CEDO3,2010-12-31,2011-04-07,2036899,1532160,3569059
1961,CEDO3,2011-03-31,2011-05-16,2036899,1532160,3569059
1962,CEDO3,2011-06-30,2011-08-11,5707104,4292896,10000000
1963,CEDO3,2011-09-30,2011-11-04,5707104,4292896,10000000
1964,CEDO3,2011-12-31,2012-03-13,5707104,4292896,10000000
1965,CEDO3,2012-03-31,2012-05-15,5707104,4292896,10000000
1966,CEDO3,2012-06-30,2012-08-14,5707104,4292896,10000000
1967,CEDO3,2012-09-30,2012-11-14,5707104,4292896,10000000
1968,CEDO3,2012-12-31,2013-04-19,5707104,4292896,10000000
1969,CEDO3,2013-03-31,2013-05-14,5707104,4292896,10000000
1970,CEDO3,2013-06-30,2013-08-14,5707104,4292896,10000000
1971,CEDO3,2013-09-30,2013-11-14,5707104,4292896,10000000
1972,CEDO3,2013-12-31,2014-03-25,5707104,4292896,10000000
1973,CEDO3,2014-03-31,2014-05-15,5707104,4292896,10000000
1974,CEDO3,2014-06-30,2014-08-14,5707104,4292896,10000000
1975,CEDO3,2014-09-30,2014-11-14,5707104,4292896,10000000
1976,CEDO3,2014-12-31,2015-03-24,5707104,4292896,10000000
1977,CEDO3,2015-03-31,2015-05-15,5707104,4292896,10000000
1978,CEDO3,2015-06-30,2015-08-14,5707104,4292896,10000000
1979,CEDO3,2015-09-30,2015-11-13,5707104,4292896,10000000
1980,CEDO3,2015-12-31,2016-03-31,5707104,4292896,10000000
1981,CEDO3,2016-03-31,2016-05-13,5707104,4292896,10000000
1982,CEDO3,2016-06-30,2016-08-12,5707104,4292896,10000000
1983,CEDO3,2016-09-30,2016-11-14,5707104,4292896,10000000
1984,CEDO3,2016-12-31,2017-03-28,5707104,4292896,10000000
1985,CEDO3,2017-03-31,2017-05-15,5707104,4292896,10000000
1986,CEDO3,2017-06-30,2017-08-14,5707104,4292896,10000000
1987,CEDO3,2017-09-30,2017-11-14,5707104,4292896,10000000
1988,CEDO3,2017-12-31,2018-03-28,5707104,4292896,10000000
1989,CEDO3,2018-03-31,2018-05-15,5707104,4292896,10000000
1990,CEDO3,2018-06-30,2018-08-30,5707104,4292896,10000000
1991,CEDO3,2018-09-30,2018-11-14,5707104,4292896,10000000
1992,CEDO3,2018-12-31,2019-03-29,5707104,4292896,10000000
1993,CEDO3,2019-03-31,2019-05-15,5707104,4292896,10000000
1994,CEDO3,2019-06-30,2019-08-14,5707104,4292896,10000000
1995,CEDO3,2019-09-30,2019-11-14,5707104,4292896,10000000
1996,CEDO3,2019-12-31,2020-03-27,5707104,4292896,10000000
1997,CEDO3,2020-03-31,2020-06-30,5707104,4292896,10000000
1998,CEDO3,2020-06-30,2020-08-14,5707104,4292896,10000000
1999,CEDO3,2020-09-30,2020-11-13,5707104,4292896,10000000
2000,CEDO4,2010-12-31,2011-04-07,2036899,1532160,3569059
2001,CEDO4,2011-03-31,2011-05-16,2036899,1532160,3569059
2002,CEDO4,2011-06-30,2011-08-11,5707104,4292896,10000000
2003,CEDO4,2011-09-30,2011-11-04,5707104,4292896,10000000
2004,CEDO4,2011-12-31,2012-03-13,5707104,4292896,10000000
2005,CEDO4,2012-03-31,2012-05-15,5707104,4292896,10000000
2006,CEDO4,2012-06-30,2012-08-14,5707104,4292896,10000000
2007,CEDO4,2012-09-30,2012-11-14,5707104,4292896,10000000
2008,CEDO4,2012-12-31,2013-04-19,5707104,4292896,10000000
2009,CEDO4,2013-03-31,2013-05-14,5707104,4292896,10000000
2010,CEDO4,2013-06-30,2013-08-14,5707104,4292896,10000000
2011,CEDO4,2013-09-30,2013-11-14,5707104,4292896,10000000
2012,CEDO4,2013-12-31,2014-03-25,5707104,4292896,10000000
2013,CEDO4,2014-03-31,2014-05-15,5707104,4292896,10000000
2014,CEDO4,2014-06-30,2014-08-14,5707104,4292896,10000000
2015,CEDO4,2014-09-30,2014-11-14,5707104,4292896,10000000
2016,CEDO4,2014-12-31,2015-03-24,5707104,4292896,10000000
2017,CEDO4,2015-03-31,2015-05-15,5707104,4292896,10000000
2018,CEDO4,2015-06-30,2015-08-14,5707104,4292896,10000000
2019,CEDO4,2015-09-30,2015-11-13,5707104,4292896,10000000
2020,CEDO4,2015-12-31,2016-03-31,5707104,4292896,10000000
2021,CEDO4,2016-03-31,2016-05-13,5707104,4292896,10000000
2022,CEDO4,2016-06-30,2016-08-12,5707104,4292896,10000000
2023,CEDO4,2016-09-30,2016-11-14,5707104,4292896,10000000
2024,CEDO4,2016-12-31,2017-03-28,5707104,4292896,10000000
2025,CEDO4,2017-03-31,2017-05-15,5707104,4292896,10000000
2026,CEDO4,2017-06-30,2017-08-14,5707104,4292896,10000000
2027,CEDO4,2017-09-30,2017-11-14,5707104,4292896,10000000
2028,CEDO4,2017-12-31,2018-03-28,5707104,4292896,10000000
2029,CEDO4,2018-03-31,2018-05-15,5707104,4292896,10000000
2030,CEDO4,2018-06-30,2018-08-30,5707104,4292896,10000000
2031,CEDO4,2018-09-30,2018-11-14,5707104,4292896,10000000
2032,CEDO4,2018-12-31,2019-03-29,5707104,4292896,10000000
2033,CEDO4,2019-03-31,2019-05-15,5707104,4292896,10000000
2034,CEDO4,2019-06-30,2019-08-14,5707104,4292896,10000000
2035,CEDO4,2019-09-30,2019-11-14,5707104,4292896,10000000
2036,CEDO4,2019-12-31,2020-03-27,5707104,4292896,10000000
2037,CEDO4,2020-03-31,2020-06-30,5707104,4292896,10000000
2038,CEDO4,2020-06-30,2020-08-14,5707104,4292896,10000000
2039,CEDO4,2020-09-30,2020-11-13,5707104,4292896,10000000
2040,CSAB3,2010-12-31,2011-02-28,3840,3840,7680
2041,CSAB3,2011-03-31,2011-05-13,3840,3840,7680
2042,CSAB3,2011-06-30,2011-08-18,3840,3840,7680
2043,CSAB3,2011-09-30,2011-11-14,3840,3840,7680
2044,CSAB3,2011-12-31,2012-02-28,3840,3840,7680
2045,CSAB3,2012-03-31,2012-05-15,3840,3840,7680
2046,CSAB3,2012-06-30,2012-08-15,3840,3840,7680
2047,CSAB3,2012-09-30,2012-11-14,3840,3840,7680
2048,CSAB3,2012-12-31,2013-02-28,3840,3840,7680
2049,CSAB3,2013-03-31,2013-05-14,3840,3840,7680
2050,CSAB3,2013-06-30,2013-08-13,3840,3840,7680
2051,CSAB3,2013-09-30,2013-12-13,3840,3840,7680
2052,CSAB3,2013-12-31,2014-02-24,3840,3840,7680
2053,CSAB3,2014-03-31,2014-05-14,3840,3840,7680
2054,CSAB3,2014-06-30,2014-08-14,3840,3840,7680
2055,CSAB3,2014-09-30,2014-11-13,3840,3840,7680
2056,CSAB3,2014-12-31,2015-02-27,3840,3840,7680
2057,CSAB3,2015-03-31,2015-05-12,3840,3840,7680
2058,CSAB3,2015-06-30,2015-08-13,3840,3840,7680
2059,CSAB3,2015-09-30,2015-11-12,3840,3840,7680
2060,CSAB3,2015-12-31,2016-02-26,3840,3840,7680
2061,CSAB3,2016-03-31,2016-05-10,3840,3840,7680
2062,CSAB3,2016-06-30,2016-08-12,3840,3840,7680
2063,CSAB3,2016-09-30,2016-11-14,3840,3840,7680
2064,CSAB3,2016-12-31,2017-02-23,3840,3840,7680
2065,CSAB3,2017-03-31,2017-05-12,3840,3840,7680
2066,CSAB3,2017-06-30,2017-08-15,3840,3840,7680
2067,CSAB3,2017-09-30,2017-11-10,3840,3840,7680
2068,CSAB3,2017-12-31,2018-02-27,3840,3840,7680
2069,CSAB3,2018-03-31,2018-05-15,3840,3840,7680
2070,CSAB3,2018-06-30,2018-08-14,3840,3840,7680
2071,CSAB3,2018-09-30,2018-11-12,3840,3840,7680
2072,CSAB3,2018-12-31,2019-02-27,3840,3840,7680
2073,CSAB3,2019-03-31,2019-05-15,3840,3840,7680
2074,CSAB3,2019-06-30,2019-08-14,3840,3840,7680
2075,CSAB3,2019-09-30,2019-11-13,3840,3840,7680
2076,CSAB3,2019-12-31,2020-02-28,3840,3840,7680
2077,CSAB3,2020-03-31,2020-06-23,3840,3840,7680
2078,CSAB3,2020-06-30,2020-08-19,3840,3840,7680
2079,CSAB3,2020-09-30,2020-11-13,3840,3840,7680
2080,CSAB3,2020-12-31,2021-02-26,3840,3840,7680
2081,CSAB4,2010-12-31,2011-02-28,3840,3840,7680
2082,CSAB4,2011-03-31,2011-05-13,3840,3840,7680
2083,CSAB4,2011-06-30,2011-08-18,3840,3840,7680
2084,CSAB4,2011-09-30,2011-11-14,3840,3840,7680
2085,CSAB4,2011-12-31,2012-02-28,3840,3840,7680
2086,CSAB4,2012-03-31,2012-05-15,3840,3840,7680
2087,CSAB4,2012-06-30,2012-08-15,3840,3840,7680
2088,CSAB4,2012-09-30,2012-11-14,3840,3840,7680
2089,CSAB4,2012-12-31,2013-02-28,3840,3840,7680
2090,CSAB4,2013-03-31,2013-05-14,3840,3840,7680
2091,CSAB4,2013-06-30,2013-08-13,3840,3840,7680
2092,CSAB4,2013-09-30,2013-12-13,3840,3840,7680
2093,CSAB4,2013-12-31,2014-02-24,3840,3840,7680
2094,CSAB4,2014-03-31,2014-05-14,3840,3840,7680
2095,CSAB4,2014-06-30,2014-08-14,3840,3840,7680
2096,CSAB4,2014-09-30,2014-11-13,3840,3840,7680
2097,CSAB4,2014-12-31,2015-02-27,3840,3840,7680
2098,CSAB4,2015-03-31,2015-05-12,3840,3840,7680
2099,CSAB4,2015-06-30,2015-08-13,3840,3840,7680
2100,CSAB4,2015-09-30,2015-11-12,3840,3840,7680
2101,CSAB4,2015-12-31,2016-02-26,3840,3840,7680
2102,CSAB4,2016-03-31,2016-05-10,3840,3840,7680
2103,CSAB4,2016-06-30,2016-08-12,3840,3840,7680
2104,CSAB4,2016-09-30,2016-11-14,3840,3840,7680
2105,CSAB4,2016-12-31,2017-02-23,3840,3840,7680
2106,CSAB4,2017-03-31,2017-05-12,3840,3840,7680
2107,CSAB4,2017-06-30,2017-08-15,3840,3840,7680
2108,CSAB4,2017-09-30,2017-11-10,3840,3840,7680
2109,CSAB4,2017-12-31,2018-02-27,3840,3840,7680
2110,CSAB4,2018-03-31,2018-05-15,3840,3840,7680
2111,CSAB4,2018-06-30,2018-08-14,3840,3840,7680
2112,CSAB4,2018-09-30,2018-11-12,3840,3840,7680
2113,CSAB4,2018-12-31,2019-02-27,3840,3840,7680
2114,CSAB4,2019-03-31,2019-05-15,3840,3840,7680
2115,CSAB4,2019-06-30,2019-08-14,3840,3840,7680
2116,CSAB4,2019-09-30,2019-11-13,3840,3840,7680
2117,CSAB4,2019-12-31,2020-02-28,3840,3840,7680
2118,CSAB4,2020-03-31,2020-06-23,3840,3840,7680
2119,CSAB4,2020-06-30,2020-08-19,3840,3840,7680
2120,CSAB4,2020-09-30,2020-11-13,3840,3840,7680
2121,CSAB4,2020-12-31,2021-02-26,3840,3840,7680
2122,CTNM3,2010-12-31,2011-04-18,43532,73143,116675
2123,CTNM3,2011-03-31,2011-05-16,43532,73143,116675
2124,CTNM3,2011-06-30,2011-08-17,43532,73143,116675
2125,CTNM3,2011-09-30,2011-11-14,43532,73143,116675
2126,CTNM3,2011-12-31,2012-03-31,43532,73143,116675
2127,CTNM3,2012-03-31,2012-05-17,43532,73143,116675
2128,CTNM3,2012-06-30,2012-08-14,43532,73143,116675
2129,CTNM3,2012-09-30,2012-11-14,43532,73143,116675
2130,CTNM3,2012-12-31,2013-03-28,43532,73143,116675
2131,CTNM3,2013-03-31,2013-05-15,55652,67017,122669
2132,CTNM3,2013-06-30,2013-08-14,55651,66895,122546
2133,CTNM3,2013-09-30,2013-11-12,55651,66895,122546
2134,CTNM3,2013-12-31,2014-03-27,55651,66895,122546
2135,CTNM3,2014-03-31,2014-05-15,55651,66895,122546
2136,CTNM3,2014-06-30,2014-08-15,55651,66895,122546
2137,CTNM3,2014-09-30,2014-11-14,55651,66895,122546
2138,CTNM3,2014-12-31,2015-03-30,55651,66895,122546
2139,CTNM3,2015-03-31,2015-05-15,55651,66895,122546
2140,CTNM3,2015-06-30,2015-08-14,55651,66895,122546
2141,CTNM3,2015-09-30,2015-11-16,13913,16723,30636
2142,CTNM3,2015-12-31,2016-03-31,13913,16723,30636
2143,CTNM3,2016-03-31,2016-05-16,13912,16724,30636
2144,CTNM3,2016-06-30,2016-08-15,13912,16724,30636
2145,CTNM3,2016-09-30,2016-11-14,13912,16724,30636
2146,CTNM3,2016-12-31,2017-05-03,13913,16723,30636
2147,CTNM3,2017-03-31,2017-05-15,13912,16724,30636
2148,CTNM3,2017-06-30,2017-08-14,13912,16724,30636
2149,CTNM3,2017-09-30,2017-11-14,13912,16724,30636
2150,CTNM3,2017-12-31,2018-03-29,13913,16723,30636
2151,CTNM3,2018-03-31,2018-05-15,13912,16724,30636
2152,CTNM3,2018-06-30,2018-08-14,13912,16724,30636
2153,CTNM3,2018-09-30,2018-11-19,13912,16724,30636
2154,CTNM3,2018-12-31,2019-04-11,13913,16723,30636
2155,CTNM3,2019-03-31,2019-05-29,13913,16723,30636
2156,CTNM3,2019-06-30,2019-08-15,13913,16723,30636
2157,CTNM3,2019-09-30,2019-11-14,13913,16723,30636
2158,CTNM3,2019-12-31,2020-04-09,13913,16723,30636
2159,CTNM3,2020-03-31,2020-06-29,13913,16723,30636
2160,CTNM3,2020-06-30,2020-08-31,13913,16723,30636
2161,CTNM3,2020-09-30,2020-11-16,13913,16723,30636
2162,CTNM4,2010-12-31,2011-04-18,43532,73143,116675
2163,CTNM4,2011-03-31,2011-05-16,43532,73143,116675
2164,CTNM4,2011-06-30,2011-08-17,43532,73143,116675
2165,CTNM4,2011-09-30,2011-11-14,43532,73143,116675
2166,CTNM4,2011-12-31,2012-03-31,43532,73143,116675
2167,CTNM4,2012-03-31,2012-05-17,43532,73143,116675
2168,CTNM4,2012-06-30,2012-08-14,43532,73143,116675
2169,CTNM4,2012-09-30,2012-11-14,43532,73143,116675
2170,CTNM4,2012-12-31,2013-03-28,43532,73143,116675
2171,CTNM4,2013-03-31,2013-05-15,55652,67017,122669
2172,CTNM4,2013-06-30,2013-08-14,55651,66895,122546
2173,CTNM4,2013-09-30,2013-11-12,55651,66895,122546
2174,CTNM4,2013-12-31,2014-03-27,55651,66895,122546
2175,CTNM4,2014-03-31,2014-05-15,55651,66895,122546
2176,CTNM4,2014-06-30,2014-08-15,55651,66895,122546
2177,CTNM4,2014-09-30,2014-11-14,55651,66895,122546
2178,CTNM4,2014-12-31,2015-03-30,55651,66895,122546
2179,CTNM4,2015-03-31,2015-05-15,55651,66895,122546
2180,CTNM4,2015-06-30,2015-08-14,55651,66895,122546
2181,CTNM4,2015-09-30,2015-11-16,13913,16723,30636
2182,CTNM4,2015-12-31,2016-03-31,13913,16723,30636
2183,CTNM4,2016-03-31,2016-05-16,13912,16724,30636
2184,CTNM4,2016-06-30,2016-08-15,13912,16724,30636
2185,CTNM4,2016-09-30,2016-11-14,13912,16724,30636
2186,CTNM4,2016-12-31,2017-05-03,13913,16723,30636
2187,CTNM4,2017-03-31,2017-05-15,13912,16724,30636
2188,CTNM4,2017-06-30,2017-08-14,13912,16724,30636
2189,CTNM4,2017-09-30,2017-11-14,13912,16724,30636
2190,CTNM4,2017-12-31,2018-03-29,13913,16723,30636
2191,CTNM4,2018-03-31,2018-05-15,13912,16724,30636
2192,CTNM4,2018-06-30,2018-08-14,13912,16724,30636
2193,CTNM4,2018-09-30,2018-11-19,13912,16724,30636
2194,CTNM4,2018-12-31,2019-04-11,13913,16723,30636
2195,CTNM4,2019-03-31,2019-05-29,13913,16723,30636
2196,CTNM4,2019-06-30,2019-08-15,13913,16723,30636
2197,CTNM4,2019-09-30,2019-11-14,13913,16723,30636
2198,CTNM4,2019-12-31,2020-04-09,13913,16723,30636
2199,CTNM4,2020-03-31,2020-06-29,13913,16723,30636
2200,CTNM4,2020-06-30,2020-08-31,13913,16723,30636
2201,CTNM4,2020-09-30,2020-11-16,13913,16723,30636
2202,REDE3,2010-12-31,2011-03-29,221158,100917,322075
2203,REDE3,2011-03-31,2011-05-18,221158,100917,322075
2204,REDE3,2011-06-30,2011-08-15,221158,100917,322075
2205,REDE3,2011-09-30,2011-11-11,294110,132482,426592
2206,REDE3,2011-12-31,2012-03-30,294110,132482,426592
2207,REDE3,2012-03-31,2012-05-16,294110,132482,426592
2208,REDE3,2012-06-30,2012-08-15,294110,132482,426592
2209,REDE3,2012-09-30,2014-11-21,294110,132482,426592
2210,REDE3,2012-12-31,2014-11-21,294110,132482,426592
2211,REDE3,2013-03-31,2014-11-24,294110,132482,426592
2212,REDE3,2013-06-30,2014-11-21,294110,132482,426592
2213,REDE3,2013-09-30,2014-11-21,294110,132482,426592
2214,REDE3,2013-12-31,2014-11-21,294110,132482,426592
2215,REDE3,2014-03-31,2014-11-21,294110,132482,426592
2216,REDE3,2014-06-30,2014-09-19,294110,132482,426592
2217,REDE3,2014-09-30,2014-11-14,1182320,532575,1714895
2218,REDE3,2014-12-31,2015-03-31,1182320,532575,1714895
2219,REDE3,2015-03-31,2015-05-15,1182320,532575,1714895
2220,REDE3,2015-06-30,2015-08-14,1182320,532575,1714895
2221,REDE3,2015-09-30,2015-11-13,1182320,532575,1714895
2222,REDE3,2015-12-31,2016-03-22,1182320,532575,1714895
2223,REDE3,2016-03-31,2016-05-13,1182320,532575,1714895
2224,REDE3,2016-06-30,2016-08-12,1182320,532575,1714895
2225,REDE3,2016-09-30,2016-11-14,1182320203,532575323,1714895526
2226,REDE3,2016-12-31,2017-03-23,1418784,639091,2057875
2227,REDE3,2017-03-31,2017-05-11,1418784243,639090387,2057874630
2228,REDE3,2017-06-30,2017-08-31,2057874630,0,2057874630
2229,REDE3,2017-09-30,2017-11-14,2057874630,0,2057874630
2230,REDE3,2017-12-31,2018-03-15,2057875,0,2057875
2231,REDE3,2018-03-31,2018-05-10,2057874630,0,2057874630
2232,REDE3,2018-06-30,2018-08-08,2057874630,0,2057874630
2233,REDE3,2018-09-30,2018-11-09,2057874630,0,2057874630
2234,REDE3,2018-12-31,2019-03-21,2057874630,0,2057874630
2235,REDE3,2019-03-31,2019-05-09,2057874630,0,2057874630
2236,REDE3,2019-06-30,2019-08-08,2057874630,0,2057874630
2237,REDE3,2019-09-30,2019-11-07,2057874630,0,2057874630
2238,REDE3,2019-12-31,2020-03-12,2057874630,0,2057874630
2239,REDE3,2020-03-31,2020-05-19,2057874630,0,2057874630
2240,REDE3,2020-06-30,2020-08-13,2110323374,0,2110323374
2241,REDE3,2020-09-30,2020-11-12,2110323374,0,2110323374
2242,REDE3,2020-12-31,2021-03-11,2110323374,0,2110323374
2243,EEEL3,2010-12-31,2011-03-30,380669270,6560558,387229828
2244,EEEL3,2011-03-31,2011-06-10,380669270,6560558,387229828
2245,EEEL3,2011-06-30,2011-08-12,380669270,6560558,387229828
2246,EEEL3,2011-09-30,2011-11-11,380669270,6560558,387229828
2247,EEEL3,2011-12-31,2012-04-13,380669270,6560558,387229828
2248,EEEL3,2012-03-31,2012-05-18,380669270,6560558,387229828
2249,EEEL3,2012-06-30,2012-08-14,380669270,6560558,387229828
2250,EEEL3,2012-09-30,2012-11-14,380669270,6560558,387229828
2251,EEEL3,2012-12-31,2013-03-26,380669270,6560558,387229828
2252,EEEL3,2013-03-31,2013-05-15,380669270,6560558,387229828
2253,EEEL3,2013-06-30,2013-08-14,380669270,6560558,387229828
2254,EEEL3,2013-09-30,2013-11-14,380669270,6560558,387229828
2255,EEEL3,2013-12-31,2014-03-31,380669270,6560558,387229828
2256,EEEL3,2014-03-31,2014-05-15,380669270,6560558,387229828
2257,EEEL3,2014-06-30,2014-08-14,380669270,6560558,387229828
2258,EEEL3,2014-09-30,2014-11-14,380669270,6560558,387229828
2259,EEEL3,2014-12-31,2015-03-30,380669270,6560558,387229828
2260,EEEL3,2015-03-31,2015-05-15,380669270,6560558,387229828
2261,EEEL3,2015-06-30,2015-08-14,380669270,6560558,387229828
2262,EEEL3,2015-09-30,2015-11-13,380669270,6560558,387229828
2263,EEEL3,2015-12-31,2016-04-19,380669270,6560558,387229828
2264,EEEL3,2016-03-31,2016-05-13,380669270,6560558,387229828
2265,EEEL3,2016-06-30,2016-08-12,9516732,164014,9680746
2266,EEEL3,2016-09-30,2016-11-11,9516732,164014,9680746
2267,EEEL3,2016-12-31,2017-04-03,9516732,164014,9680746
2268,EEEL3,2017-03-31,2017-05-15,9516732,164014,9680746
2269,EEEL3,2017-06-30,2017-08-15,9516732,164014,9680746
2270,EEEL3,2017-09-30,2017-11-14,9516732,164014,9680746
2271,EEEL3,2017-12-31,2018-04-12,9516732,164014,9680746
2272,EEEL3,2018-03-31,2018-05-15,9516732,164014,9680746
2273,EEEL3,2018-06-30,2018-08-14,9516732,164014,9680746
2274,EEEL3,2018-09-30,2018-11-22,9516732,164014,9680746
2275,EEEL3,2018-12-31,2019-03-26,9516732,164014,9680746
2276,EEEL3,2019-03-31,2019-05-15,9516732,164014,9680746
2277,EEEL3,2019-06-30,2019-08-14,9516732,164014,9680746
2278,EEEL3,2019-09-30,2019-11-14,9516732,164014,9680746
2279,EEEL3,2019-12-31,2020-03-30,9516732,164014,9680746
2280,EEEL3,2020-03-31,2020-05-28,9516732,164014,9680746
2281,EEEL3,2020-06-30,2020-08-14,9516732,164014,9680746
2282,EEEL3,2020-09-30,2020-11-13,9507970,153287,9661257
2283,EEEL4,2010-12-31,2011-03-30,380669270,6560558,387229828
2284,EEEL4,2011-03-31,2011-06-10,380669270,6560558,387229828
2285,EEEL4,2011-06-30,2011-08-12,380669270,6560558,387229828
2286,EEEL4,2011-09-30,2011-11-11,380669270,6560558,387229828
2287,EEEL4,2011-12-31,2012-04-13,380669270,6560558,387229828
2288,EEEL4,2012-03-31,2012-05-18,380669270,6560558,387229828
2289,EEEL4,2012-06-30,2012-08-14,380669270,6560558,387229828
2290,EEEL4,2012-09-30,2012-11-14,380669270,6560558,387229828
2291,EEEL4,2012-12-31,2013-03-26,380669270,6560558,387229828
2292,EEEL4,2013-03-31,2013-05-15,380669270,6560558,387229828
2293,EEEL4,2013-06-30,2013-08-14,380669270,6560558,387229828
2294,EEEL4,2013-09-30,2013-11-14,380669270,6560558,387229828
2295,EEEL4,2013-12-31,2014-03-31,380669270,6560558,387229828
2296,EEEL4,2014-03-31,2014-05-15,380669270,6560558,387229828
2297,EEEL4,2014-06-30,2014-08-14,380669270,6560558,387229828
2298,EEEL4,2014-09-30,2014-11-14,380669270,6560558,387229828
2299,EEEL4,2014-12-31,2015-03-30,380669270,6560558,387229828
2300,EEEL4,2015-03-31,2015-05-15,380669270,6560558,387229828
2301,EEEL4,2015-06-30,2015-08-14,380669270,6560558,387229828
2302,EEEL4,2015-09-30,2015-11-13,380669270,6560558,387229828
2303,EEEL4,2015-12-31,2016-04-19,380669270,6560558,387229828
2304,EEEL4,2016-03-31,2016-05-13,380669270,6560558,387229828
2305,EEEL4,2016-06-30,2016-08-12,9516732,164014,9680746
2306,EEEL4,2016-09-30,2016-11-11,9516732,164014,9680746
2307,EEEL4,2016-12-31,2017-04-03,9516732,164014,9680746
2308,EEEL4,2017-03-31,2017-05-15,9516732,164014,9680746
2309,EEEL4,2017-06-30,2017-08-15,9516732,164014,9680746
2310,EEEL4,2017-09-30,2017-11-14,9516732,164014,9680746
2311,EEEL4,2017-12-31,2018-04-12,9516732,164014,9680746
2312,EEEL4,2018-03-31,2018-05-15,9516732,164014,9680746
2313,EEEL4,2018-06-30,2018-08-14,9516732,164014,9680746
2314,EEEL4,2018-09-30,2018-11-22,9516732,164014,9680746
2315,EEEL4,2018-12-31,2019-03-26,9516732,164014,9680746
2316,EEEL4,2019-03-31,2019-05-15,9516732,164014,9680746
2317,EEEL4,2019-06-30,2019-08-14,9516732,164014,9680746
2318,EEEL4,2019-09-30,2019-11-14,9516732,164014,9680746
2319,EEEL4,2019-12-31,2020-03-30,9516732,164014,9680746
2320,EEEL4,2020-03-31,2020-05-28,9516732,164014,9680746
2321,EEEL4,2020-06-30,2020-08-14,9516732,164014,9680746
2322,EEEL4,2020-09-30,2020-11-13,9507970,153287,9661257
2323,HBTS3,2010-12-31,2011-03-30,3153,5981,9134
2324,HBTS3,2011-03-31,2011-05-16,3153,5981,9134
2325,HBTS3,2011-06-30,2011-08-15,3153,5981,9134
2326,HBTS3,2011-09-30,2011-11-14,3153,5981,9134
2327,HBTS3,2011-12-31,2012-03-30,3152764,5980923,9133687
2328,HBTS3,2012-03-31,2012-05-11,3152764,5980923,9133687
2329,HBTS3,2012-06-30,2012-08-15,3152764,5980923,9133687
2330,HBTS3,2012-09-30,2012-11-14,3152764,5980923,9133687
2331,HBTS3,2012-12-31,2013-03-28,3152764,5980923,9133687
2332,HBTS3,2013-03-31,2013-05-14,3152764,5980923,9133687
2333,HBTS3,2013-06-30,2013-08-14,3152764,5980923,9133687
2334,HBTS3,2013-09-30,2013-11-14,3152764,5980923,9133687
2335,HBTS3,2013-12-31,2014-03-31,3152764,5980923,9133687
2336,HBTS3,2014-03-31,2014-05-14,3152764,5980923,9133687
2337,HBTS3,2014-06-30,2014-08-14,3152764,5980923,9133687
2338,HBTS3,2014-09-30,2014-11-13,3152764,5980923,9133687
2339,HBTS3,2014-12-31,2015-03-30,3152764,5980923,9133687
2340,HBTS3,2015-03-31,2015-05-15,3152764,5980923,9133687
2341,HBTS3,2015-06-30,2015-08-14,3152764,5980923,9133687
2342,HBTS3,2015-09-30,2015-11-13,3152764,5980923,9133687
2343,HBTS3,2015-12-31,2016-03-28,3152764,5980923,9133687
2344,HBTS3,2016-03-31,2016-05-13,3152764,5980923,9133687
2345,HBTS3,2016-06-30,2016-08-12,3152764,5980923,9133687
2346,HBTS3,2016-09-30,2016-11-14,3152764,5980923,9133687
2347,HBTS3,2016-12-31,2017-03-28,3152764,5980923,9133687
2348,HBTS3,2017-03-31,2017-05-15,3152764,5980923,9133687
2349,HBTS3,2017-06-30,2017-08-14,3152764,5980923,9133687
2350,HBTS3,2017-09-30,2017-11-14,3152764,5980923,9133687
2351,HBTS3,2017-12-31,2018-05-14,3152764,5980923,9133687
2352,HBTS3,2018-03-31,2018-07-10,3152764,5980923,9133687
2353,HBTS3,2018-06-30,2018-08-14,3152764,5980923,9133687
2354,HBTS3,2018-09-30,2018-11-14,3152764,5980923,9133687
2355,HBTS3,2018-12-31,2019-03-28,3152764,5980923,9133687
2356,HBTS3,2019-03-31,2019-05-15,3152764,5980923,9133687
2357,HBTS3,2019-06-30,2019-08-12,3152764,5980923,9133687
2358,HBTS3,2019-09-30,2019-11-13,3152764,5980923,9133687
2359,HBTS3,2019-12-31,2020-03-26,3152764,5980923,9133687
2360,HBTS3,2020-03-31,2020-05-15,3152764,5980923,9133687
2361,HBTS3,2020-06-30,2020-08-14,3152764,5980923,9133687
2362,HBTS3,2020-09-30,2020-11-13,3152764,5980923,9133687
2363,HBTS5,2010-12-31,2011-03-30,3153,5981,9134
2364,HBTS5,2011-03-31,2011-05-16,3153,5981,9134
2365,HBTS5,2011-06-30,2011-08-15,3153,5981,9134
2366,HBTS5,2011-09-30,2011-11-14,3153,5981,9134
2367,HBTS5,2011-12-31,2012-03-30,3152764,5980923,9133687
2368,HBTS5,2012-03-31,2012-05-11,3152764,5980923,9133687
2369,HBTS5,2012-06-30,2012-08-15,3152764,5980923,9133687
2370,HBTS5,2012-09-30,2012-11-14,3152764,5980923,9133687
2371,HBTS5,2012-12-31,2013-03-28,3152764,5980923,9133687
2372,HBTS5,2013-03-31,2013-05-14,3152764,5980923,9133687
2373,HBTS5,2013-06-30,2013-08-14,3152764,5980923,9133687
2374,HBTS5,2013-09-30,2013-11-14,3152764,5980923,9133687
2375,HBTS5,2013-12-31,2014-03-31,3152764,5980923,9133687
2376,HBTS5,2014-03-31,2014-05-14,3152764,5980923,9133687
2377,HBTS5,2014-06-30,2014-08-14,3152764,5980923,9133687
2378,HBTS5,2014-09-30,2014-11-13,3152764,5980923,9133687
2379,HBTS5,2014-12-31,2015-03-30,3152764,5980923,9133687
2380,HBTS5,2015-03-31,2015-05-15,3152764,5980923,9133687
2381,HBTS5,2015-06-30,2015-08-14,3152764,5980923,9133687
2382,HBTS5,2015-09-30,2015-11-13,3152764,5980923,9133687
2383,HBTS5,2015-12-31,2016-03-28,3152764,5980923,9133687
2384,HBTS5,2016-03-31,2016-05-13,3152764,5980923,9133687
2385,HBTS5,2016-06-30,2016-08-12,3152764,5980923,9133687
2386,HBTS5,2016-09-30,2016-11-14,3152764,5980923,9133687
2387,HBTS5,2016-12-31,2017-03-28,3152764,5980923,9133687
2388,HBTS5,2017-03-31,2017-05-15,3152764,5980923,9133687
2389,HBTS5,2017-06-30,2017-08-14,3152764,5980923,9133687
2390,HBTS5,2017-09-30,2017-11-14,3152764,5980923,9133687
2391,HBTS5,2017-12-31,2018-05-14,3152764,5980923,9133687
2392,HBTS5,2018-03-31,2018-07-10,3152764,5980923,9133687
2393,HBTS5,2018-06-30,2018-08-14,3152764,5980923,9133687
2394,HBTS5,2018-09-30,2018-11-14,3152764,5980923,9133687
2395,HBTS5,2018-12-31,2019-03-28,3152764,5980923,9133687
2396,HBTS5,2019-03-31,2019-05-15,3152764,5980923,9133687
2397,HBTS5,2019-06-30,2019-08-12,3152764,5980923,9133687
2398,HBTS5,2019-09-30,2019-11-13,3152764,5980923,9133687
2399,HBTS5,2019-12-31,2020-03-26,3152764,5980923,9133687
2400,HBTS5,2020-03-31,2020-05-15,3152764,5980923,9133687
2401,HBTS5,2020-06-30,2020-08-14,3152764,5980923,9133687
2402,HBTS5,2020-09-30,2020-11-13,3152764,5980923,9133687
2403,HBTS6,2010-12-31,2011-03-30,3153,5981,9134
2404,HBTS6,2011-03-31,2011-05-16,3153,5981,9134
2405,HBTS6,2011-06-30,2011-08-15,3153,5981,9134
2406,HBTS6,2011-09-30,2011-11-14,3153,5981,9134
2407,HBTS6,2011-12-31,2012-03-30,3152764,5980923,9133687
2408,HBTS6,2012-03-31,2012-05-11,3152764,5980923,9133687
2409,HBTS6,2012-06-30,2012-08-15,3152764,5980923,9133687
2410,HBTS6,2012-09-30,2012-11-14,3152764,5980923,9133687
2411,HBTS6,2012-12-31,2013-03-28,3152764,5980923,9133687
2412,HBTS6,2013-03-31,2013-05-14,3152764,5980923,9133687
2413,HBTS6,2013-06-30,2013-08-14,3152764,5980923,9133687
2414,HBTS6,2013-09-30,2013-11-14,3152764,5980923,9133687
2415,HBTS6,2013-12-31,2014-03-31,3152764,5980923,9133687
2416,HBTS6,2014-03-31,2014-05-14,3152764,5980923,9133687
2417,HBTS6,2014-06-30,2014-08-14,3152764,5980923,9133687
2418,HBTS6,2014-09-30,2014-11-13,3152764,5980923,9133687
2419,HBTS6,2014-12-31,2015-03-30,3152764,5980923,9133687
2420,HBTS6,2015-03-31,2015-05-15,3152764,5980923,9133687
2421,HBTS6,2015-06-30,2015-08-14,3152764,5980923,9133687
2422,HBTS6,2015-09-30,2015-11-13,3152764,5980923,9133687
2423,HBTS6,2015-12-31,2016-03-28,3152764,5980923,9133687
2424,HBTS6,2016-03-31,2016-05-13,3152764,5980923,9133687
2425,HBTS6,2016-06-30,2016-08-12,3152764,5980923,9133687
2426,HBTS6,2016-09-30,2016-11-14,3152764,5980923,9133687
2427,HBTS6,2016-12-31,2017-03-28,3152764,5980923,9133687
2428,HBTS6,2017-03-31,2017-05-15,3152764,5980923,9133687
2429,HBTS6,2017-06-30,2017-08-14,3152764,5980923,9133687
2430,HBTS6,2017-09-30,2017-11-14,3152764,5980923,9133687
2431,HBTS6,2017-12-31,2018-05-14,3152764,5980923,9133687
2432,HBTS6,2018-03-31,2018-07-10,3152764,5980923,9133687
2433,HBTS6,2018-06-30,2018-08-14,3152764,5980923,9133687
2434,HBTS6,2018-09-30,2018-11-14,3152764,5980923,9133687
2435,HBTS6,2018-12-31,2019-03-28,3152764,5980923,9133687
2436,HBTS6,2019-03-31,2019-05-15,3152764,5980923,9133687
2437,HBTS6,2019-06-30,2019-08-12,3152764,5980923,9133687
2438,HBTS6,2019-09-30,2019-11-13,3152764,5980923,9133687
2439,HBTS6,2019-12-31,2020-03-26,3152764,5980923,9133687
2440,HBTS6,2020-03-31,2020-05-15,3152764,5980923,9133687
2441,HBTS6,2020-06-30,2020-08-14,3152764,5980923,9133687
2442,HBTS6,2020-09-30,2020-11-13,3152764,5980923,9133687
2443,CATA3,2010-12-31,2011-03-31,144,1,145
2444,CATA3,2011-03-31,2011-05-17,144,1,145
2445,CATA3,2011-06-30,2015-12-15,144,1,145
2446,CATA3,2011-09-30,2015-12-15,144,1,145
2447,CATA3,2011-12-31,2012-05-01,144,1,145
2448,CATA3,2012-03-31,2012-05-19,144,1,145
2449,CATA3,2012-06-30,2012-08-20,144,1,145
2450,CATA3,2012-09-30,2012-11-14,144,1,145
2451,CATA3,2012-12-31,2013-03-16,144,1,145
2452,CATA3,2013-03-31,2013-05-03,144,1,145
2453,CATA3,2013-06-30,2013-08-12,144,1,145
2454,CATA3,2013-09-30,2013-11-12,144,1,145
2455,CATA3,2013-12-31,2014-03-26,144,1,145
2456,CATA3,2014-03-31,2014-05-16,144,1,145
2457,CATA3,2014-06-30,2014-08-11,144,1,145
2458,CATA3,2014-09-30,2014-11-10,144,1,145
2459,CATA3,2014-12-31,2015-03-25,144,1,145
2460,CATA3,2015-03-31,2015-05-14,144,1,145
2461,CATA3,2015-06-30,2015-08-20,144,1,145
2462,CATA3,2015-09-30,2015-11-12,144,1,145
2463,CATA3,2015-12-31,2016-03-15,144,1,145
2464,CATA3,2016-03-31,2016-05-12,144,1,145
2465,CATA3,2016-06-30,2016-08-09,144,1,145
2466,CATA3,2016-09-30,2016-11-10,144,1,145
2467,CATA3,2016-12-31,2017-03-15,144,1,145
2468,CATA3,2017-03-31,2017-05-10,144,1,145
2469,CATA3,2017-06-30,2017-08-14,144,1,145
2470,CATA3,2017-09-30,2017-11-13,144,1,145
2471,CATA3,2017-12-31,2018-03-29,144,1,145
2472,CATA3,2018-03-31,2018-05-14,144,1,145
2473,CATA3,2018-06-30,2018-08-14,144,1,145
2474,CATA3,2018-09-30,2018-11-14,144,1,145
2475,CATA3,2018-12-31,2019-03-29,144,1,145
2476,CATA3,2019-03-31,2019-05-15,144,1,145
2477,CATA3,2019-06-30,2019-08-14,144,1,145
2478,CATA3,2019-09-30,2019-11-14,144,1,145
2479,CATA3,2019-12-31,2020-03-24,144,1,145
2480,CATA3,2020-03-31,2020-06-23,144,1,145
2481,CATA3,2020-06-30,2020-08-06,144,1,145
2482,CATA3,2020-09-30,2020-11-10,144,1,145
2483,CATA3,2020-12-31,2021-03-04,144,1,145
2484,CATA4,2010-12-31,2011-03-31,144,1,145
2485,CATA4,2011-03-31,2011-05-17,144,1,145
2486,CATA4,2011-06-30,2015-12-15,144,1,145
2487,CATA4,2011-09-30,2015-12-15,144,1,145
2488,CATA4,2011-12-31,2012-05-01,144,1,145
2489,CATA4,2012-03-31,2012-05-19,144,1,145
2490,CATA4,2012-06-30,2012-08-20,144,1,145
2491,CATA4,2012-09-30,2012-11-14,144,1,145
2492,CATA4,2012-12-31,2013-03-16,144,1,145
2493,CATA4,2013-03-31,2013-05-03,144,1,145
2494,CATA4,2013-06-30,2013-08-12,144,1,145
2495,CATA4,2013-09-30,2013-11-12,144,1,145
2496,CATA4,2013-12-31,2014-03-26,144,1,145
2497,CATA4,2014-03-31,2014-05-16,144,1,145
2498,CATA4,2014-06-30,2014-08-11,144,1,145
2499,CATA4,2014-09-30,2014-11-10,144,1,145
2500,CATA4,2014-12-31,2015-03-25,144,1,145
2501,CATA4,2015-03-31,2015-05-14,144,1,145
2502,CATA4,2015-06-30,2015-08-20,144,1,145
2503,CATA4,2015-09-30,2015-11-12,144,1,145
2504,CATA4,2015-12-31,2016-03-15,144,1,145
2505,CATA4,2016-03-31,2016-05-12,144,1,145
2506,CATA4,2016-06-30,2016-08-09,144,1,145
2507,CATA4,2016-09-30,2016-11-10,144,1,145
2508,CATA4,2016-12-31,2017-03-15,144,1,145
2509,CATA4,2017-03-31,2017-05-10,144,1,145
2510,CATA4,2017-06-30,2017-08-14,144,1,145
2511,CATA4,2017-09-30,2017-11-13,144,1,145
2512,CATA4,2017-12-31,2018-03-29,144,1,145
2513,CATA4,2018-03-31,2018-05-14,144,1,145
2514,CATA4,2018-06-30,2018-08-14,144,1,145
2515,CATA4,2018-09-30,2018-11-14,144,1,145
2516,CATA4,2018-12-31,2019-03-29,144,1,145
2517,CATA4,2019-03-31,2019-05-15,144,1,145
2518,CATA4,2019-06-30,2019-08-14,144,1,145
2519,CATA4,2019-09-30,2019-11-14,144,1,145
2520,CATA4,2019-12-31,2020-03-24,144,1,145
2521,CATA4,2020-03-31,2020-06-23,144,1,145
2522,CATA4,2020-06-30,2020-08-06,144,1,145
2523,CATA4,2020-09-30,2020-11-10,144,1,145
2524,CATA4,2020-12-31,2021-03-04,144,1,145
2525,MSPA3,2010-12-31,2011-06-03,5796,777,6573
2526,MSPA3,2011-03-31,2011-05-27,5796,777,6573
2527,MSPA3,2011-06-30,2011-08-15,5796,777,6573
2528,MSPA3,2011-09-30,2011-11-14,5796,777,6573
2529,MSPA3,2011-12-31,2012-03-23,5796,777,6573
2530,MSPA3,2012-03-31,2012-05-10,5796,777,6573
2531,MSPA3,2012-06-30,2013-03-25,5796,777,6573
2532,MSPA3,2012-09-30,2013-03-25,5796,777,6573
2533,MSPA3,2012-12-31,2013-03-25,5631,774,6405
2534,MSPA3,2013-03-31,2013-05-14,5631,774,6405
2535,MSPA3,2013-06-30,2013-08-12,5631,774,6405
2536,MSPA3,2013-09-30,2013-11-14,5631,774,6405
2537,MSPA3,2013-12-31,2014-07-22,5631,774,6405
2538,MSPA3,2014-03-31,2014-05-14,5631,774,6405
2539,MSPA3,2014-06-30,2014-08-14,5631,774,6405
2540,MSPA3,2014-09-30,2014-11-14,5631,774,6405
2541,MSPA3,2014-12-31,2015-03-19,5631,774,6405
2542,MSPA3,2015-03-31,2015-05-14,5631,774,6405
2543,MSPA3,2015-06-30,2015-08-13,5631,774,6405
2544,MSPA3,2015-09-30,2015-11-12,5631,774,6405
2545,MSPA3,2015-12-31,2016-03-23,5631,774,6405
2546,MSPA3,2016-03-31,2016-05-13,5631,774,6405
2547,MSPA3,2016-06-30,2016-08-12,5631,774,6405
2548,MSPA3,2016-09-30,2016-11-11,5631,774,6405
2549,MSPA3,2016-12-31,2017-03-15,5631,774,6405
2550,MSPA3,2017-03-31,2017-05-15,5631,774,6405
2551,MSPA3,2017-06-30,2017-08-15,5631,774,6405
2552,MSPA3,2017-09-30,2017-11-14,5631,774,6405
2553,MSPA3,2017-12-31,2018-03-26,5631,774,6405
2554,MSPA3,2018-03-31,2018-05-15,5631,774,6405
2555,MSPA3,2018-06-30,2018-08-15,5631,774,6405
2556,MSPA3,2018-09-30,2018-11-13,5631,774,6405
2557,MSPA3,2018-12-31,2019-03-25,5631,774,6405
2558,MSPA3,2019-03-31,2019-05-14,5631,774,6405
2559,MSPA3,2019-06-30,2019-08-13,5629,770,6399
2560,MSPA3,2019-09-30,2019-10-30,5629,770,6399
2561,MSPA3,2019-12-31,2020-03-11,5629,770,6399
2562,MSPA3,2020-03-31,2020-06-25,5629,770,6399
2563,MSPA3,2020-06-30,2020-08-28,5629,770,6399
2564,MSPA3,2020-09-30,2020-11-10,5629,770,6399
2565,MSPA4,2010-12-31,2011-06-03,5796,777,6573
2566,MSPA4,2011-03-31,2011-05-27,5796,777,6573
2567,MSPA4,2011-06-30,2011-08-15,5796,777,6573
2568,MSPA4,2011-09-30,2011-11-14,5796,777,6573
2569,MSPA4,2011-12-31,2012-03-23,5796,777,6573
2570,MSPA4,2012-03-31,2012-05-10,5796,777,6573
2571,MSPA4,2012-06-30,2013-03-25,5796,777,6573
2572,MSPA4,2012-09-30,2013-03-25,5796,777,6573
2573,MSPA4,2012-12-31,2013-03-25,5631,774,6405
2574,MSPA4,2013-03-31,2013-05-14,5631,774,6405
2575,MSPA4,2013-06-30,2013-08-12,5631,774,6405
2576,MSPA4,2013-09-30,2013-11-14,5631,774,6405
2577,MSPA4,2013-12-31,2014-07-22,5631,774,6405
2578,MSPA4,2014-03-31,2014-05-14,5631,774,6405
2579,MSPA4,2014-06-30,2014-08-14,5631,774,6405
2580,MSPA4,2014-09-30,2014-11-14,5631,774,6405
2581,MSPA4,2014-12-31,2015-03-19,5631,774,6405
2582,MSPA4,2015-03-31,2015-05-14,5631,774,6405
2583,MSPA4,2015-06-30,2015-08-13,5631,774,6405
2584,MSPA4,2015-09-30,2015-11-12,5631,774,6405
2585,MSPA4,2015-12-31,2016-03-23,5631,774,6405
2586,MSPA4,2016-03-31,2016-05-13,5631,774,6405
2587,MSPA4,2016-06-30,2016-08-12,5631,774,6405
2588,MSPA4,2016-09-30,2016-11-11,5631,774,6405
2589,MSPA4,2016-12-31,2017-03-15,5631,774,6405
2590,MSPA4,2017-03-31,2017-05-15,5631,774,6405
2591,MSPA4,2017-06-30,2017-08-15,5631,774,6405
2592,MSPA4,2017-09-30,2017-11-14,5631,774,6405
2593,MSPA4,2017-12-31,2018-03-26,5631,774,6405
2594,MSPA4,2018-03-31,2018-05-15,5631,774,6405
2595,MSPA4,2018-06-30,2018-08-15,5631,774,6405
2596,MSPA4,2018-09-30,2018-11-13,5631,774,6405
2597,MSPA4,2018-12-31,2019-03-25,5631,774,6405
2598,MSPA4,2019-03-31,2019-05-14,5631,774,6405
2599,MSPA4,2019-06-30,2019-08-13,5629,770,6399
2600,MSPA4,2019-09-30,2019-10-30,5629,770,6399
2601,MSPA4,2019-12-31,2020-03-11,5629,770,6399
2602,MSPA4,2020-03-31,2020-06-25,5629,770,6399
2603,MSPA4,2020-06-30,2020-08-28,5629,770,6399
2604,MSPA4,2020-09-30,2020-11-10,5629,770,6399
2605,CRIV3,2010-12-31,2011-02-18,59439,46327,105766
2606,CRIV3,2011-03-31,2011-05-16,59439,46327,105766
2607,CRIV3,2011-06-30,2011-08-12,59439,46327,105766
2608,CRIV3,2011-09-30,2011-11-10,59439,46327,105766
2609,CRIV3,2011-12-31,2012-02-14,59439,46327,105766
2610,CRIV3,2012-03-31,2012-05-14,59439,46327,105766
2611,CRIV3,2012-06-30,2012-08-14,59439,46327,105766
2612,CRIV3,2012-09-30,2012-11-14,59439,46327,105766
2613,CRIV3,2012-12-31,2013-03-01,59439,46327,105766
2614,CRIV3,2013-03-31,2013-05-14,59439,46327,105766
2615,CRIV3,2013-06-30,2013-09-02,59439,46327,105766
2616,CRIV3,2013-09-30,2013-11-14,59439,46327,105766
2617,CRIV3,2013-12-31,2014-03-20,59439,46327,105766
2618,CRIV3,2014-03-31,2014-05-14,59439,46327,105766
2619,CRIV3,2014-06-30,2014-08-14,59439,46327,105766
2620,CRIV3,2014-09-30,2014-11-14,59439,46327,105766
2621,CRIV3,2014-12-31,2015-03-20,59439,46327,105766
2622,CRIV3,2015-03-31,2015-05-14,59439,46327,105766
2623,CRIV3,2015-06-30,2015-08-13,59439,46327,105766
2624,CRIV3,2015-09-30,2015-11-12,59439,46327,105766
2625,CRIV3,2015-12-31,2016-03-18,59043,44472,103515
2626,CRIV3,2016-03-31,2016-05-13,59043,44472,103515
2627,CRIV3,2016-06-30,2016-08-11,59042,44472,103514
2628,CRIV3,2016-09-30,2016-11-10,59042969,44471587,103514556
2629,CRIV3,2016-12-31,2017-03-17,59042969,44471587,103514556
2630,CRIV3,2017-03-31,2017-05-12,58783569,44319187,103102756
2631,CRIV3,2017-06-30,2017-08-14,58783569,44319187,103102756
2632,CRIV3,2017-09-30,2017-11-10,58783569,44319187,103102756
2633,CRIV3,2017-12-31,2018-03-16,58742969,44233987,102976956
2634,CRIV3,2018-03-31,2018-05-11,58736269,44206287,102942556
2635,CRIV3,2018-06-30,2018-08-10,58736269,44206287,102942556
2636,CRIV3,2018-09-30,2018-11-09,58736269,44206287,102942556
2637,CRIV3,2018-12-31,2019-03-15,58736269,44206287,102942556
2638,CRIV3,2019-03-31,2019-05-10,58736269,44206287,102942556
2639,CRIV3,2019-06-30,2019-08-09,58736269,44206287,102942556
2640,CRIV3,2019-09-30,2019-11-08,58736269,44206287,102942556
2641,CRIV3,2019-12-31,2020-03-19,58736269,44206287,102942556
2642,CRIV3,2020-03-31,2020-05-12,58736269,44206287,102942556
2643,CRIV3,2020-06-30,2020-08-12,58736269,44206287,102942556
2644,CRIV3,2020-09-30,2020-11-11,58736269,44206287,102942556
2645,CRIV3,2020-12-31,2021-03-02,58736269,44206287,102942556
2646,CRIV4,2010-12-31,2011-02-18,59439,46327,105766
2647,CRIV4,2011-03-31,2011-05-16,59439,46327,105766
2648,CRIV4,2011-06-30,2011-08-12,59439,46327,105766
2649,CRIV4,2011-09-30,2011-11-10,59439,46327,105766
2650,CRIV4,2011-12-31,2012-02-14,59439,46327,105766
2651,CRIV4,2012-03-31,2012-05-14,59439,46327,105766
2652,CRIV4,2012-06-30,2012-08-14,59439,46327,105766
2653,CRIV4,2012-09-30,2012-11-14,59439,46327,105766
2654,CRIV4,2012-12-31,2013-03-01,59439,46327,105766
2655,CRIV4,2013-03-31,2013-05-14,59439,46327,105766
2656,CRIV4,2013-06-30,2013-09-02,59439,46327,105766
2657,CRIV4,2013-09-30,2013-11-14,59439,46327,105766
2658,CRIV4,2013-12-31,2014-03-20,59439,46327,105766
2659,CRIV4,2014-03-31,2014-05-14,59439,46327,105766
2660,CRIV4,2014-06-30,2014-08-14,59439,46327,105766
2661,CRIV4,2014-09-30,2014-11-14,59439,46327,105766
2662,CRIV4,2014-12-31,2015-03-20,59439,46327,105766
2663,CRIV4,2015-03-31,2015-05-14,59439,46327,105766
2664,CRIV4,2015-06-30,2015-08-13,59439,46327,105766
2665,CRIV4,2015-09-30,2015-11-12,59439,46327,105766
2666,CRIV4,2015-12-31,2016-03-18,59043,44472,103515
2667,CRIV4,2016-03-31,2016-05-13,59043,44472,103515
2668,CRIV4,2016-06-30,2016-08-11,59042,44472,103514
2669,CRIV4,2016-09-30,2016-11-10,59042969,44471587,103514556
2670,CRIV4,2016-12-31,2017-03-17,59042969,44471587,103514556
2671,CRIV4,2017-03-31,2017-05-12,58783569,44319187,103102756
2672,CRIV4,2017-06-30,2017-08-14,58783569,44319187,103102756
2673,CRIV4,2017-09-30,2017-11-10,58783569,44319187,103102756
2674,CRIV4,2017-12-31,2018-03-16,58742969,44233987,102976956
2675,CRIV4,2018-03-31,2018-05-11,58736269,44206287,102942556
2676,CRIV4,2018-06-30,2018-08-10,58736269,44206287,102942556
2677,CRIV4,2018-09-30,2018-11-09,58736269,44206287,102942556
2678,CRIV4,2018-12-31,2019-03-15,58736269,44206287,102942556
2679,CRIV4,2019-03-31,2019-05-10,58736269,44206287,102942556
2680,CRIV4,2019-06-30,2019-08-09,58736269,44206287,102942556
2681,CRIV4,2019-09-30,2019-11-08,58736269,44206287,102942556
2682,CRIV4,2019-12-31,2020-03-19,58736269,44206287,102942556
2683,CRIV4,2020-03-31,2020-05-12,58736269,44206287,102942556
2684,CRIV4,2020-06-30,2020-08-12,58736269,44206287,102942556
2685,CRIV4,2020-09-30,2020-11-11,58736269,44206287,102942556
2686,CRIV4,2020-12-31,2021-03-02,58736269,44206287,102942556
2687,GGBR3,2010-12-31,2011-03-03,505601,1011201,1516802
2688,GGBR3,2011-03-31,2011-05-12,505600573,1011201145,1516801718
2689,GGBR3,2011-06-30,2011-08-04,573627483,1146031245,1719658728
2690,GGBR3,2011-09-30,2011-11-10,573627483,1146031245,1719658728
2691,GGBR3,2011-12-31,2012-02-16,573628,1146031,1719659
2692,GGBR3,2012-03-31,2012-05-03,573627483,1146031245,1719658728
2693,GGBR3,2012-06-30,2012-08-02,573627483,1146031245,1719658728
2694,GGBR3,2012-09-30,2012-11-01,573627483,1146031245,1719658728
2695,GGBR3,2012-12-31,2013-02-21,573627483,1146031245,1719658728
2696,GGBR3,2013-03-31,2013-05-07,573627483,1146031245,1719658728
2697,GGBR3,2013-06-30,2013-08-01,573627483,1146031245,1719658728
2698,GGBR3,2013-09-30,2013-10-31,573627483,1146031245,1719658728
2699,GGBR3,2013-12-31,2014-02-21,573627483,1146031245,1719658728
2700,GGBR3,2014-03-31,2014-05-07,573627483,1146031245,1719658728
2701,GGBR3,2014-06-30,2014-07-30,573627483,1146031245,1719658728
2702,GGBR3,2014-09-30,2014-11-12,573627483,1146031245,1719658728
2703,GGBR3,2014-12-31,2015-03-05,573627483,1146031245,1719658728
2704,GGBR3,2015-03-31,2015-05-06,573627483,1146031245,1719658728
2705,GGBR3,2015-06-30,2015-08-12,573627483,1146031245,1719658728
2706,GGBR3,2015-09-30,2015-10-29,573627483,1146031245,1719658728
2707,GGBR3,2015-12-31,2016-03-15,573627483,1146031245,1719658728
2708,GGBR3,2016-03-31,2016-05-04,573627483,1146031245,1719658728
2709,GGBR3,2016-06-30,2016-08-10,573627483,1146031245,1719658728
2710,GGBR3,2016-09-30,2016-11-09,573627483,1146031245,1719658728
2711,GGBR3,2016-12-31,2017-02-22,573627483,1146031245,1719658728
2712,GGBR3,2017-03-31,2017-05-04,573627483,1146031245,1719658728
2713,GGBR3,2017-06-30,2017-08-09,573627483,1146031245,1719658728
2714,GGBR3,2017-09-30,2017-11-08,573627483,1146031245,1719658728
2715,GGBR3,2017-12-31,2018-02-28,573627483,1146031245,1719658728
2716,GGBR3,2018-03-31,2018-05-09,573627483,1146031245,1719658728
2717,GGBR3,2018-06-30,2018-08-08,573627483,1146031245,1719658728
2718,GGBR3,2018-09-30,2018-11-07,573627483,1146031245,1719658728
2719,GGBR3,2018-12-31,2019-02-21,573627483,1146031245,1719658728
2720,GGBR3,2019-03-31,2019-05-08,573627483,1146031245,1719658728
2721,GGBR3,2019-06-30,2019-08-07,573627483,1146031245,1719658728
2722,GGBR3,2019-09-30,2019-10-30,573627483,1146031245,1719658728
2723,GGBR3,2019-12-31,2020-02-19,573627483,1146031245,1719658728
2724,GGBR3,2020-03-31,2020-05-06,573627483,1146031245,1719658728
2725,GGBR3,2020-06-30,2020-08-05,573627483,1146031245,1719658728
2726,GGBR3,2020-09-30,2020-10-28,573627483,1146031245,1719658728
2727,GGBR3,2020-12-31,2021-02-24,573627483,1146031245,1719658728
2728,GGBR4,2010-12-31,2011-03-03,505601,1011201,1516802
2729,GGBR4,2011-03-31,2011-05-12,505600573,1011201145,1516801718
2730,GGBR4,2011-06-30,2011-08-04,573627483,1146031245,1719658728
2731,GGBR4,2011-09-30,2011-11-10,573627483,1146031245,1719658728
2732,GGBR4,2011-12-31,2012-02-16,573628,1146031,1719659
2733,GGBR4,2012-03-31,2012-05-03,573627483,1146031245,1719658728
2734,GGBR4,2012-06-30,2012-08-02,573627483,1146031245,1719658728
2735,GGBR4,2012-09-30,2012-11-01,573627483,1146031245,1719658728
2736,GGBR4,2012-12-31,2013-02-21,573627483,1146031245,1719658728
2737,GGBR4,2013-03-31,2013-05-07,573627483,1146031245,1719658728
2738,GGBR4,2013-06-30,2013-08-01,573627483,1146031245,1719658728
2739,GGBR4,2013-09-30,2013-10-31,573627483,1146031245,1719658728
2740,GGBR4,2013-12-31,2014-02-21,573627483,1146031245,1719658728
2741,GGBR4,2014-03-31,2014-05-07,573627483,1146031245,1719658728
2742,GGBR4,2014-06-30,2014-07-30,573627483,1146031245,1719658728
2743,GGBR4,2014-09-30,2014-11-12,573627483,1146031245,1719658728
2744,GGBR4,2014-12-31,2015-03-05,573627483,1146031245,1719658728
2745,GGBR4,2015-03-31,2015-05-06,573627483,1146031245,1719658728
2746,GGBR4,2015-06-30,2015-08-12,573627483,1146031245,1719658728
2747,GGBR4,2015-09-30,2015-10-29,573627483,1146031245,1719658728
2748,GGBR4,2015-12-31,2016-03-15,573627483,1146031245,1719658728
2749,GGBR4,2016-03-31,2016-05-04,573627483,1146031245,1719658728
2750,GGBR4,2016-06-30,2016-08-10,573627483,1146031245,1719658728
2751,GGBR4,2016-09-30,2016-11-09,573627483,1146031245,1719658728
2752,GGBR4,2016-12-31,2017-02-22,573627483,1146031245,1719658728
2753,GGBR4,2017-03-31,2017-05-04,573627483,1146031245,1719658728
2754,GGBR4,2017-06-30,2017-08-09,573627483,1146031245,1719658728
2755,GGBR4,2017-09-30,2017-11-08,573627483,1146031245,1719658728
2756,GGBR4,2017-12-31,2018-02-28,573627483,1146031245,1719658728
2757,GGBR4,2018-03-31,2018-05-09,573627483,1146031245,1719658728
2758,GGBR4,2018-06-30,2018-08-08,573627483,1146031245,1719658728
2759,GGBR4,2018-09-30,2018-11-07,573627483,1146031245,1719658728
2760,GGBR4,2018-12-31,2019-02-21,573627483,1146031245,1719658728
2761,GGBR4,2019-03-31,2019-05-08,573627483,1146031245,1719658728
2762,GGBR4,2019-06-30,2019-08-07,573627483,1146031245,1719658728
2763,GGBR4,2019-09-30,2019-10-30,573627483,1146031245,1719658728
2764,GGBR4,2019-12-31,2020-02-19,573627483,1146031245,1719658728
2765,GGBR4,2020-03-31,2020-05-06,573627483,1146031245,1719658728
2766,GGBR4,2020-06-30,2020-08-05,573627483,1146031245,1719658728
2767,GGBR4,2020-09-30,2020-10-28,573627483,1146031245,1719658728
2768,GGBR4,2020-12-31,2021-02-24,573627483,1146031245,1719658728
2769,CSNA3,2010-12-31,2011-03-28,1483033685,0,1483033685
2770,CSNA3,2011-03-31,2011-05-03,1483033685,0,1483033685
2771,CSNA3,2011-06-30,2011-08-02,1483033685,0,1483033685
2772,CSNA3,2011-09-30,2011-10-27,1457970108,0,1457970108
2773,CSNA3,2011-12-31,2012-03-26,1457970108,0,1457970108
2774,CSNA3,2012-03-31,2012-05-10,1457970108,0,1457970108
2775,CSNA3,2012-06-30,2012-08-14,1457970108,0,1457970108
2776,CSNA3,2012-09-30,2012-10-31,1457970108,0,1457970108
2777,CSNA3,2012-12-31,2013-03-28,1457970108,0,1457970108
2778,CSNA3,2013-03-31,2013-05-15,1457970108,0,1457970108
2779,CSNA3,2013-06-30,2013-08-06,1457970108,0,1457970108
2780,CSNA3,2013-09-30,2013-11-14,1457970108,0,1457970108
2781,CSNA3,2013-12-31,2014-02-28,1457970108,0,1457970108
2782,CSNA3,2014-03-31,2014-05-07,1457970108,0,1457970108
2783,CSNA3,2014-06-30,2014-08-04,1457970108,0,1457970108
2784,CSNA3,2014-09-30,2014-11-14,1387524047,0,1387524047
2785,CSNA3,2014-12-31,2015-03-12,1387524047,0,1387524047
2786,CSNA3,2015-03-31,2015-05-06,1387524047,0,1387524047
2787,CSNA3,2015-06-30,2015-08-13,1387524047,0,1387524047
2788,CSNA3,2015-09-30,2015-11-13,1387524047,0,1387524047
2789,CSNA3,2015-12-31,2016-11-14,1387524047,0,1387524047
2790,CSNA3,2016-03-31,2017-10-30,1387524047,0,1387524047
2791,CSNA3,2016-06-30,2017-10-30,1387524047,0,1387524047
2792,CSNA3,2016-09-30,2017-10-30,1387524047,0,1387524047
2793,CSNA3,2016-12-31,2017-10-28,1387524047,0,1387524047
2794,CSNA3,2017-03-31,2017-12-26,1387524047,0,1387524047
2795,CSNA3,2017-06-30,2017-12-26,1387524047,0,1387524047
2796,CSNA3,2017-09-30,2017-12-26,1387524047,0,1387524047
2797,CSNA3,2017-12-31,2018-04-06,1387524047,0,1387524047
2798,CSNA3,2018-03-31,2018-05-14,1387524047,0,1387524047
2799,CSNA3,2018-06-30,2018-08-08,1387524047,0,1387524047
2800,CSNA3,2018-09-30,2018-11-07,1387524047,0,1387524047
2801,CSNA3,2018-12-31,2019-02-20,1387524047,0,1387524047
2802,CSNA3,2019-03-31,2019-05-08,1387524047,0,1387524047
2803,CSNA3,2019-06-30,2019-07-30,1387524047,0,1387524047
2804,CSNA3,2019-09-30,2019-10-23,1387524047,0,1387524047
2805,CSNA3,2019-12-31,2020-03-04,1387524047,0,1387524047
2806,CSNA3,2020-03-31,2020-05-14,1387524047,0,1387524047
2807,CSNA3,2020-06-30,2020-07-28,1387524047,0,1387524047
2808,CSNA3,2020-09-30,2020-10-15,1387524047,0,1387524047
2809,CSNA3,2020-12-31,2021-02-22,1387524047,0,1387524047
2810,CTSA3,2010-12-31,2011-04-18,38041,1258,39299
2811,CTSA3,2011-03-31,2011-05-16,38041,1258,39299
2812,CTSA3,2011-06-30,2011-08-15,38041,1258,39299
2813,CTSA3,2011-09-30,2011-11-14,38041,1258,39299
2814,CTSA3,2011-12-31,2012-03-30,38041,1258,39299
2815,CTSA3,2012-03-31,2012-05-15,38041,1258,39299
2816,CTSA3,2012-06-30,2012-08-14,38041,1258,39299
2817,CTSA3,2012-09-30,2012-11-14,38041,1258,39299
2818,CTSA3,2012-12-31,2013-03-19,38041,1258,39299
2819,CTSA3,2013-03-31,2013-05-15,38041,1258,39299
2820,CTSA3,2013-06-30,2013-08-13,38041,1258,39299
2821,CTSA3,2013-09-30,2013-11-12,38041,1258,39299
2822,CTSA3,2013-12-31,2014-03-27,38041,1258,39299
2823,CTSA3,2014-03-31,2014-05-15,38041,1258,39299
2824,CTSA3,2014-06-30,2014-08-13,38041,1258,39299
2825,CTSA3,2014-09-30,2014-11-14,38041,1258,39299
2826,CTSA3,2014-12-31,2015-03-26,38041,1258,39299
2827,CTSA3,2015-03-31,2015-05-15,38041,1258,39299
2828,CTSA3,2015-06-30,2015-08-14,38041,1258,39299
2829,CTSA3,2015-09-30,2015-11-16,38041,1258,39299
2830,CTSA3,2015-12-31,2016-03-29,38041,1258,39299
2831,CTSA3,2016-03-31,2016-05-09,38041,1258,39299
2832,CTSA3,2016-06-30,2016-08-09,38041,1258,39299
2833,CTSA3,2016-09-30,2016-11-10,38041,1258,39299
2834,CTSA3,2016-12-31,2017-03-27,38041,1258,39299
2835,CTSA3,2017-03-31,2017-05-15,38041,1258,39299
2836,CTSA3,2017-06-30,2017-08-14,38041,1258,39299
2837,CTSA3,2017-09-30,2017-11-13,38041,1258,39299
2838,CTSA3,2017-12-31,2018-03-28,38041,1258,39299
2839,CTSA3,2018-03-31,2018-05-15,38041,1258,39299
2840,CTSA3,2018-06-30,2018-08-14,38041,1258,39299
2841,CTSA3,2018-09-30,2018-11-19,38041,1258,39299
2842,CTSA3,2018-12-31,2019-04-05,38041,1258,39299
2843,CTSA3,2019-03-31,2019-05-18,38041,1258,39299
2844,CTSA3,2019-06-30,2019-08-14,38041,1258,39299
2845,CTSA3,2019-09-30,2019-11-13,38041,1258,39299
2846,CTSA3,2019-12-31,2020-03-30,38041,1258,39299
2847,CTSA3,2020-03-31,2020-06-25,38041,1258,39299
2848,CTSA3,2020-06-30,2020-09-04,38041,73258,111299
2849,CTSA3,2020-09-30,2020-11-14,38041,73258,111299
2850,CTSA4,2010-12-31,2011-04-18,38041,1258,39299
2851,CTSA4,2011-03-31,2011-05-16,38041,1258,39299
2852,CTSA4,2011-06-30,2011-08-15,38041,1258,39299
2853,CTSA4,2011-09-30,2011-11-14,38041,1258,39299
2854,CTSA4,2011-12-31,2012-03-30,38041,1258,39299
2855,CTSA4,2012-03-31,2012-05-15,38041,1258,39299
2856,CTSA4,2012-06-30,2012-08-14,38041,1258,39299
2857,CTSA4,2012-09-30,2012-11-14,38041,1258,39299
2858,CTSA4,2012-12-31,2013-03-19,38041,1258,39299
2859,CTSA4,2013-03-31,2013-05-15,38041,1258,39299
2860,CTSA4,2013-06-30,2013-08-13,38041,1258,39299
2861,CTSA4,2013-09-30,2013-11-12,38041,1258,39299
2862,CTSA4,2013-12-31,2014-03-27,38041,1258,39299
2863,CTSA4,2014-03-31,2014-05-15,38041,1258,39299
2864,CTSA4,2014-06-30,2014-08-13,38041,1258,39299
2865,CTSA4,2014-09-30,2014-11-14,38041,1258,39299
2866,CTSA4,2014-12-31,2015-03-26,38041,1258,39299
2867,CTSA4,2015-03-31,2015-05-15,38041,1258,39299
2868,CTSA4,2015-06-30,2015-08-14,38041,1258,39299
2869,CTSA4,2015-09-30,2015-11-16,38041,1258,39299
2870,CTSA4,2015-12-31,2016-03-29,38041,1258,39299
2871,CTSA4,2016-03-31,2016-05-09,38041,1258,39299
2872,CTSA4,2016-06-30,2016-08-09,38041,1258,39299
2873,CTSA4,2016-09-30,2016-11-10,38041,1258,39299
2874,CTSA4,2016-12-31,2017-03-27,38041,1258,39299
2875,CTSA4,2017-03-31,2017-05-15,38041,1258,39299
2876,CTSA4,2017-06-30,2017-08-14,38041,1258,39299
2877,CTSA4,2017-09-30,2017-11-13,38041,1258,39299
2878,CTSA4,2017-12-31,2018-03-28,38041,1258,39299
2879,CTSA4,2018-03-31,2018-05-15,38041,1258,39299
2880,CTSA4,2018-06-30,2018-08-14,38041,1258,39299
2881,CTSA4,2018-09-30,2018-11-19,38041,1258,39299
2882,CTSA4,2018-12-31,2019-04-05,38041,1258,39299
2883,CTSA4,2019-03-31,2019-05-18,38041,1258,39299
2884,CTSA4,2019-06-30,2019-08-14,38041,1258,39299
2885,CTSA4,2019-09-30,2019-11-13,38041,1258,39299
2886,CTSA4,2019-12-31,2020-03-30,38041,1258,39299
2887,CTSA4,2020-03-31,2020-06-25,38041,1258,39299
2888,CTSA4,2020-06-30,2020-09-04,38041,73258,111299
2889,CTSA4,2020-09-30,2020-11-14,38041,73258,111299
2890,CTSA8,2010-12-31,2011-04-18,38041,1258,39299
2891,CTSA8,2011-03-31,2011-05-16,38041,1258,39299
2892,CTSA8,2011-06-30,2011-08-15,38041,1258,39299
2893,CTSA8,2011-09-30,2011-11-14,38041,1258,39299
2894,CTSA8,2011-12-31,2012-03-30,38041,1258,39299
2895,CTSA8,2012-03-31,2012-05-15,38041,1258,39299
2896,CTSA8,2012-06-30,2012-08-14,38041,1258,39299
2897,CTSA8,2012-09-30,2012-11-14,38041,1258,39299
2898,CTSA8,2012-12-31,2013-03-19,38041,1258,39299
2899,CTSA8,2013-03-31,2013-05-15,38041,1258,39299
2900,CTSA8,2013-06-30,2013-08-13,38041,1258,39299
2901,CTSA8,2013-09-30,2013-11-12,38041,1258,39299
2902,CTSA8,2013-12-31,2014-03-27,38041,1258,39299
2903,CTSA8,2014-03-31,2014-05-15,38041,1258,39299
2904,CTSA8,2014-06-30,2014-08-13,38041,1258,39299
2905,CTSA8,2014-09-30,2014-11-14,38041,1258,39299
2906,CTSA8,2014-12-31,2015-03-26,38041,1258,39299
2907,CTSA8,2015-03-31,2015-05-15,38041,1258,39299
2908,CTSA8,2015-06-30,2015-08-14,38041,1258,39299
2909,CTSA8,2015-09-30,2015-11-16,38041,1258,39299
2910,CTSA8,2015-12-31,2016-03-29,38041,1258,39299
2911,CTSA8,2016-03-31,2016-05-09,38041,1258,39299
2912,CTSA8,2016-06-30,2016-08-09,38041,1258,39299
2913,CTSA8,2016-09-30,2016-11-10,38041,1258,39299
2914,CTSA8,2016-12-31,2017-03-27,38041,1258,39299
2915,CTSA8,2017-03-31,2017-05-15,38041,1258,39299
2916,CTSA8,2017-06-30,2017-08-14,38041,1258,39299
2917,CTSA8,2017-09-30,2017-11-13,38041,1258,39299
2918,CTSA8,2017-12-31,2018-03-28,38041,1258,39299
2919,CTSA8,2018-03-31,2018-05-15,38041,1258,39299
2920,CTSA8,2018-06-30,2018-08-14,38041,1258,39299
2921,CTSA8,2018-09-30,2018-11-19,38041,1258,39299
2922,CTSA8,2018-12-31,2019-04-05,38041,1258,39299
2923,CTSA8,2019-03-31,2019-05-18,38041,1258,39299
2924,CTSA8,2019-06-30,2019-08-14,38041,1258,39299
2925,CTSA8,2019-09-30,2019-11-13,38041,1258,39299
2926,CTSA8,2019-12-31,2020-03-30,38041,1258,39299
2927,CTSA8,2020-03-31,2020-06-25,38041,1258,39299
2928,CTSA8,2020-06-30,2020-09-04,38041,73258,111299
2929,CTSA8,2020-09-30,2020-11-14,38041,73258,111299
2930,CTKA3,2010-12-31,2011-03-30,6121,8285,14406
2931,CTKA3,2011-03-31,2011-05-14,6121,8285,14406
2932,CTKA3,2011-06-30,2011-08-15,6121,8285,14406
2933,CTKA3,2011-09-30,2011-12-28,6121,8285,14406
2934,CTKA3,2011-12-31,2012-03-21,6121,8285,14406
2935,CTKA3,2012-03-31,2012-05-11,6121,8285,14406
2936,CTKA3,2012-06-30,2012-08-14,6121,8285,14406
2937,CTKA3,2012-09-30,2012-11-13,6121,8285,14406
2938,CTKA3,2012-12-31,2013-04-02,6121,8285,14406
2939,CTKA3,2013-03-31,2013-05-10,6121,8285,14406
2940,CTKA3,2013-06-30,2013-08-09,6121,8285,14406
2941,CTKA3,2013-09-30,2013-11-12,6121,8285,14406
2942,CTKA3,2013-12-31,2014-03-20,6121,8285,14406
2943,CTKA3,2014-03-31,2014-05-06,6121,8285,14406
2944,CTKA3,2014-06-30,2014-08-08,6121,8285,14406
2945,CTKA3,2014-09-30,2015-03-19,6121,8285,14406
2946,CTKA3,2014-12-31,2015-03-30,28784,33270,62054
2947,CTKA3,2015-03-31,2015-08-18,28784041,33269710,62053751
2948,CTKA3,2015-06-30,2015-08-13,28784,33270,62054
2949,CTKA3,2015-09-30,2015-11-12,28784,33270,62054
2950,CTKA3,2015-12-31,2016-03-28,28784,33270,62054
2951,CTKA3,2016-03-31,2016-05-13,28784,33270,62054
2952,CTKA3,2016-06-30,2016-08-12,2878,3327,6205
2953,CTKA3,2016-09-30,2016-11-10,2878,3327,6205
2954,CTKA3,2016-12-31,2017-03-29,2878,3327,6205
2955,CTKA3,2017-03-31,2017-05-17,2878,3327,6205
2956,CTKA3,2017-06-30,2017-08-15,2878,3327,6205
2957,CTKA3,2017-09-30,2018-03-28,2878,3327,6205
2958,CTKA3,2017-12-31,2018-03-29,2878,3327,6205
2959,CTKA3,2018-03-31,2018-05-15,2878,3327,6205
2960,CTKA3,2018-06-30,2018-08-14,2878,3327,6205
2961,CTKA3,2018-09-30,2018-11-14,2878,3327,6205
2962,CTKA3,2018-12-31,2019-03-28,2878,3327,6205
2963,CTKA3,2019-03-31,2019-05-15,2878,3327,6205
2964,CTKA3,2019-06-30,2019-08-14,2878,3327,6205
2965,CTKA3,2019-09-30,2019-11-14,2878,3327,6205
2966,CTKA3,2019-12-31,2020-03-30,2878,3327,6205
2967,CTKA3,2020-03-31,2020-06-26,2878,3327,6205
2968,CTKA3,2020-06-30,2020-08-28,2878,3327,6205
2969,CTKA3,2020-09-30,2020-11-16,2878,3327,6205
2970,CTKA4,2010-12-31,2011-03-30,6121,8285,14406
2971,CTKA4,2011-03-31,2011-05-14,6121,8285,14406
2972,CTKA4,2011-06-30,2011-08-15,6121,8285,14406
2973,CTKA4,2011-09-30,2011-12-28,6121,8285,14406
2974,CTKA4,2011-12-31,2012-03-21,6121,8285,14406
2975,CTKA4,2012-03-31,2012-05-11,6121,8285,14406
2976,CTKA4,2012-06-30,2012-08-14,6121,8285,14406
2977,CTKA4,2012-09-30,2012-11-13,6121,8285,14406
2978,CTKA4,2012-12-31,2013-04-02,6121,8285,14406
2979,CTKA4,2013-03-31,2013-05-10,6121,8285,14406
2980,CTKA4,2013-06-30,2013-08-09,6121,8285,14406
2981,CTKA4,2013-09-30,2013-11-12,6121,8285,14406
2982,CTKA4,2013-12-31,2014-03-20,6121,8285,14406
2983,CTKA4,2014-03-31,2014-05-06,6121,8285,14406
2984,CTKA4,2014-06-30,2014-08-08,6121,8285,14406
2985,CTKA4,2014-09-30,2015-03-19,6121,8285,14406
2986,CTKA4,2014-12-31,2015-03-30,28784,33270,62054
2987,CTKA4,2015-03-31,2015-08-18,28784041,33269710,62053751
2988,CTKA4,2015-06-30,2015-08-13,28784,33270,62054
2989,CTKA4,2015-09-30,2015-11-12,28784,33270,62054
2990,CTKA4,2015-12-31,2016-03-28,28784,33270,62054
2991,CTKA4,2016-03-31,2016-05-13,28784,33270,62054
2992,CTKA4,2016-06-30,2016-08-12,2878,3327,6205
2993,CTKA4,2016-09-30,2016-11-10,2878,3327,6205
2994,CTKA4,2016-12-31,2017-03-29,2878,3327,6205
2995,CTKA4,2017-03-31,2017-05-17,2878,3327,6205
2996,CTKA4,2017-06-30,2017-08-15,2878,3327,6205
2997,CTKA4,2017-09-30,2018-03-28,2878,3327,6205
2998,CTKA4,2017-12-31,2018-03-29,2878,3327,6205
2999,CTKA4,2018-03-31,2018-05-15,2878,3327,6205
3000,CTKA4,2018-06-30,2018-08-14,2878,3327,6205
3001,CTKA4,2018-09-30,2018-11-14,2878,3327,6205
3002,CTKA4,2018-12-31,2019-03-28,2878,3327,6205
3003,CTKA4,2019-03-31,2019-05-15,2878,3327,6205
3004,CTKA4,2019-06-30,2019-08-14,2878,3327,6205
3005,CTKA4,2019-09-30,2019-11-14,2878,3327,6205
3006,CTKA4,2019-12-31,2020-03-30,2878,3327,6205
3007,CTKA4,2020-03-31,2020-06-26,2878,3327,6205
3008,CTKA4,2020-06-30,2020-08-28,2878,3327,6205
3009,CTKA4,2020-09-30,2020-11-16,2878,3327,6205
3010,VALE3,2010-12-31,2011-02-24,3256725,2108580,5365305
3011,VALE3,2011-03-31,2011-05-05,3256725,2108580,5365305
3012,VALE3,2011-06-30,2011-07-28,3256725,2108580,5365305
3013,VALE3,2011-09-30,2011-11-07,3256725,2108580,5365305
3014,VALE3,2011-12-31,2012-06-28,3256725,2108580,5365305
3015,VALE3,2012-03-31,2012-04-25,3256725,2108580,5365305
3016,VALE3,2012-06-30,2012-07-25,3256725,2108580,5365305
3017,VALE3,2012-09-30,2012-10-24,3256725,2108580,5365305
3018,VALE3,2012-12-31,2013-03-14,3256725,2108580,5365305
3019,VALE3,2013-03-31,2013-04-25,3256725,2108580,5365305
3020,VALE3,2013-06-30,2013-08-12,3256725,2108580,5365305
3021,VALE3,2013-09-30,2013-11-06,3256725,2108580,5365305
3022,VALE3,2013-12-31,2014-03-17,3256725,2108580,5365305
3023,VALE3,2014-03-31,2014-04-30,3256725,2108580,5365305
3024,VALE3,2014-06-30,2014-07-31,3217188,2027128,5244316
3025,VALE3,2014-09-30,2014-10-30,3217188,2027128,5244316
3026,VALE3,2014-12-31,2015-02-26,3217188,2027128,5244316
3027,VALE3,2015-03-31,2015-04-30,3217188,2027128,5244316
3028,VALE3,2015-06-30,2015-07-30,3217188,2027128,5244316
3029,VALE3,2015-09-30,2015-10-22,3217188,2027128,5244316
3030,VALE3,2015-12-31,2016-02-25,3217188,2027128,5244316
3031,VALE3,2016-03-31,2016-04-28,3217188,2027128,5244316
3032,VALE3,2016-06-30,2016-07-28,3217188,2027128,5244316
3033,VALE3,2016-09-30,2016-10-27,3217188,2027128,5244316
3034,VALE3,2016-12-31,2017-02-23,3217188,2027128,5244316
3035,VALE3,2017-03-31,2017-04-27,3217188,2027128,5244316
3036,VALE3,2017-06-30,2017-07-27,3217188,2027128,5244316
3037,VALE3,2017-09-30,2017-10-26,4997545,307140,5304685
3038,VALE3,2017-12-31,2018-02-27,5284475,0,5284475
3039,VALE3,2018-03-31,2018-04-25,5284475,0,5284475
3040,VALE3,2018-06-30,2018-07-25,5284475,0,5284475
3041,VALE3,2018-09-30,2018-10-24,5284475,0,5284475
3042,VALE3,2018-12-31,2019-04-18,5284475,0,5284475
3043,VALE3,2019-03-31,2019-05-09,5284475,0,5284475
3044,VALE3,2019-06-30,2020-05-29,5284475,0,5284475
3045,VALE3,2019-09-30,2019-10-24,5284475,0,5284475
3046,VALE3,2019-12-31,2020-03-02,5284475,0,5284475
3047,VALE3,2020-03-31,2020-04-28,5284475,0,5284475
3048,VALE3,2020-06-30,2020-07-29,5284475,0,5284475
3049,VALE3,2020-09-30,2020-10-29,5284475,0,5284475
3050,VALE3,2020-12-31,2021-02-25,5284474,0,5284474
3051,ELEK3,2010-12-31,2011-02-23,14518,16967,31485
3052,ELEK3,2011-03-31,2011-05-04,14518,16967,31485
3053,ELEK3,2011-06-30,2011-08-03,14518,16967,31485
3054,ELEK3,2011-09-30,2011-11-03,14518,16967,31485
3055,ELEK3,2011-12-31,2012-02-15,14518,16967,31485
3056,ELEK3,2012-03-31,2012-04-24,14518,16967,31485
3057,ELEK3,2012-06-30,2012-08-07,14518,16967,31485
3058,ELEK3,2012-09-30,2012-10-24,14518,16967,31485
3059,ELEK3,2012-12-31,2013-02-08,14518,16967,31485
3060,ELEK3,2013-03-31,2013-04-24,14518,16967,31485
3061,ELEK3,2013-06-30,2013-07-22,14518,16967,31485
3062,ELEK3,2013-09-30,2013-10-30,14518,16967,31485
3063,ELEK3,2013-12-31,2014-02-11,14518,16967,31485
3064,ELEK3,2014-03-31,2014-04-30,14518,16967,31485
3065,ELEK3,2014-06-30,2014-07-31,14518,16967,31485
3066,ELEK3,2014-09-30,2014-10-23,14518,16967,31485
3067,ELEK3,2014-12-31,2015-02-06,14518,16967,31485
3068,ELEK3,2015-03-31,2015-04-29,14518,16967,31485
3069,ELEK3,2015-06-30,2015-08-03,14518,16967,31485
3070,ELEK3,2015-09-30,2015-10-28,14518,16967,31485
3071,ELEK3,2015-12-31,2016-02-04,14518,16967,31485
3072,ELEK3,2016-03-31,2016-04-26,14518,16967,31485
3073,ELEK3,2016-06-30,2016-07-27,14518,16967,31485
3074,ELEK3,2016-09-30,2016-10-24,14518,16967,31485
3075,ELEK3,2016-12-31,2017-02-01,14518,16967,31485
3076,ELEK3,2017-03-31,2017-05-03,14518,16967,31485
3077,ELEK3,2017-06-30,2017-08-10,14518,16967,31485
3078,ELEK3,2017-09-30,2017-10-24,14518,16967,31485
3079,ELEK3,2017-12-31,2018-02-07,14518,16967,31485
3080,ELEK3,2018-03-31,2018-04-27,14518,16967,31485
3081,ELEK3,2018-06-30,2018-08-07,14518,16967,31485
3082,ELEK3,2018-09-30,2018-10-22,14518,16967,31485
3083,ELEK3,2018-12-31,2019-01-30,14518,16967,31485
3084,ELEK3,2019-03-31,2019-04-30,14518,16967,31485
3085,ELEK3,2019-06-30,2019-07-31,14518,16967,31485
3086,ELEK3,2019-09-30,2019-11-06,14518,16967,31485
3087,ELEK3,2019-12-31,2020-02-03,14518,16967,31485
3088,ELEK3,2020-03-31,2020-05-28,14518,16967,31485
3089,ELEK4,2010-12-31,2011-02-23,14518,16967,31485
3090,ELEK4,2011-03-31,2011-05-04,14518,16967,31485
3091,ELEK4,2011-06-30,2011-08-03,14518,16967,31485
3092,ELEK4,2011-09-30,2011-11-03,14518,16967,31485
3093,ELEK4,2011-12-31,2012-02-15,14518,16967,31485
3094,ELEK4,2012-03-31,2012-04-24,14518,16967,31485
3095,ELEK4,2012-06-30,2012-08-07,14518,16967,31485
3096,ELEK4,2012-09-30,2012-10-24,14518,16967,31485
3097,ELEK4,2012-12-31,2013-02-08,14518,16967,31485
3098,ELEK4,2013-03-31,2013-04-24,14518,16967,31485
3099,ELEK4,2013-06-30,2013-07-22,14518,16967,31485
3100,ELEK4,2013-09-30,2013-10-30,14518,16967,31485
3101,ELEK4,2013-12-31,2014-02-11,14518,16967,31485
3102,ELEK4,2014-03-31,2014-04-30,14518,16967,31485
3103,ELEK4,2014-06-30,2014-07-31,14518,16967,31485
3104,ELEK4,2014-09-30,2014-10-23,14518,16967,31485
3105,ELEK4,2014-12-31,2015-02-06,14518,16967,31485
3106,ELEK4,2015-03-31,2015-04-29,14518,16967,31485
3107,ELEK4,2015-06-30,2015-08-03,14518,16967,31485
3108,ELEK4,2015-09-30,2015-10-28,14518,16967,31485
3109,ELEK4,2015-12-31,2016-02-04,14518,16967,31485
3110,ELEK4,2016-03-31,2016-04-26,14518,16967,31485
3111,ELEK4,2016-06-30,2016-07-27,14518,16967,31485
3112,ELEK4,2016-09-30,2016-10-24,14518,16967,31485
3113,ELEK4,2016-12-31,2017-02-01,14518,16967,31485
3114,ELEK4,2017-03-31,2017-05-03,14518,16967,31485
3115,ELEK4,2017-06-30,2017-08-10,14518,16967,31485
3116,ELEK4,2017-09-30,2017-10-24,14518,16967,31485
3117,ELEK4,2017-12-31,2018-02-07,14518,16967,31485
3118,ELEK4,2018-03-31,2018-04-27,14518,16967,31485
3119,ELEK4,2018-06-30,2018-08-07,14518,16967,31485
3120,ELEK4,2018-09-30,2018-10-22,14518,16967,31485
3121,ELEK4,2018-12-31,2019-01-30,14518,16967,31485
3122,ELEK4,2019-03-31,2019-04-30,14518,16967,31485
3123,ELEK4,2019-06-30,2019-07-31,14518,16967,31485
3124,ELEK4,2019-09-30,2019-11-06,14518,16967,31485
3125,ELEK4,2019-12-31,2020-02-03,14518,16967,31485
3126,ELEK4,2020-03-31,2020-05-28,14518,16967,31485
3127,CGRA3,2010-12-31,2011-08-26,8759925,12913750,21673675
3128,CGRA3,2011-03-31,2011-08-26,8759925,12913750,21673675
3129,CGRA3,2011-06-30,2011-08-26,8759925,12949533,21709458
3130,CGRA3,2011-09-30,2011-11-07,8759925,12949533,21709458
3131,CGRA3,2011-12-31,2012-03-12,8759925,12949533,21709458
3132,CGRA3,2012-03-31,2012-05-09,8759925,12949533,21709458
3133,CGRA3,2012-06-30,2012-08-13,8759925,13008320,21768245
3134,CGRA3,2012-09-30,2012-11-08,8759925,13008320,21768245
3135,CGRA3,2012-12-31,2013-03-07,8759925,13008320,21768245
3136,CGRA3,2013-03-31,2013-04-30,8759925,13008320,21768245
3137,CGRA3,2013-06-30,2013-07-31,8759925,13056020,21815945
3138,CGRA3,2013-09-30,2013-10-31,8759925,13056020,21815945
3139,CGRA3,2013-12-31,2014-02-27,8759925,13056020,21815945
3140,CGRA3,2014-03-31,2014-05-12,8759925,13056020,21815945
3141,CGRA3,2014-06-30,2014-08-04,8759925,13108445,21868370
3142,CGRA3,2014-09-30,2014-11-10,8759925,13108445,21868370
3143,CGRA3,2014-12-31,2015-03-06,8759925,13108445,21868370
3144,CGRA3,2015-03-31,2015-05-11,8759925,13108445,21868370
3145,CGRA3,2015-06-30,2015-08-07,8759925,13164095,21924020
3146,CGRA3,2015-09-30,2015-11-10,8759925,13164095,21924020
3147,CGRA3,2015-12-31,2016-02-26,8759925,13164095,21924020
3148,CGRA3,2016-03-31,2016-04-29,8759925,13164095,21924020
3149,CGRA3,2016-06-30,2016-07-29,8759925,13278949,22038874
3150,CGRA3,2016-09-30,2016-11-11,8759925,13278949,22038874
3151,CGRA3,2016-12-31,2017-02-24,8759925,13278949,22038874
3152,CGRA3,2017-03-31,2017-04-28,8759925,13278949,22038874
3153,CGRA3,2017-06-30,2017-07-28,8459925,12455405,20915330
3154,CGRA3,2017-09-30,2017-10-27,8459925,12455405,20915330
3155,CGRA3,2017-12-31,2018-02-16,8459925,12455405,20915330
3156,CGRA3,2018-03-31,2018-04-27,8459925,12455405,20915330
3157,CGRA3,2018-06-30,2018-07-27,8196525,12016981,20213506
3158,CGRA3,2018-09-30,2018-10-30,8196525,12016981,20213506
3159,CGRA3,2018-12-31,2019-03-18,8196525,12016981,20213506
3160,CGRA3,2019-03-31,2019-05-02,8196525,12016981,20213506
3161,CGRA3,2019-06-30,2019-08-02,8174413,11926570,20100983
3162,CGRA3,2019-09-30,2019-11-06,8174413,11926570,20100983
3163,CGRA3,2019-12-31,2020-03-16,8174413,11926570,20100983
3164,CGRA3,2020-03-31,2020-07-09,8174413,11926570,20100983
3165,CGRA3,2020-06-30,2020-08-17,8174413,11926570,20100983
3166,CGRA3,2020-09-30,2020-11-17,8174413,11973166,20147579
3167,CGRA4,2010-12-31,2011-08-26,8759925,12913750,21673675
3168,CGRA4,2011-03-31,2011-08-26,8759925,12913750,21673675
3169,CGRA4,2011-06-30,2011-08-26,8759925,12949533,21709458
3170,CGRA4,2011-09-30,2011-11-07,8759925,12949533,21709458
3171,CGRA4,2011-12-31,2012-03-12,8759925,12949533,21709458
3172,CGRA4,2012-03-31,2012-05-09,8759925,12949533,21709458
3173,CGRA4,2012-06-30,2012-08-13,8759925,13008320,21768245
3174,CGRA4,2012-09-30,2012-11-08,8759925,13008320,21768245
3175,CGRA4,2012-12-31,2013-03-07,8759925,13008320,21768245
3176,CGRA4,2013-03-31,2013-04-30,8759925,13008320,21768245
3177,CGRA4,2013-06-30,2013-07-31,8759925,13056020,21815945
3178,CGRA4,2013-09-30,2013-10-31,8759925,13056020,21815945
3179,CGRA4,2013-12-31,2014-02-27,8759925,13056020,21815945
3180,CGRA4,2014-03-31,2014-05-12,8759925,13056020,21815945
3181,CGRA4,2014-06-30,2014-08-04,8759925,13108445,21868370
3182,CGRA4,2014-09-30,2014-11-10,8759925,13108445,21868370
3183,CGRA4,2014-12-31,2015-03-06,8759925,13108445,21868370
3184,CGRA4,2015-03-31,2015-05-11,8759925,13108445,21868370
3185,CGRA4,2015-06-30,2015-08-07,8759925,13164095,21924020
3186,CGRA4,2015-09-30,2015-11-10,8759925,13164095,21924020
3187,CGRA4,2015-12-31,2016-02-26,8759925,13164095,21924020
3188,CGRA4,2016-03-31,2016-04-29,8759925,13164095,21924020
3189,CGRA4,2016-06-30,2016-07-29,8759925,13278949,22038874
3190,CGRA4,2016-09-30,2016-11-11,8759925,13278949,22038874
3191,CGRA4,2016-12-31,2017-02-24,8759925,13278949,22038874
3192,CGRA4,2017-03-31,2017-04-28,8759925,13278949,22038874
3193,CGRA4,2017-06-30,2017-07-28,8459925,12455405,20915330
3194,CGRA4,2017-09-30,2017-10-27,8459925,12455405,20915330
3195,CGRA4,2017-12-31,2018-02-16,8459925,12455405,20915330
3196,CGRA4,2018-03-31,2018-04-27,8459925,12455405,20915330
3197,CGRA4,2018-06-30,2018-07-27,8196525,12016981,20213506
3198,CGRA4,2018-09-30,2018-10-30,8196525,12016981,20213506
3199,CGRA4,2018-12-31,2019-03-18,8196525,12016981,20213506
3200,CGRA4,2019-03-31,2019-05-02,8196525,12016981,20213506
3201,CGRA4,2019-06-30,2019-08-02,8174413,11926570,20100983
3202,CGRA4,2019-09-30,2019-11-06,8174413,11926570,20100983
3203,CGRA4,2019-12-31,2020-03-16,8174413,11926570,20100983
3204,CGRA4,2020-03-31,2020-07-09,8174413,11926570,20100983
3205,CGRA4,2020-06-30,2020-08-17,8174413,11926570,20100983
3206,CGRA4,2020-09-30,2020-11-17,8174413,11973166,20147579
3207,GUAR3,2010-12-31,2011-03-30,31200000,31200000,62400000
3208,GUAR3,2011-03-31,2011-05-27,31200,31200,62400
3209,GUAR3,2011-06-30,2011-08-11,31200,31200,62400
3210,GUAR3,2011-09-30,2011-11-10,31200,31200,62400
3211,GUAR3,2011-12-31,2012-03-29,31200000,31200000,62400000
3212,GUAR3,2012-03-31,2012-05-25,31200,31200,62400
3213,GUAR3,2012-06-30,2012-08-13,31200,31200,62400
3214,GUAR3,2012-09-30,2012-11-13,31200,31200,62400
3215,GUAR3,2012-12-31,2013-03-13,31200000,31200000,62400000
3216,GUAR3,2013-03-31,2013-05-09,31200,31200,62400
3217,GUAR3,2013-06-30,2013-08-05,31200,31200,62400
3218,GUAR3,2013-09-30,2013-11-12,31200,31200,62400
3219,GUAR3,2013-12-31,2014-02-17,31200000,31200000,62400000
3220,GUAR3,2014-03-31,2014-04-28,31200,31200,62400
3221,GUAR3,2014-06-30,2014-08-07,31200,31200,62400
3222,GUAR3,2014-09-30,2014-11-10,31200,31200,62400
3223,GUAR3,2014-12-31,2015-03-02,31200000,31200000,62400000
3224,GUAR3,2015-03-31,2015-05-05,31200,31200,62400
3225,GUAR3,2015-06-30,2015-08-04,31200,31200,62400
3226,GUAR3,2015-09-30,2015-11-13,31200,31200,62400
3227,GUAR3,2015-12-31,2016-02-24,31200000,31200000,62400000
3228,GUAR3,2016-03-31,2016-05-13,31200,31200,62400
3229,GUAR3,2016-06-30,2016-08-09,31200,31200,62400
3230,GUAR3,2016-09-30,2016-11-07,31200,31200,62400
3231,GUAR3,2016-12-31,2017-03-15,31200000,31200000,62400000
3232,GUAR3,2017-03-31,2017-05-15,31200,31200,62400
3233,GUAR3,2017-06-30,2017-08-09,31200,31200,62400
3234,GUAR3,2017-09-30,2017-11-07,31200,31200,62400
3235,GUAR3,2017-12-31,2018-02-26,31200000,31200000,62400000
3236,GUAR3,2018-03-31,2018-05-08,31200,31200,62400
3237,GUAR3,2018-06-30,2018-08-09,31200,31200,62400
3238,GUAR3,2018-09-30,2018-11-07,31200,31200,62400
3239,GUAR3,2018-12-31,2019-03-26,31200000,31200000,62400000
3240,GUAR3,2019-03-31,2019-05-14,62400,0,62400
3241,GUAR3,2019-06-30,2019-08-06,499200,0,499200
3242,GUAR3,2019-09-30,2019-11-06,499200,0,499200
3243,GUAR3,2019-12-31,2020-02-17,499200,0,499200
3244,GUAR3,2020-03-31,2020-05-21,499200000,0,499200000
3245,GUAR3,2020-06-30,2020-08-10,499200000,0,499200000
3246,GUAR3,2020-09-30,2020-11-11,499200000,0,499200000
3247,GUAR3,2020-12-31,2021-03-15,499200000,0,499200000
3248,ODER3,2010-12-31,2011-05-12,9858,1429,11287
3249,ODER3,2011-03-31,2011-05-25,9858,1429,11287
3250,ODER3,2011-06-30,2011-08-12,9858,1429,11287
3251,ODER3,2011-09-30,2011-11-14,9858,1429,11287
3252,ODER3,2011-12-31,2012-03-27,9858,1429,11287
3253,ODER3,2012-03-31,2012-05-15,9858,1429,11287
3254,ODER3,2012-06-30,2012-08-10,9858,1429,11287
3255,ODER3,2012-09-30,2012-11-13,9858,1429,11287
3256,ODER3,2012-12-31,2013-03-25,9858,1429,11287
3257,ODER3,2013-03-31,2013-05-14,9858,1429,11287
3258,ODER3,2013-06-30,2013-08-14,9858,1429,11287
3259,ODER3,2013-09-30,2013-11-14,9858,1429,11287
3260,ODER3,2013-12-31,2014-03-25,9858,1429,11287
3261,ODER3,2014-03-31,2014-05-14,9858,1429,11287
3262,ODER3,2014-06-30,2014-08-12,9858,1429,11287
3263,ODER3,2014-09-30,2014-11-07,9858,1429,11287
3264,ODER3,2014-12-31,2015-03-27,9858,1429,11287
3265,ODER3,2015-03-31,2015-05-15,9858,1429,11287
3266,ODER3,2015-06-30,2015-08-14,9858,1429,11287
3267,ODER3,2015-09-30,2015-11-05,9858,1429,11287
3268,ODER3,2015-12-31,2016-03-24,9858,1429,11287
3269,ODER3,2016-03-31,2016-05-18,9859,1428,11287
3270,ODER3,2016-06-30,2016-08-12,9859,1428,11287
3271,ODER3,2016-09-30,2016-11-14,9859,1428,11287
3272,ODER3,2016-12-31,2017-03-28,9859,1428,11287
3273,ODER3,2017-03-31,2017-05-15,9859,1428,11287
3274,ODER3,2017-06-30,2017-08-15,9859,1428,11287
3275,ODER3,2017-09-30,2017-11-14,9859,1428,11287
3276,ODER3,2017-12-31,2018-03-27,9859,1428,11287
3277,ODER3,2018-03-31,2018-05-15,9859,1428,11287
3278,ODER3,2018-06-30,2018-08-14,9859,1428,11287
3279,ODER3,2018-09-30,2018-11-14,9859,1428,11287
3280,ODER3,2018-12-31,2019-03-29,9859,1428,11287
3281,ODER3,2019-03-31,2019-05-15,9859,1428,11287
3282,ODER3,2019-06-30,2019-08-14,9859,1428,11287
3283,ODER3,2019-09-30,2019-11-14,9859,1428,11287
3284,ODER3,2019-12-31,2020-03-27,9859,1428,11287
3285,ODER3,2020-03-31,2020-06-08,9859,1428,11287
3286,ODER3,2020-06-30,2020-09-08,9859,1428,11287
3287,ODER3,2020-09-30,2020-11-16,9859,1428,11287
3288,ODER3,2020-12-31,2021-03-26,9859,1428,11287
3289,ODER4,2010-12-31,2011-05-12,9858,1429,11287
3290,ODER4,2011-03-31,2011-05-25,9858,1429,11287
3291,ODER4,2011-06-30,2011-08-12,9858,1429,11287
3292,ODER4,2011-09-30,2011-11-14,9858,1429,11287
3293,ODER4,2011-12-31,2012-03-27,9858,1429,11287
3294,ODER4,2012-03-31,2012-05-15,9858,1429,11287
3295,ODER4,2012-06-30,2012-08-10,9858,1429,11287
3296,ODER4,2012-09-30,2012-11-13,9858,1429,11287
3297,ODER4,2012-12-31,2013-03-25,9858,1429,11287
3298,ODER4,2013-03-31,2013-05-14,9858,1429,11287
3299,ODER4,2013-06-30,2013-08-14,9858,1429,11287
3300,ODER4,2013-09-30,2013-11-14,9858,1429,11287
3301,ODER4,2013-12-31,2014-03-25,9858,1429,11287
3302,ODER4,2014-03-31,2014-05-14,9858,1429,11287
3303,ODER4,2014-06-30,2014-08-12,9858,1429,11287
3304,ODER4,2014-09-30,2014-11-07,9858,1429,11287
3305,ODER4,2014-12-31,2015-03-27,9858,1429,11287
3306,ODER4,2015-03-31,2015-05-15,9858,1429,11287
3307,ODER4,2015-06-30,2015-08-14,9858,1429,11287
3308,ODER4,2015-09-30,2015-11-05,9858,1429,11287
3309,ODER4,2015-12-31,2016-03-24,9858,1429,11287
3310,ODER4,2016-03-31,2016-05-18,9859,1428,11287
3311,ODER4,2016-06-30,2016-08-12,9859,1428,11287
3312,ODER4,2016-09-30,2016-11-14,9859,1428,11287
3313,ODER4,2016-12-31,2017-03-28,9859,1428,11287
3314,ODER4,2017-03-31,2017-05-15,9859,1428,11287
3315,ODER4,2017-06-30,2017-08-15,9859,1428,11287
3316,ODER4,2017-09-30,2017-11-14,9859,1428,11287
3317,ODER4,2017-12-31,2018-03-27,9859,1428,11287
3318,ODER4,2018-03-31,2018-05-15,9859,1428,11287
3319,ODER4,2018-06-30,2018-08-14,9859,1428,11287
3320,ODER4,2018-09-30,2018-11-14,9859,1428,11287
3321,ODER4,2018-12-31,2019-03-29,9859,1428,11287
3322,ODER4,2019-03-31,2019-05-15,9859,1428,11287
3323,ODER4,2019-06-30,2019-08-14,9859,1428,11287
3324,ODER4,2019-09-30,2019-11-14,9859,1428,11287
3325,ODER4,2019-12-31,2020-03-27,9859,1428,11287
3326,ODER4,2020-03-31,2020-06-08,9859,1428,11287
3327,ODER4,2020-06-30,2020-09-08,9859,1428,11287
3328,ODER4,2020-09-30,2020-11-16,9859,1428,11287
3329,ODER4,2020-12-31,2021-03-26,9859,1428,11287
3330,BRGE11,2010-12-31,2011-03-25,40394932,33251456,73646388
3331,BRGE11,2011-03-31,2011-05-16,40394932,33251456,73646388
3332,BRGE11,2011-06-30,2011-08-12,40394932,33251456,73646388
3333,BRGE11,2011-09-30,2011-11-11,40394932,33251456,73646388
3334,BRGE11,2011-12-31,2012-03-09,40394932,33251456,73646388
3335,BRGE11,2012-03-31,2012-05-14,40394932,33251456,73646388
3336,BRGE11,2012-06-30,2012-08-14,40394932,33251456,73646388
3337,BRGE11,2012-09-30,2012-11-14,40394932,33251456,73646388
3338,BRGE11,2012-12-31,2013-03-14,40394932,33251456,73646388
3339,BRGE11,2013-03-31,2013-05-16,40394932,33251456,73646388
3340,BRGE11,2013-06-30,2013-08-14,40394932,33251456,73646388
3341,BRGE11,2013-09-30,2013-11-14,40394932,33251456,73646388
3342,BRGE11,2013-12-31,2014-03-20,40394932,33251456,73646388
3343,BRGE11,2014-03-31,2014-05-14,40394932,33251456,73646388
3344,BRGE11,2014-06-30,2014-09-25,40394932,33251456,73646388
3345,BRGE11,2014-09-30,2014-11-14,40394932,33251456,73646388
3346,BRGE11,2014-12-31,2015-03-20,40394932,33251456,73646388
3347,BRGE11,2015-03-31,2015-05-14,40394932,33251456,73646388
3348,BRGE11,2015-06-30,2015-08-13,40394932,33251456,73646388
3349,BRGE11,2015-09-30,2015-11-12,40394932,33251456,73646388
3350,BRGE11,2015-12-31,2016-03-18,40394932,33251456,73646388
3351,BRGE11,2016-03-31,2016-05-13,40394932,33251456,73646388
3352,BRGE11,2016-06-30,2016-08-11,40394932,33251456,73646388
3353,BRGE11,2016-09-30,2016-11-10,40394932,33251456,73646388
3354,BRGE11,2016-12-31,2017-03-17,40394932,33251456,73646388
3355,BRGE11,2017-03-31,2017-05-12,40394932,33251456,73646388
3356,BRGE11,2017-06-30,2017-08-14,40394932,33251456,73646388
3357,BRGE11,2017-09-30,2017-11-10,40394932,33251456,73646388
3358,BRGE11,2017-12-31,2018-03-16,40394932,33251456,73646388
3359,BRGE11,2018-03-31,2018-05-14,40394932,33251456,73646388
3360,BRGE11,2018-06-30,2018-08-10,40394932,33251456,73646388
3361,BRGE11,2018-09-30,2018-11-09,40394932,33251456,73646388
3362,BRGE11,2018-12-31,2019-03-15,40394932,33251456,73646388
3363,BRGE11,2019-03-31,2019-05-10,40394932,33251456,73646388
3364,BRGE11,2019-06-30,2019-08-09,40394932,33251456,73646388
3365,BRGE11,2019-09-30,2019-11-08,40394932,33251456,73646388
3366,BRGE11,2019-12-31,2020-03-19,40394932,33251456,73646388
3367,BRGE11,2020-03-31,2020-05-12,40394932,33251456,73646388
3368,BRGE11,2020-06-30,2020-08-12,40394932,33251456,73646388
3369,BRGE11,2020-09-30,2020-11-11,40394932,33251456,73646388
3370,BRGE11,2020-12-31,2021-02-26,40394932,33251456,73646388
3371,BRGE12,2010-12-31,2011-03-25,40394932,33251456,73646388
3372,BRGE12,2011-03-31,2011-05-16,40394932,33251456,73646388
3373,BRGE12,2011-06-30,2011-08-12,40394932,33251456,73646388
3374,BRGE12,2011-09-30,2011-11-11,40394932,33251456,73646388
3375,BRGE12,2011-12-31,2012-03-09,40394932,33251456,73646388
3376,BRGE12,2012-03-31,2012-05-14,40394932,33251456,73646388
3377,BRGE12,2012-06-30,2012-08-14,40394932,33251456,73646388
3378,BRGE12,2012-09-30,2012-11-14,40394932,33251456,73646388
3379,BRGE12,2012-12-31,2013-03-14,40394932,33251456,73646388
3380,BRGE12,2013-03-31,2013-05-16,40394932,33251456,73646388
3381,BRGE12,2013-06-30,2013-08-14,40394932,33251456,73646388
3382,BRGE12,2013-09-30,2013-11-14,40394932,33251456,73646388
3383,BRGE12,2013-12-31,2014-03-20,40394932,33251456,73646388
3384,BRGE12,2014-03-31,2014-05-14,40394932,33251456,73646388
3385,BRGE12,2014-06-30,2014-09-25,40394932,33251456,73646388
3386,BRGE12,2014-09-30,2014-11-14,40394932,33251456,73646388
3387,BRGE12,2014-12-31,2015-03-20,40394932,33251456,73646388
3388,BRGE12,2015-03-31,2015-05-14,40394932,33251456,73646388
3389,BRGE12,2015-06-30,2015-08-13,40394932,33251456,73646388
3390,BRGE12,2015-09-30,2015-11-12,40394932,33251456,73646388
3391,BRGE12,2015-12-31,2016-03-18,40394932,33251456,73646388
3392,BRGE12,2016-03-31,2016-05-13,40394932,33251456,73646388
3393,BRGE12,2016-06-30,2016-08-11,40394932,33251456,73646388
3394,BRGE12,2016-09-30,2016-11-10,40394932,33251456,73646388
3395,BRGE12,2016-12-31,2017-03-17,40394932,33251456,73646388
3396,BRGE12,2017-03-31,2017-05-12,40394932,33251456,73646388
3397,BRGE12,2017-06-30,2017-08-14,40394932,33251456,73646388
3398,BRGE12,2017-09-30,2017-11-10,40394932,33251456,73646388
3399,BRGE12,2017-12-31,2018-03-16,40394932,33251456,73646388
3400,BRGE12,2018-03-31,2018-05-14,40394932,33251456,73646388
3401,BRGE12,2018-06-30,2018-08-10,40394932,33251456,73646388
3402,BRGE12,2018-09-30,2018-11-09,40394932,33251456,73646388
3403,BRGE12,2018-12-31,2019-03-15,40394932,33251456,73646388
3404,BRGE12,2019-03-31,2019-05-10,40394932,33251456,73646388
3405,BRGE12,2019-06-30,2019-08-09,40394932,33251456,73646388
3406,BRGE12,2019-09-30,2019-11-08,40394932,33251456,73646388
3407,BRGE12,2019-12-31,2020-03-19,40394932,33251456,73646388
3408,BRGE12,2020-03-31,2020-05-12,40394932,33251456,73646388
3409,BRGE12,2020-06-30,2020-08-12,40394932,33251456,73646388
3410,BRGE12,2020-09-30,2020-11-11,40394932,33251456,73646388
3411,BRGE12,2020-12-31,2021-02-26,40394932,33251456,73646388
3412,BRGE3,2010-12-31,2011-03-25,40394932,33251456,73646388
3413,BRGE3,2011-03-31,2011-05-16,40394932,33251456,73646388
3414,BRGE3,2011-06-30,2011-08-12,40394932,33251456,73646388
3415,BRGE3,2011-09-30,2011-11-11,40394932,33251456,73646388
3416,BRGE3,2011-12-31,2012-03-09,40394932,33251456,73646388
3417,BRGE3,2012-03-31,2012-05-14,40394932,33251456,73646388
3418,BRGE3,2012-06-30,2012-08-14,40394932,33251456,73646388
3419,BRGE3,2012-09-30,2012-11-14,40394932,33251456,73646388
3420,BRGE3,2012-12-31,2013-03-14,40394932,33251456,73646388
3421,BRGE3,2013-03-31,2013-05-16,40394932,33251456,73646388
3422,BRGE3,2013-06-30,2013-08-14,40394932,33251456,73646388
3423,BRGE3,2013-09-30,2013-11-14,40394932,33251456,73646388
3424,BRGE3,2013-12-31,2014-03-20,40394932,33251456,73646388
3425,BRGE3,2014-03-31,2014-05-14,40394932,33251456,73646388
3426,BRGE3,2014-06-30,2014-09-25,40394932,33251456,73646388
3427,BRGE3,2014-09-30,2014-11-14,40394932,33251456,73646388
3428,BRGE3,2014-12-31,2015-03-20,40394932,33251456,73646388
3429,BRGE3,2015-03-31,2015-05-14,40394932,33251456,73646388
3430,BRGE3,2015-06-30,2015-08-13,40394932,33251456,73646388
3431,BRGE3,2015-09-30,2015-11-12,40394932,33251456,73646388
3432,BRGE3,2015-12-31,2016-03-18,40394932,33251456,73646388
3433,BRGE3,2016-03-31,2016-05-13,40394932,33251456,73646388
3434,BRGE3,2016-06-30,2016-08-11,40394932,33251456,73646388
3435,BRGE3,2016-09-30,2016-11-10,40394932,33251456,73646388
3436,BRGE3,2016-12-31,2017-03-17,40394932,33251456,73646388
3437,BRGE3,2017-03-31,2017-05-12,40394932,33251456,73646388
3438,BRGE3,2017-06-30,2017-08-14,40394932,33251456,73646388
3439,BRGE3,2017-09-30,2017-11-10,40394932,33251456,73646388
3440,BRGE3,2017-12-31,2018-03-16,40394932,33251456,73646388
3441,BRGE3,2018-03-31,2018-05-14,40394932,33251456,73646388
3442,BRGE3,2018-06-30,2018-08-10,40394932,33251456,73646388
3443,BRGE3,2018-09-30,2018-11-09,40394932,33251456,73646388
3444,BRGE3,2018-12-31,2019-03-15,40394932,33251456,73646388
3445,BRGE3,2019-03-31,2019-05-10,40394932,33251456,73646388
3446,BRGE3,2019-06-30,2019-08-09,40394932,33251456,73646388
3447,BRGE3,2019-09-30,2019-11-08,40394932,33251456,73646388
3448,BRGE3,2019-12-31,2020-03-19,40394932,33251456,73646388
3449,BRGE3,2020-03-31,2020-05-12,40394932,33251456,73646388
3450,BRGE3,2020-06-30,2020-08-12,40394932,33251456,73646388
3451,BRGE3,2020-09-30,2020-11-11,40394932,33251456,73646388
3452,BRGE3,2020-12-31,2021-02-26,40394932,33251456,73646388
3453,BRGE5,2010-12-31,2011-03-25,40394932,33251456,73646388
3454,BRGE5,2011-03-31,2011-05-16,40394932,33251456,73646388
3455,BRGE5,2011-06-30,2011-08-12,40394932,33251456,73646388
3456,BRGE5,2011-09-30,2011-11-11,40394932,33251456,73646388
3457,BRGE5,2011-12-31,2012-03-09,40394932,33251456,73646388
3458,BRGE5,2012-03-31,2012-05-14,40394932,33251456,73646388
3459,BRGE5,2012-06-30,2012-08-14,40394932,33251456,73646388
3460,BRGE5,2012-09-30,2012-11-14,40394932,33251456,73646388
3461,BRGE5,2012-12-31,2013-03-14,40394932,33251456,73646388
3462,BRGE5,2013-03-31,2013-05-16,40394932,33251456,73646388
3463,BRGE5,2013-06-30,2013-08-14,40394932,33251456,73646388
3464,BRGE5,2013-09-30,2013-11-14,40394932,33251456,73646388
3465,BRGE5,2013-12-31,2014-03-20,40394932,33251456,73646388
3466,BRGE5,2014-03-31,2014-05-14,40394932,33251456,73646388
3467,BRGE5,2014-06-30,2014-09-25,40394932,33251456,73646388
3468,BRGE5,2014-09-30,2014-11-14,40394932,33251456,73646388
3469,BRGE5,2014-12-31,2015-03-20,40394932,33251456,73646388
3470,BRGE5,2015-03-31,2015-05-14,40394932,33251456,73646388
3471,BRGE5,2015-06-30,2015-08-13,40394932,33251456,73646388
3472,BRGE5,2015-09-30,2015-11-12,40394932,33251456,73646388
3473,BRGE5,2015-12-31,2016-03-18,40394932,33251456,73646388
3474,BRGE5,2016-03-31,2016-05-13,40394932,33251456,73646388
3475,BRGE5,2016-06-30,2016-08-11,40394932,33251456,73646388
3476,BRGE5,2016-09-30,2016-11-10,40394932,33251456,73646388
3477,BRGE5,2016-12-31,2017-03-17,40394932,33251456,73646388
3478,BRGE5,2017-03-31,2017-05-12,40394932,33251456,73646388
3479,BRGE5,2017-06-30,2017-08-14,40394932,33251456,73646388
3480,BRGE5,2017-09-30,2017-11-10,40394932,33251456,73646388
3481,BRGE5,2017-12-31,2018-03-16,40394932,33251456,73646388
3482,BRGE5,2018-03-31,2018-05-14,40394932,33251456,73646388
3483,BRGE5,2018-06-30,2018-08-10,40394932,33251456,73646388
3484,BRGE5,2018-09-30,2018-11-09,40394932,33251456,73646388
3485,BRGE5,2018-12-31,2019-03-15,40394932,33251456,73646388
3486,BRGE5,2019-03-31,2019-05-10,40394932,33251456,73646388
3487,BRGE5,2019-06-30,2019-08-09,40394932,33251456,73646388
3488,BRGE5,2019-09-30,2019-11-08,40394932,33251456,73646388
3489,BRGE5,2019-12-31,2020-03-19,40394932,33251456,73646388
3490,BRGE5,2020-03-31,2020-05-12,40394932,33251456,73646388
3491,BRGE5,2020-06-30,2020-08-12,40394932,33251456,73646388
3492,BRGE5,2020-09-30,2020-11-11,40394932,33251456,73646388
3493,BRGE5,2020-12-31,2021-02-26,40394932,33251456,73646388
3494,BRGE6,2010-12-31,2011-03-25,40394932,33251456,73646388
3495,BRGE6,2011-03-31,2011-05-16,40394932,33251456,73646388
3496,BRGE6,2011-06-30,2011-08-12,40394932,33251456,73646388
3497,BRGE6,2011-09-30,2011-11-11,40394932,33251456,73646388
3498,BRGE6,2011-12-31,2012-03-09,40394932,33251456,73646388
3499,BRGE6,2012-03-31,2012-05-14,40394932,33251456,73646388
3500,BRGE6,2012-06-30,2012-08-14,40394932,33251456,73646388
3501,BRGE6,2012-09-30,2012-11-14,40394932,33251456,73646388
3502,BRGE6,2012-12-31,2013-03-14,40394932,33251456,73646388
3503,BRGE6,2013-03-31,2013-05-16,40394932,33251456,73646388
3504,BRGE6,2013-06-30,2013-08-14,40394932,33251456,73646388
3505,BRGE6,2013-09-30,2013-11-14,40394932,33251456,73646388
3506,BRGE6,2013-12-31,2014-03-20,40394932,33251456,73646388
3507,BRGE6,2014-03-31,2014-05-14,40394932,33251456,73646388
3508,BRGE6,2014-06-30,2014-09-25,40394932,33251456,73646388
3509,BRGE6,2014-09-30,2014-11-14,40394932,33251456,73646388
3510,BRGE6,2014-12-31,2015-03-20,40394932,33251456,73646388
3511,BRGE6,2015-03-31,2015-05-14,40394932,33251456,73646388
3512,BRGE6,2015-06-30,2015-08-13,40394932,33251456,73646388
3513,BRGE6,2015-09-30,2015-11-12,40394932,33251456,73646388
3514,BRGE6,2015-12-31,2016-03-18,40394932,33251456,73646388
3515,BRGE6,2016-03-31,2016-05-13,40394932,33251456,73646388
3516,BRGE6,2016-06-30,2016-08-11,40394932,33251456,73646388
3517,BRGE6,2016-09-30,2016-11-10,40394932,33251456,73646388
3518,BRGE6,2016-12-31,2017-03-17,40394932,33251456,73646388
3519,BRGE6,2017-03-31,2017-05-12,40394932,33251456,73646388
3520,BRGE6,2017-06-30,2017-08-14,40394932,33251456,73646388
3521,BRGE6,2017-09-30,2017-11-10,40394932,33251456,73646388
3522,BRGE6,2017-12-31,2018-03-16,40394932,33251456,73646388
3523,BRGE6,2018-03-31,2018-05-14,40394932,33251456,73646388
3524,BRGE6,2018-06-30,2018-08-10,40394932,33251456,73646388
3525,BRGE6,2018-09-30,2018-11-09,40394932,33251456,73646388
3526,BRGE6,2018-12-31,2019-03-15,40394932,33251456,73646388
3527,BRGE6,2019-03-31,2019-05-10,40394932,33251456,73646388
3528,BRGE6,2019-06-30,2019-08-09,40394932,33251456,73646388
3529,BRGE6,2019-09-30,2019-11-08,40394932,33251456,73646388
3530,BRGE6,2019-12-31,2020-03-19,40394932,33251456,73646388
3531,BRGE6,2020-03-31,2020-05-12,40394932,33251456,73646388
3532,BRGE6,2020-06-30,2020-08-12,40394932,33251456,73646388
3533,BRGE6,2020-09-30,2020-11-11,40394932,33251456,73646388
3534,BRGE6,2020-12-31,2021-02-26,40394932,33251456,73646388
3535,BRGE7,2010-12-31,2011-03-25,40394932,33251456,73646388
3536,BRGE7,2011-03-31,2011-05-16,40394932,33251456,73646388
3537,BRGE7,2011-06-30,2011-08-12,40394932,33251456,73646388
3538,BRGE7,2011-09-30,2011-11-11,40394932,33251456,73646388
3539,BRGE7,2011-12-31,2012-03-09,40394932,33251456,73646388
3540,BRGE7,2012-03-31,2012-05-14,40394932,33251456,73646388
3541,BRGE7,2012-06-30,2012-08-14,40394932,33251456,73646388
3542,BRGE7,2012-09-30,2012-11-14,40394932,33251456,73646388
3543,BRGE7,2012-12-31,2013-03-14,40394932,33251456,73646388
3544,BRGE7,2013-03-31,2013-05-16,40394932,33251456,73646388
3545,BRGE7,2013-06-30,2013-08-14,40394932,33251456,73646388
3546,BRGE7,2013-09-30,2013-11-14,40394932,33251456,73646388
3547,BRGE7,2013-12-31,2014-03-20,40394932,33251456,73646388
3548,BRGE7,2014-03-31,2014-05-14,40394932,33251456,73646388
3549,BRGE7,2014-06-30,2014-09-25,40394932,33251456,73646388
3550,BRGE7,2014-09-30,2014-11-14,40394932,33251456,73646388
3551,BRGE7,2014-12-31,2015-03-20,40394932,33251456,73646388
3552,BRGE7,2015-03-31,2015-05-14,40394932,33251456,73646388
3553,BRGE7,2015-06-30,2015-08-13,40394932,33251456,73646388
3554,BRGE7,2015-09-30,2015-11-12,40394932,33251456,73646388
3555,BRGE7,2015-12-31,2016-03-18,40394932,33251456,73646388
3556,BRGE7,2016-03-31,2016-05-13,40394932,33251456,73646388
3557,BRGE7,2016-06-30,2016-08-11,40394932,33251456,73646388
3558,BRGE7,2016-09-30,2016-11-10,40394932,33251456,73646388
3559,BRGE7,2016-12-31,2017-03-17,40394932,33251456,73646388
3560,BRGE7,2017-03-31,2017-05-12,40394932,33251456,73646388
3561,BRGE7,2017-06-30,2017-08-14,40394932,33251456,73646388
3562,BRGE7,2017-09-30,2017-11-10,40394932,33251456,73646388
3563,BRGE7,2017-12-31,2018-03-16,40394932,33251456,73646388
3564,BRGE7,2018-03-31,2018-05-14,40394932,33251456,73646388
3565,BRGE7,2018-06-30,2018-08-10,40394932,33251456,73646388
3566,BRGE7,2018-09-30,2018-11-09,40394932,33251456,73646388
3567,BRGE7,2018-12-31,2019-03-15,40394932,33251456,73646388
3568,BRGE7,2019-03-31,2019-05-10,40394932,33251456,73646388
3569,BRGE7,2019-06-30,2019-08-09,40394932,33251456,73646388
3570,BRGE7,2019-09-30,2019-11-08,40394932,33251456,73646388
3571,BRGE7,2019-12-31,2020-03-19,40394932,33251456,73646388
3572,BRGE7,2020-03-31,2020-05-12,40394932,33251456,73646388
3573,BRGE7,2020-06-30,2020-08-12,40394932,33251456,73646388
3574,BRGE7,2020-09-30,2020-11-11,40394932,33251456,73646388
3575,BRGE7,2020-12-31,2021-02-26,40394932,33251456,73646388
3576,BRGE8,2010-12-31,2011-03-25,40394932,33251456,73646388
3577,BRGE8,2011-03-31,2011-05-16,40394932,33251456,73646388
3578,BRGE8,2011-06-30,2011-08-12,40394932,33251456,73646388
3579,BRGE8,2011-09-30,2011-11-11,40394932,33251456,73646388
3580,BRGE8,2011-12-31,2012-03-09,40394932,33251456,73646388
3581,BRGE8,2012-03-31,2012-05-14,40394932,33251456,73646388
3582,BRGE8,2012-06-30,2012-08-14,40394932,33251456,73646388
3583,BRGE8,2012-09-30,2012-11-14,40394932,33251456,73646388
3584,BRGE8,2012-12-31,2013-03-14,40394932,33251456,73646388
3585,BRGE8,2013-03-31,2013-05-16,40394932,33251456,73646388
3586,BRGE8,2013-06-30,2013-08-14,40394932,33251456,73646388
3587,BRGE8,2013-09-30,2013-11-14,40394932,33251456,73646388
3588,BRGE8,2013-12-31,2014-03-20,40394932,33251456,73646388
3589,BRGE8,2014-03-31,2014-05-14,40394932,33251456,73646388
3590,BRGE8,2014-06-30,2014-09-25,40394932,33251456,73646388
3591,BRGE8,2014-09-30,2014-11-14,40394932,33251456,73646388
3592,BRGE8,2014-12-31,2015-03-20,40394932,33251456,73646388
3593,BRGE8,2015-03-31,2015-05-14,40394932,33251456,73646388
3594,BRGE8,2015-06-30,2015-08-13,40394932,33251456,73646388
3595,BRGE8,2015-09-30,2015-11-12,40394932,33251456,73646388
3596,BRGE8,2015-12-31,2016-03-18,40394932,33251456,73646388
3597,BRGE8,2016-03-31,2016-05-13,40394932,33251456,73646388
3598,BRGE8,2016-06-30,2016-08-11,40394932,33251456,73646388
3599,BRGE8,2016-09-30,2016-11-10,40394932,33251456,73646388
3600,BRGE8,2016-12-31,2017-03-17,40394932,33251456,73646388
3601,BRGE8,2017-03-31,2017-05-12,40394932,33251456,73646388
3602,BRGE8,2017-06-30,2017-08-14,40394932,33251456,73646388
3603,BRGE8,2017-09-30,2017-11-10,40394932,33251456,73646388
3604,BRGE8,2017-12-31,2018-03-16,40394932,33251456,73646388
3605,BRGE8,2018-03-31,2018-05-14,40394932,33251456,73646388
3606,BRGE8,2018-06-30,2018-08-10,40394932,33251456,73646388
3607,BRGE8,2018-09-30,2018-11-09,40394932,33251456,73646388
3608,BRGE8,2018-12-31,2019-03-15,40394932,33251456,73646388
3609,BRGE8,2019-03-31,2019-05-10,40394932,33251456,73646388
3610,BRGE8,2019-06-30,2019-08-09,40394932,33251456,73646388
3611,BRGE8,2019-09-30,2019-11-08,40394932,33251456,73646388
3612,BRGE8,2019-12-31,2020-03-19,40394932,33251456,73646388
3613,BRGE8,2020-03-31,2020-05-12,40394932,33251456,73646388
3614,BRGE8,2020-06-30,2020-08-12,40394932,33251456,73646388
3615,BRGE8,2020-09-30,2020-11-11,40394932,33251456,73646388
3616,BRGE8,2020-12-31,2021-02-26,40394932,33251456,73646388
3617,CALI3,2010-12-31,2011-04-01,23,46,69
3618,CALI3,2011-03-31,2011-05-27,23000,46000,69000
3619,CALI3,2011-06-30,2011-08-15,23000,46000,69000
3620,CALI3,2011-09-30,2011-11-11,124040,248079,372119
3621,CALI3,2011-12-31,2014-03-28,124040,248079,372119
3622,CALI3,2012-03-31,2012-05-15,124040,248079,372119
3623,CALI3,2012-06-30,2012-08-14,124040,248079,372119
3624,CALI3,2012-09-30,2012-11-07,124040,248079,372119
3625,CALI3,2012-12-31,2014-03-28,124040,248079,372119
3626,CALI3,2013-03-31,2013-05-14,124040,248079,372119
3627,CALI3,2013-06-30,2013-08-07,124040,248079,372119
3628,CALI3,2013-09-30,2013-11-07,124040,248079,372119
3629,CALI3,2013-12-31,2015-03-26,124040,248079,372119
3630,CALI3,2014-03-31,2014-05-12,124040,248079,372119
3631,CALI3,2014-06-30,2014-08-05,124040,248079,372119
3632,CALI3,2014-09-30,2014-11-07,124040,248079,372119
3633,CALI3,2014-12-31,2015-02-27,124040,248079,372119
3634,CALI3,2015-03-31,2015-05-08,124040,248079,372119
3635,CALI3,2015-06-30,2015-08-07,124040,248079,372119
3636,CALI3,2015-09-30,2015-11-13,124040,248079,372119
3637,CALI3,2015-12-31,2016-02-19,124040,248079,372119
3638,CALI3,2016-03-31,2016-05-11,124040,248079,372119
3639,CALI3,2016-06-30,2016-08-10,124040,248079,372119
3640,CALI3,2016-09-30,2016-11-09,124040,248079,372119
3641,CALI3,2016-12-31,2017-02-20,124040,248079,372119
3642,CALI3,2017-03-31,2017-05-11,124040,248079,372119
3643,CALI3,2017-06-30,2017-08-14,124040,248079,372119
3644,CALI3,2017-09-30,2017-11-14,124040,248079,372119
3645,CALI3,2017-12-31,2018-03-16,124040,248079,372119
3646,CALI3,2018-03-31,2018-05-15,124040,248079,372119
3647,CALI3,2018-06-30,2018-08-13,124040,248079,372119
3648,CALI3,2018-09-30,2018-11-13,124040,248079,372119
3649,CALI3,2018-12-31,2019-03-18,124040,248079,372119
3650,CALI3,2019-03-31,2019-05-15,124040,248079,372119
3651,CALI3,2019-06-30,2019-08-13,124040,248079,372119
3652,CALI3,2019-09-30,2019-10-21,124040,248079,372119
3653,CALI3,2019-12-31,2020-03-19,124040,248079,372119
3654,CALI3,2020-03-31,2020-05-15,124040,248079,372119
3655,CALI3,2020-06-30,2020-08-19,124040,248079,372119
3656,CALI3,2020-09-30,2020-10-30,124040,248079,372119
3657,CALI3,2020-12-31,2021-02-19,124040,248079,372119
3658,CALI4,2010-12-31,2011-04-01,23,46,69
3659,CALI4,2011-03-31,2011-05-27,23000,46000,69000
3660,CALI4,2011-06-30,2011-08-15,23000,46000,69000
3661,CALI4,2011-09-30,2011-11-11,124040,248079,372119
3662,CALI4,2011-12-31,2014-03-28,124040,248079,372119
3663,CALI4,2012-03-31,2012-05-15,124040,248079,372119
3664,CALI4,2012-06-30,2012-08-14,124040,248079,372119
3665,CALI4,2012-09-30,2012-11-07,124040,248079,372119
3666,CALI4,2012-12-31,2014-03-28,124040,248079,372119
3667,CALI4,2013-03-31,2013-05-14,124040,248079,372119
3668,CALI4,2013-06-30,2013-08-07,124040,248079,372119
3669,CALI4,2013-09-30,2013-11-07,124040,248079,372119
3670,CALI4,2013-12-31,2015-03-26,124040,248079,372119
3671,CALI4,2014-03-31,2014-05-12,124040,248079,372119
3672,CALI4,2014-06-30,2014-08-05,124040,248079,372119
3673,CALI4,2014-09-30,2014-11-07,124040,248079,372119
3674,CALI4,2014-12-31,2015-02-27,124040,248079,372119
3675,CALI4,2015-03-31,2015-05-08,124040,248079,372119
3676,CALI4,2015-06-30,2015-08-07,124040,248079,372119
3677,CALI4,2015-09-30,2015-11-13,124040,248079,372119
3678,CALI4,2015-12-31,2016-02-19,124040,248079,372119
3679,CALI4,2016-03-31,2016-05-11,124040,248079,372119
3680,CALI4,2016-06-30,2016-08-10,124040,248079,372119
3681,CALI4,2016-09-30,2016-11-09,124040,248079,372119
3682,CALI4,2016-12-31,2017-02-20,124040,248079,372119
3683,CALI4,2017-03-31,2017-05-11,124040,248079,372119
3684,CALI4,2017-06-30,2017-08-14,124040,248079,372119
3685,CALI4,2017-09-30,2017-11-14,124040,248079,372119
3686,CALI4,2017-12-31,2018-03-16,124040,248079,372119
3687,CALI4,2018-03-31,2018-05-15,124040,248079,372119
3688,CALI4,2018-06-30,2018-08-13,124040,248079,372119
3689,CALI4,2018-09-30,2018-11-13,124040,248079,372119
3690,CALI4,2018-12-31,2019-03-18,124040,248079,372119
3691,CALI4,2019-03-31,2019-05-15,124040,248079,372119
3692,CALI4,2019-06-30,2019-08-13,124040,248079,372119
3693,CALI4,2019-09-30,2019-10-21,124040,248079,372119
3694,CALI4,2019-12-31,2020-03-19,124040,248079,372119
3695,CALI4,2020-03-31,2020-05-15,124040,248079,372119
3696,CALI4,2020-06-30,2020-08-19,124040,248079,372119
3697,CALI4,2020-09-30,2020-10-30,124040,248079,372119
3698,CALI4,2020-12-31,2021-02-19,124040,248079,372119
3699,MEND3,2010-12-31,2011-04-06,6977,3332,10309
3700,MEND3,2011-03-31,2011-06-06,6977,3332,10309
3701,MEND3,2011-06-30,2011-08-26,6977,3332,10309
3702,MEND3,2011-09-30,2011-12-23,6977,3332,10309
3703,MEND3,2011-12-31,2012-04-02,6977,3332,10309
3704,MEND3,2012-03-31,2012-05-16,6977,3332,10309
3705,MEND3,2012-06-30,2012-08-14,6977,3332,10309
3706,MEND3,2012-09-30,2012-11-14,6977,3332,10309
3707,MEND3,2012-12-31,2013-03-27,6977,3332,10309
3708,MEND3,2013-03-31,2013-05-15,6977,3332,10309
3709,MEND3,2013-06-30,2013-08-14,6977,3332,10309
3710,MEND3,2013-09-30,2013-11-14,6977,3332,10309
3711,MEND3,2013-12-31,2014-03-31,6977,3332,10309
3712,MEND3,2014-03-31,2014-05-14,6977,3332,10309
3713,MEND3,2014-06-30,2014-08-14,6977,3332,10309
3714,MEND3,2014-09-30,2014-11-18,6977,3332,10309
3715,MEND3,2014-12-31,2015-07-01,6977,3332,10309
3716,MEND3,2015-03-31,2015-11-26,6977,3332,10309
3717,MEND3,2015-06-30,2015-11-30,6977,3332,10309
3718,MEND3,2015-09-30,2016-02-05,6977,3332,10309
3719,MEND3,2015-12-31,2016-03-31,6977,3332,10309
3720,MEND3,2016-03-31,2016-05-13,6977,3332,10309
3721,MEND3,2016-06-30,2017-05-30,6977,3332,10309
3722,MEND3,2016-09-30,2016-11-17,6977,3332,10309
3723,MEND3,2016-12-31,2017-05-18,6977,3332,10309
3724,MEND3,2017-03-31,2017-06-02,6977,3332,10309
3725,MEND3,2017-06-30,2017-08-10,6977,3332,10309
3726,MEND3,2017-09-30,2017-11-13,6977,3332,10309
3727,MEND3,2017-12-31,2018-03-28,6977,3332,10309
3728,MEND3,2018-03-31,2018-05-14,6977,3332,10309
3729,MEND3,2018-06-30,2018-08-13,6977,3332,10309
3730,MEND3,2018-09-30,2018-11-14,6977,3332,10309
3731,MEND3,2018-12-31,2019-04-15,6977,3332,10309
3732,MEND3,2019-03-31,2019-05-15,6977,3332,10309
3733,MEND3,2019-06-30,2019-08-13,6977,3332,10309
3734,MEND3,2019-09-30,2019-11-12,6977,3332,10309
3735,MEND3,2019-12-31,2020-03-30,6977,3332,10309
3736,MEND3,2020-03-31,2020-06-26,6977,3332,10309
3737,MEND3,2020-06-30,2020-08-28,6977,3332,10309
3738,MEND3,2020-09-30,2020-12-15,6977,3332,10309
3739,MEND5,2010-12-31,2011-04-06,6977,3332,10309
3740,MEND5,2011-03-31,2011-06-06,6977,3332,10309
3741,MEND5,2011-06-30,2011-08-26,6977,3332,10309
3742,MEND5,2011-09-30,2011-12-23,6977,3332,10309
3743,MEND5,2011-12-31,2012-04-02,6977,3332,10309
3744,MEND5,2012-03-31,2012-05-16,6977,3332,10309
3745,MEND5,2012-06-30,2012-08-14,6977,3332,10309
3746,MEND5,2012-09-30,2012-11-14,6977,3332,10309
3747,MEND5,2012-12-31,2013-03-27,6977,3332,10309
3748,MEND5,2013-03-31,2013-05-15,6977,3332,10309
3749,MEND5,2013-06-30,2013-08-14,6977,3332,10309
3750,MEND5,2013-09-30,2013-11-14,6977,3332,10309
3751,MEND5,2013-12-31,2014-03-31,6977,3332,10309
3752,MEND5,2014-03-31,2014-05-14,6977,3332,10309
3753,MEND5,2014-06-30,2014-08-14,6977,3332,10309
3754,MEND5,2014-09-30,2014-11-18,6977,3332,10309
3755,MEND5,2014-12-31,2015-07-01,6977,3332,10309
3756,MEND5,2015-03-31,2015-11-26,6977,3332,10309
3757,MEND5,2015-06-30,2015-11-30,6977,3332,10309
3758,MEND5,2015-09-30,2016-02-05,6977,3332,10309
3759,MEND5,2015-12-31,2016-03-31,6977,3332,10309
3760,MEND5,2016-03-31,2016-05-13,6977,3332,10309
3761,MEND5,2016-06-30,2017-05-30,6977,3332,10309
3762,MEND5,2016-09-30,2016-11-17,6977,3332,10309
3763,MEND5,2016-12-31,2017-05-18,6977,3332,10309
3764,MEND5,2017-03-31,2017-06-02,6977,3332,10309
3765,MEND5,2017-06-30,2017-08-10,6977,3332,10309
3766,MEND5,2017-09-30,2017-11-13,6977,3332,10309
3767,MEND5,2017-12-31,2018-03-28,6977,3332,10309
3768,MEND5,2018-03-31,2018-05-14,6977,3332,10309
3769,MEND5,2018-06-30,2018-08-13,6977,3332,10309
3770,MEND5,2018-09-30,2018-11-14,6977,3332,10309
3771,MEND5,2018-12-31,2019-04-15,6977,3332,10309
3772,MEND5,2019-03-31,2019-05-15,6977,3332,10309
3773,MEND5,2019-06-30,2019-08-13,6977,3332,10309
3774,MEND5,2019-09-30,2019-11-12,6977,3332,10309
3775,MEND5,2019-12-31,2020-03-30,6977,3332,10309
3776,MEND5,2020-03-31,2020-06-26,6977,3332,10309
3777,MEND5,2020-06-30,2020-08-28,6977,3332,10309
3778,MEND5,2020-09-30,2020-12-15,6977,3332,10309
3779,MEND6,2010-12-31,2011-04-06,6977,3332,10309
3780,MEND6,2011-03-31,2011-06-06,6977,3332,10309
3781,MEND6,2011-06-30,2011-08-26,6977,3332,10309
3782,MEND6,2011-09-30,2011-12-23,6977,3332,10309
3783,MEND6,2011-12-31,2012-04-02,6977,3332,10309
3784,MEND6,2012-03-31,2012-05-16,6977,3332,10309
3785,MEND6,2012-06-30,2012-08-14,6977,3332,10309
3786,MEND6,2012-09-30,2012-11-14,6977,3332,10309
3787,MEND6,2012-12-31,2013-03-27,6977,3332,10309
3788,MEND6,2013-03-31,2013-05-15,6977,3332,10309
3789,MEND6,2013-06-30,2013-08-14,6977,3332,10309
3790,MEND6,2013-09-30,2013-11-14,6977,3332,10309
3791,MEND6,2013-12-31,2014-03-31,6977,3332,10309
3792,MEND6,2014-03-31,2014-05-14,6977,3332,10309
3793,MEND6,2014-06-30,2014-08-14,6977,3332,10309
3794,MEND6,2014-09-30,2014-11-18,6977,3332,10309
3795,MEND6,2014-12-31,2015-07-01,6977,3332,10309
3796,MEND6,2015-03-31,2015-11-26,6977,3332,10309
3797,MEND6,2015-06-30,2015-11-30,6977,3332,10309
3798,MEND6,2015-09-30,2016-02-05,6977,3332,10309
3799,MEND6,2015-12-31,2016-03-31,6977,3332,10309
3800,MEND6,2016-03-31,2016-05-13,6977,3332,10309
3801,MEND6,2016-06-30,2017-05-30,6977,3332,10309
3802,MEND6,2016-09-30,2016-11-17,6977,3332,10309
3803,MEND6,2016-12-31,2017-05-18,6977,3332,10309
3804,MEND6,2017-03-31,2017-06-02,6977,3332,10309
3805,MEND6,2017-06-30,2017-08-10,6977,3332,10309
3806,MEND6,2017-09-30,2017-11-13,6977,3332,10309
3807,MEND6,2017-12-31,2018-03-28,6977,3332,10309
3808,MEND6,2018-03-31,2018-05-14,6977,3332,10309
3809,MEND6,2018-06-30,2018-08-13,6977,3332,10309
3810,MEND6,2018-09-30,2018-11-14,6977,3332,10309
3811,MEND6,2018-12-31,2019-04-15,6977,3332,10309
3812,MEND6,2019-03-31,2019-05-15,6977,3332,10309
3813,MEND6,2019-06-30,2019-08-13,6977,3332,10309
3814,MEND6,2019-09-30,2019-11-12,6977,3332,10309
3815,MEND6,2019-12-31,2020-03-30,6977,3332,10309
3816,MEND6,2020-03-31,2020-06-26,6977,3332,10309
3817,MEND6,2020-06-30,2020-08-28,6977,3332,10309
3818,MEND6,2020-09-30,2020-12-15,6977,3332,10309
3819,BRKM3,2010-12-31,2011-03-17,451669,349996,801665
3820,BRKM3,2011-03-31,2011-06-13,451669063,349996554,801665617
3821,BRKM3,2011-06-30,2011-08-11,451669063,349996554,801665617
3822,BRKM3,2011-09-30,2011-11-10,451669063,349996554,801665617
3823,BRKM3,2011-12-31,2012-03-26,451669,349996,801665
3824,BRKM3,2012-03-31,2012-05-10,451669063,349996554,801665617
3825,BRKM3,2012-06-30,2012-08-14,451668652,347299538,798968190
3826,BRKM3,2012-09-30,2012-11-08,451668652,344441938,796110590
3827,BRKM3,2012-12-31,2013-02-07,451668652,345596696,797265348
3828,BRKM3,2013-03-31,2013-05-09,451668652,345596696,797265348
3829,BRKM3,2013-06-30,2013-08-08,451668652,345596696,797265348
3830,BRKM3,2013-09-30,2013-11-07,451668652,344441938,796110590
3831,BRKM3,2013-12-31,2014-03-17,451668652,345596696,797265348
3832,BRKM3,2014-03-31,2014-05-08,451668652,345596696,797265348
3833,BRKM3,2014-06-30,2014-08-07,451668652,345596696,797265348
3834,BRKM3,2014-09-30,2014-11-06,451668652,345596696,797265348
3835,BRKM3,2014-12-31,2015-02-12,451668652,345596696,797265348
3836,BRKM3,2015-03-31,2015-05-07,451668652,345596696,797265348
3837,BRKM3,2015-06-30,2015-08-06,451668652,345596696,797265348
3838,BRKM3,2015-09-30,2015-11-05,451668652,345596696,797265348
3839,BRKM3,2015-12-31,2016-02-18,451668652,345596596,797265248
3840,BRKM3,2016-03-31,2016-05-05,451668652,345596596,797265248
3841,BRKM3,2016-06-30,2016-08-04,451668652,345596596,797265248
3842,BRKM3,2016-09-30,2016-11-10,451668652,345588952,797257604
3843,BRKM3,2016-12-31,2017-08-15,451668652,345588952,797257604
3844,BRKM3,2017-03-31,2017-08-15,451668652,345588952,797257604
3845,BRKM3,2017-06-30,2017-08-15,451668652,345588952,797257604
3846,BRKM3,2017-09-30,2017-11-09,451668652,345588952,797257604
3847,BRKM3,2017-12-31,2018-03-29,451668652,345588952,797257604
3848,BRKM3,2018-03-31,2018-05-09,451668652,345549952,797218604
3849,BRKM3,2018-06-30,2018-08-08,451668652,345549902,797218554
3850,BRKM3,2018-09-30,2018-11-12,451668652,345549902,797218554
3851,BRKM3,2018-12-31,2019-03-13,451668652,345549902,797218554
3852,BRKM3,2019-03-31,2019-08-07,451668652,345549902,797218554
3853,BRKM3,2019-06-30,2019-10-22,451668652,345549902,797218554
3854,BRKM3,2019-09-30,2019-11-14,451668652,345549902,797218554
3855,BRKM3,2019-12-31,2020-04-03,451668652,345549902,797218554
3856,BRKM3,2020-03-31,2020-06-03,451668652,345549902,797218554
3857,BRKM3,2020-06-30,2020-08-05,451668652,345549902,797218554
3858,BRKM3,2020-09-30,2020-11-10,451668652,345549902,797218554
3859,BRKM3,2020-12-31,2021-03-10,451668652,345549902,797218554
3860,BRKM5,2010-12-31,2011-03-17,451669,349996,801665
3861,BRKM5,2011-03-31,2011-06-13,451669063,349996554,801665617
3862,BRKM5,2011-06-30,2011-08-11,451669063,349996554,801665617
3863,BRKM5,2011-09-30,2011-11-10,451669063,349996554,801665617
3864,BRKM5,2011-12-31,2012-03-26,451669,349996,801665
3865,BRKM5,2012-03-31,2012-05-10,451669063,349996554,801665617
3866,BRKM5,2012-06-30,2012-08-14,451668652,347299538,798968190
3867,BRKM5,2012-09-30,2012-11-08,451668652,344441938,796110590
3868,BRKM5,2012-12-31,2013-02-07,451668652,345596696,797265348
3869,BRKM5,2013-03-31,2013-05-09,451668652,345596696,797265348
3870,BRKM5,2013-06-30,2013-08-08,451668652,345596696,797265348
3871,BRKM5,2013-09-30,2013-11-07,451668652,344441938,796110590
3872,BRKM5,2013-12-31,2014-03-17,451668652,345596696,797265348
3873,BRKM5,2014-03-31,2014-05-08,451668652,345596696,797265348
3874,BRKM5,2014-06-30,2014-08-07,451668652,345596696,797265348
3875,BRKM5,2014-09-30,2014-11-06,451668652,345596696,797265348
3876,BRKM5,2014-12-31,2015-02-12,451668652,345596696,797265348
3877,BRKM5,2015-03-31,2015-05-07,451668652,345596696,797265348
3878,BRKM5,2015-06-30,2015-08-06,451668652,345596696,797265348
3879,BRKM5,2015-09-30,2015-11-05,451668652,345596696,797265348
3880,BRKM5,2015-12-31,2016-02-18,451668652,345596596,797265248
3881,BRKM5,2016-03-31,2016-05-05,451668652,345596596,797265248
3882,BRKM5,2016-06-30,2016-08-04,451668652,345596596,797265248
3883,BRKM5,2016-09-30,2016-11-10,451668652,345588952,797257604
3884,BRKM5,2016-12-31,2017-08-15,451668652,345588952,797257604
3885,BRKM5,2017-03-31,2017-08-15,451668652,345588952,797257604
3886,BRKM5,2017-06-30,2017-08-15,451668652,345588952,797257604
3887,BRKM5,2017-09-30,2017-11-09,451668652,345588952,797257604
3888,BRKM5,2017-12-31,2018-03-29,451668652,345588952,797257604
3889,BRKM5,2018-03-31,2018-05-09,451668652,345549952,797218604
3890,BRKM5,2018-06-30,2018-08-08,451668652,345549902,797218554
3891,BRKM5,2018-09-30,2018-11-12,451668652,345549902,797218554
3892,BRKM5,2018-12-31,2019-03-13,451668652,345549902,797218554
3893,BRKM5,2019-03-31,2019-08-07,451668652,345549902,797218554
3894,BRKM5,2019-06-30,2019-10-22,451668652,345549902,797218554
3895,BRKM5,2019-09-30,2019-11-14,451668652,345549902,797218554
3896,BRKM5,2019-12-31,2020-04-03,451668652,345549902,797218554
3897,BRKM5,2020-03-31,2020-06-03,451668652,345549902,797218554
3898,BRKM5,2020-06-30,2020-08-05,451668652,345549902,797218554
3899,BRKM5,2020-09-30,2020-11-10,451668652,345549902,797218554
3900,BRKM5,2020-12-31,2021-03-10,451668652,345549902,797218554
3901,BRKM6,2010-12-31,2011-03-17,451669,349996,801665
3902,BRKM6,2011-03-31,2011-06-13,451669063,349996554,801665617
3903,BRKM6,2011-06-30,2011-08-11,451669063,349996554,801665617
3904,BRKM6,2011-09-30,2011-11-10,451669063,349996554,801665617
3905,BRKM6,2011-12-31,2012-03-26,451669,349996,801665
3906,BRKM6,2012-03-31,2012-05-10,451669063,349996554,801665617
3907,BRKM6,2012-06-30,2012-08-14,451668652,347299538,798968190
3908,BRKM6,2012-09-30,2012-11-08,451668652,344441938,796110590
3909,BRKM6,2012-12-31,2013-02-07,451668652,345596696,797265348
3910,BRKM6,2013-03-31,2013-05-09,451668652,345596696,797265348
3911,BRKM6,2013-06-30,2013-08-08,451668652,345596696,797265348
3912,BRKM6,2013-09-30,2013-11-07,451668652,344441938,796110590
3913,BRKM6,2013-12-31,2014-03-17,451668652,345596696,797265348
3914,BRKM6,2014-03-31,2014-05-08,451668652,345596696,797265348
3915,BRKM6,2014-06-30,2014-08-07,451668652,345596696,797265348
3916,BRKM6,2014-09-30,2014-11-06,451668652,345596696,797265348
3917,BRKM6,2014-12-31,2015-02-12,451668652,345596696,797265348
3918,BRKM6,2015-03-31,2015-05-07,451668652,345596696,797265348
3919,BRKM6,2015-06-30,2015-08-06,451668652,345596696,797265348
3920,BRKM6,2015-09-30,2015-11-05,451668652,345596696,797265348
3921,BRKM6,2015-12-31,2016-02-18,451668652,345596596,797265248
3922,BRKM6,2016-03-31,2016-05-05,451668652,345596596,797265248
3923,BRKM6,2016-06-30,2016-08-04,451668652,345596596,797265248
3924,BRKM6,2016-09-30,2016-11-10,451668652,345588952,797257604
3925,BRKM6,2016-12-31,2017-08-15,451668652,345588952,797257604
3926,BRKM6,2017-03-31,2017-08-15,451668652,345588952,797257604
3927,BRKM6,2017-06-30,2017-08-15,451668652,345588952,797257604
3928,BRKM6,2017-09-30,2017-11-09,451668652,345588952,797257604
3929,BRKM6,2017-12-31,2018-03-29,451668652,345588952,797257604
3930,BRKM6,2018-03-31,2018-05-09,451668652,345549952,797218604
3931,BRKM6,2018-06-30,2018-08-08,451668652,345549902,797218554
3932,BRKM6,2018-09-30,2018-11-12,451668652,345549902,797218554
3933,BRKM6,2018-12-31,2019-03-13,451668652,345549902,797218554
3934,BRKM6,2019-03-31,2019-08-07,451668652,345549902,797218554
3935,BRKM6,2019-06-30,2019-10-22,451668652,345549902,797218554
3936,BRKM6,2019-09-30,2019-11-14,451668652,345549902,797218554
3937,BRKM6,2019-12-31,2020-04-03,451668652,345549902,797218554
3938,BRKM6,2020-03-31,2020-06-03,451668652,345549902,797218554
3939,BRKM6,2020-06-30,2020-08-05,451668652,345549902,797218554
3940,BRKM6,2020-09-30,2020-11-10,451668652,345549902,797218554
3941,BRKM6,2020-12-31,2021-03-10,451668652,345549902,797218554
3942,CORR3,2010-12-31,2011-04-01,7815,15338,23153
3943,CORR3,2011-03-31,2011-05-13,7815,15338,23153
3944,CORR3,2011-06-30,2011-08-15,7815,15338,23153
3945,CORR3,2011-09-30,2011-11-09,7815,15338,23153
3946,CORR3,2011-12-31,2012-03-13,7815,15338,23153
3947,CORR3,2012-03-31,2012-05-10,7815,15338,23153
3948,CORR3,2012-06-30,2012-08-21,7815,15338,23153
3949,CORR3,2012-09-30,2012-11-12,7815,15338,23153
3950,CORR3,2012-12-31,2013-03-26,7815,15338,23153
3951,CORR3,2013-03-31,2013-05-08,7815,15338,23153
3952,CORR3,2013-06-30,2013-08-09,7815,15338,23153
3953,CORR3,2013-09-30,2013-11-11,7815,15338,23153
3954,CORR3,2013-12-31,2014-03-27,7815,15338,23153
3955,CORR3,2014-03-30,2014-05-13,7815,15338,23153
3956,CORR3,2014-03-31,2014-05-15,7815,15338,23153
3957,CORR3,2014-06-30,2014-08-15,7815,15338,23153
3958,CORR3,2014-09-30,2014-11-07,7815,15338,23153
3959,CORR3,2014-12-31,2015-03-24,7815,15338,23153
3960,CORR3,2015-03-31,2015-05-13,7815,15338,23153
3961,CORR3,2015-06-30,2015-08-11,7815,15338,23153
3962,CORR3,2015-09-30,2015-11-10,7815,15338,23153
3963,CORR3,2015-12-31,2016-03-23,7815,15338,23153
3964,CORR3,2016-03-31,2016-05-11,7815,15338,23153
3965,CORR3,2016-06-30,2016-08-12,7815,15338,23153
3966,CORR3,2016-09-30,2016-11-14,7815,15338,23153
3967,CORR3,2016-12-31,2017-03-24,7815,15338,23153
3968,CORR3,2017-03-31,2017-05-11,7815,15338,23153
3969,CORR3,2017-06-30,2017-08-14,7815,15338,23153
3970,CORR3,2017-09-30,2017-11-10,7815,15338,23153
3971,CORR3,2017-12-31,2018-03-23,7815,15338,23153
3972,CORR3,2018-03-31,2018-05-15,7815,15338,23153
3973,CORR3,2018-06-30,2018-08-14,7815,15338,23153
3974,CORR3,2018-09-30,2018-11-14,7815,15338,23153
3975,CORR3,2018-12-31,2019-03-20,7815,15338,23153
3976,CORR3,2019-03-31,2019-05-16,8,15,23
3977,CORR3,2019-06-30,2019-08-16,7815,15338,23153
3978,CORR3,2019-09-30,2019-11-13,7815,15338,23153
3979,CORR3,2019-12-31,2020-03-30,7815,15338,23153
3980,CORR3,2020-03-31,2020-06-25,7815,15338,23153
3981,CORR3,2020-06-30,2020-08-24,7815,15338,23153
3982,CORR3,2020-09-30,2020-11-13,7815,15338,23153
3983,CORR3,2020-12-31,2021-03-16,7815,15338,23153
3984,CORR4,2010-12-31,2011-04-01,7815,15338,23153
3985,CORR4,2011-03-31,2011-05-13,7815,15338,23153
3986,CORR4,2011-06-30,2011-08-15,7815,15338,23153
3987,CORR4,2011-09-30,2011-11-09,7815,15338,23153
3988,CORR4,2011-12-31,2012-03-13,7815,15338,23153
3989,CORR4,2012-03-31,2012-05-10,7815,15338,23153
3990,CORR4,2012-06-30,2012-08-21,7815,15338,23153
3991,CORR4,2012-09-30,2012-11-12,7815,15338,23153
3992,CORR4,2012-12-31,2013-03-26,7815,15338,23153
3993,CORR4,2013-03-31,2013-05-08,7815,15338,23153
3994,CORR4,2013-06-30,2013-08-09,7815,15338,23153
3995,CORR4,2013-09-30,2013-11-11,7815,15338,23153
3996,CORR4,2013-12-31,2014-03-27,7815,15338,23153
3997,CORR4,2014-03-30,2014-05-13,7815,15338,23153
3998,CORR4,2014-03-31,2014-05-15,7815,15338,23153
3999,CORR4,2014-06-30,2014-08-15,7815,15338,23153
4000,CORR4,2014-09-30,2014-11-07,7815,15338,23153
4001,CORR4,2014-12-31,2015-03-24,7815,15338,23153
4002,CORR4,2015-03-31,2015-05-13,7815,15338,23153
4003,CORR4,2015-06-30,2015-08-11,7815,15338,23153
4004,CORR4,2015-09-30,2015-11-10,7815,15338,23153
4005,CORR4,2015-12-31,2016-03-23,7815,15338,23153
4006,CORR4,2016-03-31,2016-05-11,7815,15338,23153
4007,CORR4,2016-06-30,2016-08-12,7815,15338,23153
4008,CORR4,2016-09-30,2016-11-14,7815,15338,23153
4009,CORR4,2016-12-31,2017-03-24,7815,15338,23153
4010,CORR4,2017-03-31,2017-05-11,7815,15338,23153
4011,CORR4,2017-06-30,2017-08-14,7815,15338,23153
4012,CORR4,2017-09-30,2017-11-10,7815,15338,23153
4013,CORR4,2017-12-31,2018-03-23,7815,15338,23153
4014,CORR4,2018-03-31,2018-05-15,7815,15338,23153
4015,CORR4,2018-06-30,2018-08-14,7815,15338,23153
4016,CORR4,2018-09-30,2018-11-14,7815,15338,23153
4017,CORR4,2018-12-31,2019-03-20,7815,15338,23153
4018,CORR4,2019-03-31,2019-05-16,8,15,23
4019,CORR4,2019-06-30,2019-08-16,7815,15338,23153
4020,CORR4,2019-09-30,2019-11-13,7815,15338,23153
4021,CORR4,2019-12-31,2020-03-30,7815,15338,23153
4022,CORR4,2020-03-31,2020-06-25,7815,15338,23153
4023,CORR4,2020-06-30,2020-08-24,7815,15338,23153
4024,CORR4,2020-09-30,2020-11-13,7815,15338,23153
4025,CORR4,2020-12-31,2021-03-16,7815,15338,23153
4026,DOHL3,2010-12-31,2011-03-30,3631,1412,5043
4027,DOHL3,2011-03-31,2011-05-31,3631,1412,5043
4028,DOHL3,2011-06-30,2011-08-15,36312,14118,50430
4029,DOHL3,2011-09-30,2011-11-11,36312,14118,50430
4030,DOHL3,2011-12-31,2012-03-27,36311880,14118310,50430190
4031,DOHL3,2012-03-31,2012-05-15,36312,14118,50430
4032,DOHL3,2012-06-30,2012-08-14,36312,14118,50430
4033,DOHL3,2012-09-30,2012-11-13,36312,14118,50430
4034,DOHL3,2012-12-31,2013-03-25,36311880,14118310,50430190
4035,DOHL3,2013-03-31,2013-05-14,36311880,14118310,50430190
4036,DOHL3,2013-06-30,2013-08-13,36311880,14118310,50430190
4037,DOHL3,2013-09-30,2013-11-13,36311880,14118310,50430190
4038,DOHL3,2013-12-31,2014-03-24,36311880,14118310,50430190
4039,DOHL3,2014-03-31,2014-05-13,36311880,14118310,50430190
4040,DOHL3,2014-06-30,2014-08-13,43574256,16941972,60516228
4041,DOHL3,2014-09-30,2014-11-12,43574256,16941972,60516228
4042,DOHL3,2014-12-31,2015-03-23,43574256,16941972,60516228
4043,DOHL3,2015-03-31,2015-05-15,43574256,16941972,60516228
4044,DOHL3,2015-06-30,2015-08-13,43574256,16941972,60516228
4045,DOHL3,2015-09-30,2015-11-12,43574256,16941972,60516228
4046,DOHL3,2015-12-31,2016-03-23,43574256,16941972,60516228
4047,DOHL3,2016-03-31,2016-05-12,43574256,16941972,60516228
4048,DOHL3,2016-06-30,2016-08-12,43574256,16941972,60516228
4049,DOHL3,2016-09-30,2016-11-11,43574256,16941972,60516228
4050,DOHL3,2016-12-31,2017-03-24,43574256,16941972,60516228
4051,DOHL3,2017-03-31,2017-05-12,43574256,16941972,60516228
4052,DOHL3,2017-06-30,2017-08-14,43574256,16941972,60516228
4053,DOHL3,2017-09-30,2017-11-10,43574256,16941972,60516228
4054,DOHL3,2017-12-31,2018-03-28,43574256,16941972,60516228
4055,DOHL3,2018-03-31,2018-05-11,43574256,16941972,60516228
4056,DOHL3,2018-06-30,2018-08-14,43574256,16941972,60516228
4057,DOHL3,2018-09-30,2018-11-13,43574256,16941972,60516228
4058,DOHL3,2018-12-31,2019-03-25,43574256,16941972,60516228
4059,DOHL3,2019-03-31,2019-05-14,43574256,16941972,60516228
4060,DOHL3,2019-06-30,2019-08-13,43574256,16941972,60516228
4061,DOHL3,2019-09-30,2019-11-13,43574256,16941972,60516228
4062,DOHL3,2019-12-31,2020-03-26,43574256,16941972,60516228
4063,DOHL3,2020-03-31,2020-06-18,43574256,16941972,60516228
4064,DOHL3,2020-06-30,2020-08-26,43574256,16941972,60516228
4065,DOHL3,2020-09-30,2020-11-12,54467820,21177465,75645285
4066,DOHL4,2010-12-31,2011-03-30,3631,1412,5043
4067,DOHL4,2011-03-31,2011-05-31,3631,1412,5043
4068,DOHL4,2011-06-30,2011-08-15,36312,14118,50430
4069,DOHL4,2011-09-30,2011-11-11,36312,14118,50430
4070,DOHL4,2011-12-31,2012-03-27,36311880,14118310,50430190
4071,DOHL4,2012-03-31,2012-05-15,36312,14118,50430
4072,DOHL4,2012-06-30,2012-08-14,36312,14118,50430
4073,DOHL4,2012-09-30,2012-11-13,36312,14118,50430
4074,DOHL4,2012-12-31,2013-03-25,36311880,14118310,50430190
4075,DOHL4,2013-03-31,2013-05-14,36311880,14118310,50430190
4076,DOHL4,2013-06-30,2013-08-13,36311880,14118310,50430190
4077,DOHL4,2013-09-30,2013-11-13,36311880,14118310,50430190
4078,DOHL4,2013-12-31,2014-03-24,36311880,14118310,50430190
4079,DOHL4,2014-03-31,2014-05-13,36311880,14118310,50430190
4080,DOHL4,2014-06-30,2014-08-13,43574256,16941972,60516228
4081,DOHL4,2014-09-30,2014-11-12,43574256,16941972,60516228
4082,DOHL4,2014-12-31,2015-03-23,43574256,16941972,60516228
4083,DOHL4,2015-03-31,2015-05-15,43574256,16941972,60516228
4084,DOHL4,2015-06-30,2015-08-13,43574256,16941972,60516228
4085,DOHL4,2015-09-30,2015-11-12,43574256,16941972,60516228
4086,DOHL4,2015-12-31,2016-03-23,43574256,16941972,60516228
4087,DOHL4,2016-03-31,2016-05-12,43574256,16941972,60516228
4088,DOHL4,2016-06-30,2016-08-12,43574256,16941972,60516228
4089,DOHL4,2016-09-30,2016-11-11,43574256,16941972,60516228
4090,DOHL4,2016-12-31,2017-03-24,43574256,16941972,60516228
4091,DOHL4,2017-03-31,2017-05-12,43574256,16941972,60516228
4092,DOHL4,2017-06-30,2017-08-14,43574256,16941972,60516228
4093,DOHL4,2017-09-30,2017-11-10,43574256,16941972,60516228
4094,DOHL4,2017-12-31,2018-03-28,43574256,16941972,60516228
4095,DOHL4,2018-03-31,2018-05-11,43574256,16941972,60516228
4096,DOHL4,2018-06-30,2018-08-14,43574256,16941972,60516228
4097,DOHL4,2018-09-30,2018-11-13,43574256,16941972,60516228
4098,DOHL4,2018-12-31,2019-03-25,43574256,16941972,60516228
4099,DOHL4,2019-03-31,2019-05-14,43574256,16941972,60516228
4100,DOHL4,2019-06-30,2019-08-13,43574256,16941972,60516228
4101,DOHL4,2019-09-30,2019-11-13,43574256,16941972,60516228
4102,DOHL4,2019-12-31,2020-03-26,43574256,16941972,60516228
4103,DOHL4,2020-03-31,2020-06-18,43574256,16941972,60516228
4104,DOHL4,2020-06-30,2020-08-26,43574256,16941972,60516228
4105,DOHL4,2020-09-30,2020-11-12,54467820,21177465,75645285
4106,RADL3,2010-12-31,2011-03-01,188320020,0,188320020
4107,RADL3,2011-03-31,2011-05-11,188320020,0,188320020
4108,RADL3,2011-06-30,2011-08-10,188320020,0,188320020
4109,RADL3,2011-09-30,2011-11-09,188320020,0,188320020
4110,RADL3,2011-12-31,2012-03-26,330386000,0,330386000
4111,RADL3,2012-03-31,2012-05-10,330386000,0,330386000
4112,RADL3,2012-06-30,2012-08-09,330386000,0,330386000
4113,RADL3,2012-09-30,2012-11-13,330386000,0,330386000
4114,RADL3,2012-12-31,2013-03-27,330386000,0,330386000
4115,RADL3,2013-03-31,2013-05-09,330386000,0,330386000
4116,RADL3,2013-06-30,2013-08-08,330386000,0,330386000
4117,RADL3,2013-09-30,2013-11-07,330386000,0,330386000
4118,RADL3,2013-12-31,2014-03-17,330386000,0,330386000
4119,RADL3,2014-03-31,2014-05-08,330386000,0,330386000
4120,RADL3,2014-06-30,2014-08-07,330386000,0,330386000
4121,RADL3,2014-09-30,2014-11-06,330386000,0,330386000
4122,RADL3,2014-12-31,2015-02-26,330386000,0,330386000
4123,RADL3,2015-03-31,2015-04-29,330386000,0,330386000
4124,RADL3,2015-06-30,2015-07-30,330386000,0,330386000
4125,RADL3,2015-09-30,2015-10-29,330386000,0,330386000
4126,RADL3,2015-12-31,2016-02-18,330386000,0,330386000
4127,RADL3,2016-03-31,2016-04-28,330386000,0,330386000
4128,RADL3,2016-06-30,2016-08-04,330386000,0,330386000
4129,RADL3,2016-09-30,2016-10-27,330386000,0,330386000
4130,RADL3,2016-12-31,2017-02-16,330386000,0,330386000
4131,RADL3,2017-03-31,2017-04-27,330386000,0,330386000
4132,RADL3,2017-06-30,2017-07-27,330386000,0,330386000
4133,RADL3,2017-09-30,2017-10-26,330386000,0,330386000
4134,RADL3,2017-12-31,2018-02-22,330386000,0,330386000
4135,RADL3,2018-03-31,2018-05-02,330386000,0,330386000
4136,RADL3,2018-06-30,2018-07-30,330386000,0,330386000
4137,RADL3,2018-09-30,2018-10-30,330386000,0,330386000
4138,RADL3,2018-12-31,2019-02-26,330386000,0,330386000
4139,RADL3,2019-03-31,2019-04-29,330386000,0,330386000
4140,RADL3,2019-06-30,2019-08-06,330386000,0,330386000
4141,RADL3,2019-09-30,2019-10-29,330386000,0,330386000
4142,RADL3,2019-12-31,2020-02-19,330386000,0,330386000
4143,RADL3,2020-03-31,2020-04-28,330386000,0,330386000
4144,RADL3,2020-06-30,2020-08-11,330386000,0,330386000
4145,RADL3,2020-09-30,2020-10-27,1651930000,0,1651930000
4146,RADL3,2020-12-31,2021-03-09,1651930000,0,1651930000
4147,MNDL3,2010-12-31,2011-04-04,24638,22763,47401
4148,MNDL3,2011-03-31,2011-06-28,24638,22763,47401
4149,MNDL3,2011-06-30,2011-08-17,147829,136577,284406
4150,MNDL3,2011-09-30,2011-11-14,147829,136577,284406
4151,MNDL3,2011-12-31,2012-04-09,147829050,136577028,284406078
4152,MNDL3,2012-03-31,2012-05-16,257090672,0,257090672
4153,MNDL3,2012-06-30,2012-08-15,297631213,0,297631213
4154,MNDL3,2012-09-30,2012-11-14,297631213,0,297631213
4155,MNDL3,2012-12-31,2013-04-09,297631213,0,297631213
4156,MNDL3,2013-03-31,2013-05-15,2480260,0,2480260
4157,MNDL3,2013-06-30,2013-08-14,2480260,0,2480260
4158,MNDL3,2013-09-30,2013-11-14,2480260,0,2480260
4159,MNDL3,2013-12-31,2014-04-01,2480260,0,2480260
4160,MNDL3,2014-03-31,2014-05-16,2480260,0,2480260
4161,MNDL3,2014-06-30,2014-08-22,2480260,0,2480260
4162,MNDL3,2014-09-30,2014-11-17,2480260,0,2480260
4163,MNDL3,2014-12-31,2015-04-30,2480260,0,2480260
4164,MNDL3,2015-03-31,2015-05-28,2480260,0,2480260
4165,MNDL3,2015-06-30,2015-09-21,2480260,0,2480260
4166,MNDL3,2015-09-30,2015-11-16,2480260,0,2480260
4167,MNDL3,2015-12-31,2016-04-20,2480260,0,2480260
4168,MNDL3,2016-03-31,2016-06-27,2480260,0,2480260
4169,MNDL3,2016-06-30,2016-08-12,2480260,0,2480260
4170,MNDL3,2016-09-30,2016-11-14,2480260,0,2480260
4171,MNDL3,2016-12-31,2017-03-30,2480260,0,2480260
4172,MNDL3,2017-03-31,2017-05-15,2480260,0,2480260
4173,MNDL3,2017-06-30,2017-08-14,2480260,0,2480260
4174,MNDL3,2017-09-30,2017-11-14,2480260,0,2480260
4175,MNDL3,2017-12-31,2018-03-27,2480260,0,2480260
4176,MNDL3,2018-03-31,2018-05-15,2480260,0,2480260
4177,MNDL3,2018-06-30,2018-08-14,2480260,0,2480260
4178,MNDL3,2018-09-30,2018-11-14,2480260,0,2480260
4179,MNDL3,2018-12-31,2019-03-29,2480260,0,2480260
4180,MNDL3,2019-03-31,2019-05-15,2480260,0,2480260
4181,MNDL3,2019-06-30,2019-08-14,2480260,0,2480260
4182,MNDL3,2019-09-30,2019-11-14,2480260,0,2480260
4183,MNDL3,2019-12-31,2020-03-27,2480260,0,2480260
4184,MNDL3,2020-03-31,2020-06-29,2480260,0,2480260
4185,MNDL3,2020-06-30,2020-08-28,2480260,0,2480260
4186,MNDL3,2020-09-30,2020-11-13,2480260,0,2480260
4187,EALT3,2010-12-31,2011-04-11,975,1275,2250
4188,EALT3,2011-03-31,2011-05-23,975,1275,2250
4189,EALT3,2011-06-30,2011-08-11,975,1275,2250
4190,EALT3,2011-09-30,2011-11-03,975,1275,2250
4191,EALT3,2011-12-31,2012-03-27,975,1275,2250
4192,EALT3,2012-03-31,2012-04-26,975,1275,2250
4193,EALT3,2012-06-30,2012-07-31,975,1275,2250
4194,EALT3,2012-09-30,2012-10-30,975,1275,2250
4195,EALT3,2012-12-31,2013-03-25,975,1275,2250
4196,EALT3,2013-03-31,2013-05-13,975,1275,2250
4197,EALT3,2013-06-30,2013-08-08,975,1275,2250
4198,EALT3,2013-09-30,2013-10-25,975,1275,2250
4199,EALT3,2013-12-31,2014-03-25,975,1275,2250
4200,EALT3,2014-03-31,2014-05-14,975,1275,2250
4201,EALT3,2014-06-30,2014-07-25,975,1275,2250
4202,EALT3,2014-09-30,2014-10-29,975,1275,2250
4203,EALT3,2014-12-31,2015-03-26,975,1275,2250
4204,EALT3,2015-03-31,2015-05-20,975,1275,2250
4205,EALT3,2015-06-30,2015-08-04,975,1275,2250
4206,EALT3,2015-09-30,2015-10-26,975,1275,2250
4207,EALT3,2015-12-31,2016-03-29,975,1275,2250
4208,EALT3,2016-03-31,2016-05-02,975,1275,2250
4209,EALT3,2016-06-30,2016-08-11,975,1275,2250
4210,EALT3,2016-09-30,2016-10-31,975,1275,2250
4211,EALT3,2016-12-31,2017-03-27,975,1275,2250
4212,EALT3,2017-03-31,2017-04-28,975,1275,2250
4213,EALT3,2017-06-30,2017-08-03,975,1275,2250
4214,EALT3,2017-09-30,2017-11-01,975,1275,2250
4215,EALT3,2017-12-31,2018-03-27,975,1275,2250
4216,EALT3,2018-03-31,2018-04-20,975,1275,2250
4217,EALT3,2018-06-30,2018-07-27,9750,12750,22500
4218,EALT3,2018-09-30,2018-11-01,9750,12750,22500
4219,EALT3,2018-12-31,2019-03-29,9750,12750,22500
4220,EALT3,2019-03-31,2019-05-10,9750,12750,22500
4221,EALT3,2019-06-30,2019-08-09,9750,12750,22500
4222,EALT3,2019-09-30,2019-11-13,9750,12750,22500
4223,EALT3,2019-12-31,2020-03-30,9750,12750,22500
4224,EALT3,2020-03-31,2020-07-01,9755,12745,22500
4225,EALT3,2020-06-30,2020-08-21,9755,12745,22500
4226,EALT3,2020-09-30,2020-11-13,9750,12750,22500
4227,EALT4,2010-12-31,2011-04-11,975,1275,2250
4228,EALT4,2011-03-31,2011-05-23,975,1275,2250
4229,EALT4,2011-06-30,2011-08-11,975,1275,2250
4230,EALT4,2011-09-30,2011-11-03,975,1275,2250
4231,EALT4,2011-12-31,2012-03-27,975,1275,2250
4232,EALT4,2012-03-31,2012-04-26,975,1275,2250
4233,EALT4,2012-06-30,2012-07-31,975,1275,2250
4234,EALT4,2012-09-30,2012-10-30,975,1275,2250
4235,EALT4,2012-12-31,2013-03-25,975,1275,2250
4236,EALT4,2013-03-31,2013-05-13,975,1275,2250
4237,EALT4,2013-06-30,2013-08-08,975,1275,2250
4238,EALT4,2013-09-30,2013-10-25,975,1275,2250
4239,EALT4,2013-12-31,2014-03-25,975,1275,2250
4240,EALT4,2014-03-31,2014-05-14,975,1275,2250
4241,EALT4,2014-06-30,2014-07-25,975,1275,2250
4242,EALT4,2014-09-30,2014-10-29,975,1275,2250
4243,EALT4,2014-12-31,2015-03-26,975,1275,2250
4244,EALT4,2015-03-31,2015-05-20,975,1275,2250
4245,EALT4,2015-06-30,2015-08-04,975,1275,2250
4246,EALT4,2015-09-30,2015-10-26,975,1275,2250
4247,EALT4,2015-12-31,2016-03-29,975,1275,2250
4248,EALT4,2016-03-31,2016-05-02,975,1275,2250
4249,EALT4,2016-06-30,2016-08-11,975,1275,2250
4250,EALT4,2016-09-30,2016-10-31,975,1275,2250
4251,EALT4,2016-12-31,2017-03-27,975,1275,2250
4252,EALT4,2017-03-31,2017-04-28,975,1275,2250
4253,EALT4,2017-06-30,2017-08-03,975,1275,2250
4254,EALT4,2017-09-30,2017-11-01,975,1275,2250
4255,EALT4,2017-12-31,2018-03-27,975,1275,2250
4256,EALT4,2018-03-31,2018-04-20,975,1275,2250
4257,EALT4,2018-06-30,2018-07-27,9750,12750,22500
4258,EALT4,2018-09-30,2018-11-01,9750,12750,22500
4259,EALT4,2018-12-31,2019-03-29,9750,12750,22500
4260,EALT4,2019-03-31,2019-05-10,9750,12750,22500
4261,EALT4,2019-06-30,2019-08-09,9750,12750,22500
4262,EALT4,2019-09-30,2019-11-13,9750,12750,22500
4263,EALT4,2019-12-31,2020-03-30,9750,12750,22500
4264,EALT4,2020-03-31,2020-07-01,9755,12745,22500
4265,EALT4,2020-06-30,2020-08-21,9755,12745,22500
4266,EALT4,2020-09-30,2020-11-13,9750,12750,22500
4267,WEGE3,2010-12-31,2011-02-23,620905029,0,620905029
4268,WEGE3,2011-03-31,2011-04-27,620905029,0,620905029
4269,WEGE3,2011-06-30,2011-07-22,620405029,0,620405029
4270,WEGE3,2011-09-30,2011-10-26,620405029,0,620405029
4271,WEGE3,2011-12-31,2012-02-15,620405029,0,620405029
4272,WEGE3,2012-03-31,2012-04-25,620405029,0,620405029
4273,WEGE3,2012-06-30,2012-07-25,620405029,0,620405029
4274,WEGE3,2012-09-30,2012-10-24,620405029,0,620405029
4275,WEGE3,2012-12-31,2013-02-27,620405029,0,620405029
4276,WEGE3,2013-03-31,2013-04-24,620405029,0,620405029
4277,WEGE3,2013-06-30,2013-07-31,620419011,0,620419011
4278,WEGE3,2013-09-30,2013-10-30,620905029,0,620905029
4279,WEGE3,2013-12-31,2014-02-26,620905029,0,620905029
4280,WEGE3,2014-03-31,2014-04-24,620905029,0,620905029
4281,WEGE3,2014-06-30,2014-07-23,807176538,0,807176538
4282,WEGE3,2014-09-30,2014-10-29,807176538,0,807176538
4283,WEGE3,2014-12-31,2015-02-25,807176538,0,807176538
4284,WEGE3,2015-03-31,2015-04-29,807176538,0,807176538
4285,WEGE3,2015-06-30,2015-07-29,1614353076,0,1614353076
4286,WEGE3,2015-09-30,2015-10-28,1614353076,0,1614353076
4287,WEGE3,2015-12-31,2016-02-24,1614353076,0,1614353076
4288,WEGE3,2016-03-31,2016-04-20,1614353076,0,1614353076
4289,WEGE3,2016-06-30,2016-07-27,1614353076,0,1614353076
4290,WEGE3,2016-09-30,2016-10-26,1614353076,0,1614353076
4291,WEGE3,2016-12-31,2017-02-22,1614353076,0,1614353076
4292,WEGE3,2017-03-31,2017-04-26,1614353076,0,1614353076
4293,WEGE3,2017-06-30,2017-07-19,1614353076,0,1614353076
4294,WEGE3,2017-09-30,2017-10-25,1614353076,0,1614353076
4295,WEGE3,2017-12-31,2018-02-28,1614353076,0,1614353076
4296,WEGE3,2018-03-31,2018-11-05,1614353076,0,1614353076
4297,WEGE3,2018-06-30,2018-08-14,2098658999,0,2098658999
4298,WEGE3,2018-09-30,2018-10-24,2098658999,0,2098658999
4299,WEGE3,2018-12-31,2019-04-10,2098658999,0,2098658999
4300,WEGE3,2019-03-31,2019-04-24,2098658999,0,2098658999
4301,WEGE3,2019-06-30,2019-07-24,2098658999,0,2098658999
4302,WEGE3,2019-09-30,2019-10-23,2098658999,0,2098658999
4303,WEGE3,2019-12-31,2020-02-19,2098658999,0,2098658999
4304,WEGE3,2020-03-31,2020-04-29,2098658999,0,2098658999
4305,WEGE3,2020-06-30,2020-07-22,2098658999,0,2098658999
4306,WEGE3,2020-09-30,2020-10-21,2098658999,0,2098658999
4307,WEGE3,2020-12-31,2021-02-24,2098658999,0,2098658999
4308,ETER3,2010-12-31,2011-03-11,89500000,0,89500000
4309,ETER3,2011-03-31,2011-05-10,89500,0,89500
4310,ETER3,2011-06-30,2011-08-09,89500,0,89500
4311,ETER3,2011-09-30,2011-12-23,89500,0,89500
4312,ETER3,2011-12-31,2012-03-12,89500,0,89500
4313,ETER3,2012-03-31,2012-05-08,89500,0,89500
4314,ETER3,2012-06-30,2012-08-09,89500,0,89500
4315,ETER3,2012-09-30,2012-11-07,89500,0,89500
4316,ETER3,2012-12-31,2013-03-15,89500,0,89500
4317,ETER3,2013-03-31,2013-05-06,89500,0,89500
4318,ETER3,2013-06-30,2013-08-08,89500,0,89500
4319,ETER3,2013-09-30,2013-11-07,89500,0,89500
4320,ETER3,2013-12-31,2014-03-17,89500,0,89500
4321,ETER3,2014-03-31,2014-05-08,89500,0,89500
4322,ETER3,2014-06-30,2014-08-07,89500,0,89500
4323,ETER3,2014-09-30,2014-11-14,179000,0,179000
4324,ETER3,2014-12-31,2015-03-12,179000,0,179000
4325,ETER3,2015-03-31,2015-05-22,179000,0,179000
4326,ETER3,2015-06-30,2015-08-14,179000,0,179000
4327,ETER3,2015-09-30,2015-11-05,179000,0,179000
4328,ETER3,2015-12-31,2016-03-28,179000,0,179000
4329,ETER3,2016-03-31,2016-05-12,179000,0,179000
4330,ETER3,2016-06-30,2016-08-11,179000,0,179000
4331,ETER3,2016-09-30,2016-11-10,179000,0,179000
4332,ETER3,2016-12-31,2017-03-17,179000,0,179000
4333,ETER3,2017-03-31,2017-05-11,179000,0,179000
4334,ETER3,2017-06-30,2017-08-10,179000,0,179000
4335,ETER3,2017-09-30,2017-11-09,179000,0,179000
4336,ETER3,2017-12-31,2018-04-27,179000,0,179000
4337,ETER3,2018-03-31,2018-05-25,179000,0,179000
4338,ETER3,2018-06-30,2018-08-15,179000,0,179000
4339,ETER3,2018-09-30,2018-11-14,179000,0,179000
4340,ETER3,2018-12-31,2019-03-25,29833,0,29833
4341,ETER3,2019-03-31,2019-05-16,29833,0,29833
4342,ETER3,2019-06-30,2019-08-15,29833,0,29833
4343,ETER3,2019-09-30,2019-11-19,31774,0,31774
4344,ETER3,2019-12-31,2020-03-25,31774,0,31774
4345,ETER3,2020-03-31,2020-05-29,31774,0,31774
4346,ETER3,2020-06-30,2020-08-11,31774,0,31774
4347,ETER3,2020-09-30,2020-11-11,51676,0,51676
4348,ETER3,2020-12-31,2021-03-02,51676,0,51676
4349,EUCA3,2010-12-31,2011-04-12,31258,61361,92619
4350,EUCA3,2011-03-31,2011-05-17,31257700,61361556,92619256
4351,EUCA3,2011-06-30,2011-08-18,31257700,61361556,92619256
4352,EUCA3,2011-09-30,2011-11-08,31257700,61361556,92619256
4353,EUCA3,2011-12-31,2012-03-07,31258,61361,92619
4354,EUCA3,2012-03-31,2012-05-09,31258,61361,92619
4355,EUCA3,2012-06-30,2012-08-08,31258,61361,92619
4356,EUCA3,2012-09-30,2012-11-06,31258,61361,92619
4357,EUCA3,2012-12-31,2013-03-20,31258,61361,92619
4358,EUCA3,2013-03-31,2013-05-03,31258,61361,92619
4359,EUCA3,2013-06-30,2013-08-07,31258,61361,92619
4360,EUCA3,2013-09-30,2013-11-06,31258,61361,92619
4361,EUCA3,2013-12-31,2014-02-21,31258,61361,92619
4362,EUCA3,2014-03-31,2014-05-07,31258,61361,92619
4363,EUCA3,2014-06-30,2014-08-06,31258,61361,92619
4364,EUCA3,2014-09-30,2014-11-05,31258,61361,92619
4365,EUCA3,2014-12-31,2015-03-04,31258,61361,92619
4366,EUCA3,2015-03-31,2015-05-06,31258,61361,92619
4367,EUCA3,2015-06-30,2015-08-11,31258,61361,92619
4368,EUCA3,2015-09-30,2015-11-11,31258,61361,92619
4369,EUCA3,2015-12-31,2016-03-09,31258,61361,92619
4370,EUCA3,2016-03-31,2016-05-11,31258,61361,92619
4371,EUCA3,2016-06-30,2016-08-10,31258,61361,92619
4372,EUCA3,2016-09-30,2016-11-09,31258,61361,92619
4373,EUCA3,2016-12-31,2017-03-29,31258,61361,92619
4374,EUCA3,2017-03-31,2017-05-15,31258,61361,92619
4375,EUCA3,2017-06-30,2017-08-09,31258,61361,92619
4376,EUCA3,2017-09-30,2017-11-08,31258,61361,92619
4377,EUCA3,2017-12-31,2018-03-21,31258,61361,92619
4378,EUCA3,2018-03-31,2018-05-08,31258,61361,92619
4379,EUCA3,2018-06-30,2018-08-08,31258,61361,92619
4380,EUCA3,2018-09-30,2018-11-07,31258,61361,92619
4381,EUCA3,2018-12-31,2019-03-27,31258,61361,92619
4382,EUCA3,2019-03-31,2019-05-15,31258,61361,92619
4383,EUCA3,2019-06-30,2019-08-14,31258,61361,92619
4384,EUCA3,2019-09-30,2019-11-12,31258,61361,92619
4385,EUCA3,2019-12-31,2020-03-25,31258,61361,92619
4386,EUCA3,2020-03-31,2020-06-24,31258,61361,92619
4387,EUCA3,2020-06-30,2020-08-26,31258,61361,92619
4388,EUCA3,2020-09-30,2020-11-11,31258,61361,92619
4389,EUCA4,2010-12-31,2011-04-12,31258,61361,92619
4390,EUCA4,2011-03-31,2011-05-17,31257700,61361556,92619256
4391,EUCA4,2011-06-30,2011-08-18,31257700,61361556,92619256
4392,EUCA4,2011-09-30,2011-11-08,31257700,61361556,92619256
4393,EUCA4,2011-12-31,2012-03-07,31258,61361,92619
4394,EUCA4,2012-03-31,2012-05-09,31258,61361,92619
4395,EUCA4,2012-06-30,2012-08-08,31258,61361,92619
4396,EUCA4,2012-09-30,2012-11-06,31258,61361,92619
4397,EUCA4,2012-12-31,2013-03-20,31258,61361,92619
4398,EUCA4,2013-03-31,2013-05-03,31258,61361,92619
4399,EUCA4,2013-06-30,2013-08-07,31258,61361,92619
4400,EUCA4,2013-09-30,2013-11-06,31258,61361,92619
4401,EUCA4,2013-12-31,2014-02-21,31258,61361,92619
4402,EUCA4,2014-03-31,2014-05-07,31258,61361,92619
4403,EUCA4,2014-06-30,2014-08-06,31258,61361,92619
4404,EUCA4,2014-09-30,2014-11-05,31258,61361,92619
4405,EUCA4,2014-12-31,2015-03-04,31258,61361,92619
4406,EUCA4,2015-03-31,2015-05-06,31258,61361,92619
4407,EUCA4,2015-06-30,2015-08-11,31258,61361,92619
4408,EUCA4,2015-09-30,2015-11-11,31258,61361,92619
4409,EUCA4,2015-12-31,2016-03-09,31258,61361,92619
4410,EUCA4,2016-03-31,2016-05-11,31258,61361,92619
4411,EUCA4,2016-06-30,2016-08-10,31258,61361,92619
4412,EUCA4,2016-09-30,2016-11-09,31258,61361,92619
4413,EUCA4,2016-12-31,2017-03-29,31258,61361,92619
4414,EUCA4,2017-03-31,2017-05-15,31258,61361,92619
4415,EUCA4,2017-06-30,2017-08-09,31258,61361,92619
4416,EUCA4,2017-09-30,2017-11-08,31258,61361,92619
4417,EUCA4,2017-12-31,2018-03-21,31258,61361,92619
4418,EUCA4,2018-03-31,2018-05-08,31258,61361,92619
4419,EUCA4,2018-06-30,2018-08-08,31258,61361,92619
4420,EUCA4,2018-09-30,2018-11-07,31258,61361,92619
4421,EUCA4,2018-12-31,2019-03-27,31258,61361,92619
4422,EUCA4,2019-03-31,2019-05-15,31258,61361,92619
4423,EUCA4,2019-06-30,2019-08-14,31258,61361,92619
4424,EUCA4,2019-09-30,2019-11-12,31258,61361,92619
4425,EUCA4,2019-12-31,2020-03-25,31258,61361,92619
4426,EUCA4,2020-03-31,2020-06-24,31258,61361,92619
4427,EUCA4,2020-06-30,2020-08-26,31258,61361,92619
4428,EUCA4,2020-09-30,2020-11-11,31258,61361,92619
4429,FIGE3,2010-12-31,2011-04-06,792,1572,2364
4430,FIGE3,2011-03-31,2011-05-13,792,1572,2364
4431,FIGE3,2011-06-30,2011-08-12,792,1572,2364
4432,FIGE3,2011-09-30,2011-11-14,792,1572,2364
4433,FIGE3,2011-12-31,2012-03-14,792,1572,2364
4434,FIGE3,2012-03-31,2012-05-15,792,1572,2364
4435,FIGE3,2012-06-30,2012-08-14,792,1572,2364
4436,FIGE3,2012-09-30,2012-11-14,792,1572,2364
4437,FIGE3,2012-12-31,2013-03-28,792,1572,2364
4438,FIGE3,2013-03-31,2013-05-15,792,1572,2364
4439,FIGE3,2013-06-30,2013-08-14,792,1572,2364
4440,FIGE3,2013-09-30,2013-11-14,792,1572,2364
4441,FIGE3,2013-12-31,2014-03-27,792,1572,2364
4442,FIGE3,2014-03-31,2014-12-18,792,1572,2364
4443,FIGE3,2014-06-30,2014-08-14,792,1572,2364
4444,FIGE3,2014-09-30,2014-11-14,792,1572,2364
4445,FIGE3,2014-12-31,2015-02-06,792,1572,2364
4446,FIGE3,2015-03-31,2015-05-08,792,1572,2364
4447,FIGE3,2015-06-30,2015-08-07,792,1572,2364
4448,FIGE3,2015-09-30,2015-11-09,792,1572,2364
4449,FIGE3,2015-12-31,2016-02-11,792,1572,2364
4450,FIGE3,2016-03-31,2016-05-06,792,1572,2364
4451,FIGE3,2016-06-30,2016-08-05,792,1572,2364
4452,FIGE3,2016-09-30,2016-11-07,792,1572,2364
4453,FIGE3,2016-12-31,2017-02-13,792,1572,2364
4454,FIGE3,2017-03-31,2017-05-08,792,1572,2364
4455,FIGE3,2017-06-30,2017-08-11,792,1572,2364
4456,FIGE3,2017-09-30,2017-11-06,792,1572,2364
4457,FIGE3,2017-12-31,2018-02-09,792,1572,2364
4458,FIGE3,2018-03-31,2018-05-04,792,1572,2364
4459,FIGE3,2018-06-30,2018-08-03,792,1572,2364
4460,FIGE3,2018-09-30,2018-11-05,792,1572,2364
4461,FIGE3,2018-12-31,2019-02-13,792,1572,2364
4462,FIGE3,2019-03-31,2019-05-03,792,1572,2364
4463,FIGE3,2019-06-30,2019-08-02,792,1572,2364
4464,FIGE3,2019-09-30,2019-11-08,792,1572,2364
4465,FIGE3,2019-12-31,2020-02-14,792,1572,2364
4466,FIGE3,2020-03-31,2020-05-08,792,1572,2364
4467,FIGE3,2020-06-30,2020-08-07,792,1572,2364
4468,FIGE3,2020-09-30,2020-11-09,792,1572,2364
4469,FIGE3,2020-12-31,2021-02-05,792,1572,2364
4470,FIGE4,2010-12-31,2011-04-06,792,1572,2364
4471,FIGE4,2011-03-31,2011-05-13,792,1572,2364
4472,FIGE4,2011-06-30,2011-08-12,792,1572,2364
4473,FIGE4,2011-09-30,2011-11-14,792,1572,2364
4474,FIGE4,2011-12-31,2012-03-14,792,1572,2364
4475,FIGE4,2012-03-31,2012-05-15,792,1572,2364
4476,FIGE4,2012-06-30,2012-08-14,792,1572,2364
4477,FIGE4,2012-09-30,2012-11-14,792,1572,2364
4478,FIGE4,2012-12-31,2013-03-28,792,1572,2364
4479,FIGE4,2013-03-31,2013-05-15,792,1572,2364
4480,FIGE4,2013-06-30,2013-08-14,792,1572,2364
4481,FIGE4,2013-09-30,2013-11-14,792,1572,2364
4482,FIGE4,2013-12-31,2014-03-27,792,1572,2364
4483,FIGE4,2014-03-31,2014-12-18,792,1572,2364
4484,FIGE4,2014-06-30,2014-08-14,792,1572,2364
4485,FIGE4,2014-09-30,2014-11-14,792,1572,2364
4486,FIGE4,2014-12-31,2015-02-06,792,1572,2364
4487,FIGE4,2015-03-31,2015-05-08,792,1572,2364
4488,FIGE4,2015-06-30,2015-08-07,792,1572,2364
4489,FIGE4,2015-09-30,2015-11-09,792,1572,2364
4490,FIGE4,2015-12-31,2016-02-11,792,1572,2364
4491,FIGE4,2016-03-31,2016-05-06,792,1572,2364
4492,FIGE4,2016-06-30,2016-08-05,792,1572,2364
4493,FIGE4,2016-09-30,2016-11-07,792,1572,2364
4494,FIGE4,2016-12-31,2017-02-13,792,1572,2364
4495,FIGE4,2017-03-31,2017-05-08,792,1572,2364
4496,FIGE4,2017-06-30,2017-08-11,792,1572,2364
4497,FIGE4,2017-09-30,2017-11-06,792,1572,2364
4498,FIGE4,2017-12-31,2018-02-09,792,1572,2364
4499,FIGE4,2018-03-31,2018-05-04,792,1572,2364
4500,FIGE4,2018-06-30,2018-08-03,792,1572,2364
4501,FIGE4,2018-09-30,2018-11-05,792,1572,2364
4502,FIGE4,2018-12-31,2019-02-13,792,1572,2364
4503,FIGE4,2019-03-31,2019-05-03,792,1572,2364
4504,FIGE4,2019-06-30,2019-08-02,792,1572,2364
4505,FIGE4,2019-09-30,2019-11-08,792,1572,2364
4506,FIGE4,2019-12-31,2020-02-14,792,1572,2364
4507,FIGE4,2020-03-31,2020-05-08,792,1572,2364
4508,FIGE4,2020-06-30,2020-08-07,792,1572,2364
4509,FIGE4,2020-09-30,2020-11-09,792,1572,2364
4510,FIGE4,2020-12-31,2021-02-05,792,1572,2364
4511,FNCN3,2010-12-31,2011-03-28,913,0,913
4512,FNCN3,2011-03-31,2011-05-03,913,0,913
4513,FNCN3,2011-06-30,2011-08-04,913,0,913
4514,FNCN3,2011-09-30,2011-11-03,913,0,913
4515,FNCN3,2011-12-31,2012-03-09,913,0,913
4516,FNCN3,2012-03-31,2012-05-03,913,0,913
4517,FNCN3,2012-06-30,2012-08-03,913,0,913
4518,FNCN3,2012-09-30,2012-11-06,913,0,913
4519,FNCN3,2012-12-31,2013-02-28,913,0,913
4520,FNCN3,2013-03-31,2013-05-10,913,0,913
4521,FNCN3,2013-06-30,2013-07-19,913,0,913
4522,FNCN3,2013-09-30,2013-11-06,913,0,913
4523,FNCN3,2013-12-31,2014-02-28,913,0,913
4524,FNCN3,2014-03-31,2014-04-30,913,0,913
4525,FNCN3,2014-06-30,2014-07-24,913,0,913
4526,FNCN3,2014-09-30,2014-10-30,913,0,913
4527,FNCN3,2014-12-31,2015-02-20,913,0,913
4528,FNCN3,2015-03-31,2015-05-11,913,0,913
4529,FNCN3,2015-06-30,2015-08-05,913,0,913
4530,FNCN3,2015-09-30,2015-11-10,913,0,913
4531,FNCN3,2015-12-31,2016-02-04,913,0,913
4532,FNCN3,2016-03-31,2016-05-05,913,0,913
4533,FNCN3,2016-06-30,2016-08-12,913,0,913
4534,FNCN3,2016-09-30,2016-10-24,913,0,913
4535,FNCN3,2016-12-31,2017-02-17,913,0,913
4536,FNCN3,2017-03-31,2017-05-10,913,0,913
4537,FNCN3,2017-06-30,2017-07-21,913,0,913
4538,FNCN3,2017-09-30,2017-10-31,913,0,913
4539,FNCN3,2017-12-31,2018-02-19,913,0,913
4540,FNCN3,2018-03-31,2018-05-08,913,0,913
4541,FNCN3,2018-06-30,2018-07-24,913,0,913
4542,FNCN3,2018-09-30,2018-11-06,913,0,913
4543,FNCN3,2018-12-31,2019-02-12,913,0,913
4544,FNCN3,2019-03-31,2019-04-24,913,0,913
4545,FNCN3,2019-06-30,2019-07-23,913,0,913
4546,FNCN3,2019-09-30,2019-10-22,913,0,913
4547,FNCN3,2019-12-31,2020-03-16,913,0,913
4548,FNCN3,2020-03-31,2020-06-19,913,0,913
4549,FNCN3,2020-06-30,2020-07-28,913,0,913
4550,FNCN3,2020-09-30,2020-11-09,913,0,913
4551,FJTA3,2010-12-31,2011-04-12,42745,85489,128234
4552,FJTA3,2011-03-31,2011-05-13,42745,85489,128234
4553,FJTA3,2011-06-30,2011-09-12,47019,94038,141057
4554,FJTA3,2011-09-30,2011-11-11,47137539,94275078,141412617
4555,FJTA3,2011-12-31,2012-03-27,47137539,94275078,141412617
4556,FJTA3,2012-03-31,2012-05-14,47137539,94275078,141412617
4557,FJTA3,2012-06-30,2014-03-28,47137539,94275078,141412617
4558,FJTA3,2012-09-30,2014-03-28,47137539,94275078,141412617
4559,FJTA3,2012-12-31,2014-03-28,47137539,94275078,141412617
4560,FJTA3,2013-03-31,2014-03-28,47137539,94275078,141412617
4561,FJTA3,2013-06-30,2014-03-28,47137539,94275078,141412617
4562,FJTA3,2013-09-30,2014-03-28,47137539,94275078,141412617
4563,FJTA3,2013-12-31,2014-03-31,47137539,94275078,141412617
4564,FJTA3,2014-03-31,2014-05-15,47137539,94275078,141412617
4565,FJTA3,2014-06-30,2014-08-14,47137539,94275078,141412617
4566,FJTA3,2014-09-30,2014-11-13,92832547,84751880,177584427
4567,FJTA3,2014-12-31,2015-03-30,92832547,84751880,177584427
4568,FJTA3,2015-03-31,2015-05-15,8439322,7704716,16144038
4569,FJTA3,2015-06-30,2015-08-14,8439322,7704716,16144038
4570,FJTA3,2015-09-30,2015-11-13,27446627,13001621,40448248
4571,FJTA3,2015-12-31,2016-03-24,27446627,13001621,40448248
4572,FJTA3,2016-03-31,2016-05-13,34581630,13001621,47583251
4573,FJTA3,2016-06-30,2016-08-12,44642459,13636110,58278569
4574,FJTA3,2016-09-30,2016-11-11,44642459,13636110,58278569
4575,FJTA3,2016-12-31,2017-03-27,44642459,13636110,58278569
4576,FJTA3,2017-03-31,2017-05-12,46445314,18242898,64688212
4577,FJTA3,2017-06-30,2017-08-11,46445314,18242898,64688212
4578,FJTA3,2017-09-30,2017-11-10,46445314,18242898,64688212
4579,FJTA3,2017-12-31,2018-04-04,46445314,18242898,64688212
4580,FJTA3,2018-03-31,2018-05-16,46445314,18242898,64688212
4581,FJTA3,2018-06-30,2018-08-14,46445314,18242898,64688212
4582,FJTA3,2018-09-30,2018-11-16,46445314,18242898,64688212
4583,FJTA3,2018-12-31,2019-03-29,46445314,28417312,74862626
4584,FJTA3,2019-03-31,2019-05-14,46445314,38823733,85269047
4585,FJTA3,2019-06-30,2019-08-22,46445314,42014484,88459798
4586,FJTA3,2019-09-30,2019-11-13,46445314,42015334,88460648
4587,FJTA3,2019-12-31,2020-03-30,46445314,42019019,88464333
4588,FJTA3,2020-03-31,2020-06-29,46445314,42042380,88487694
4589,FJTA3,2020-06-30,2020-08-13,46445314,42043312,88488626
4590,FJTA3,2020-09-30,2020-11-12,46445314,42609796,89055110
4591,FJTA3,2020-09-30,2020-11-12,46445314,42609796,89055110
4592,FJTA3,2020-12-31,2021-03-19,46445314,49684169,96129483
4593,FJTA4,2010-12-31,2011-04-12,42745,85489,128234
4594,FJTA4,2011-03-31,2011-05-13,42745,85489,128234
4595,FJTA4,2011-06-30,2011-09-12,47019,94038,141057
4596,FJTA4,2011-09-30,2011-11-11,47137539,94275078,141412617
4597,FJTA4,2011-12-31,2012-03-27,47137539,94275078,141412617
4598,FJTA4,2012-03-31,2012-05-14,47137539,94275078,141412617
4599,FJTA4,2012-06-30,2014-03-28,47137539,94275078,141412617
4600,FJTA4,2012-09-30,2014-03-28,47137539,94275078,141412617
4601,FJTA4,2012-12-31,2014-03-28,47137539,94275078,141412617
4602,FJTA4,2013-03-31,2014-03-28,47137539,94275078,141412617
4603,FJTA4,2013-06-30,2014-03-28,47137539,94275078,141412617
4604,FJTA4,2013-09-30,2014-03-28,47137539,94275078,141412617
4605,FJTA4,2013-12-31,2014-03-31,47137539,94275078,141412617
4606,FJTA4,2014-03-31,2014-05-15,47137539,94275078,141412617
4607,FJTA4,2014-06-30,2014-08-14,47137539,94275078,141412617
4608,FJTA4,2014-09-30,2014-11-13,92832547,84751880,177584427
4609,FJTA4,2014-12-31,2015-03-30,92832547,84751880,177584427
4610,FJTA4,2015-03-31,2015-05-15,8439322,7704716,16144038
4611,FJTA4,2015-06-30,2015-08-14,8439322,7704716,16144038
4612,FJTA4,2015-09-30,2015-11-13,27446627,13001621,40448248
4613,FJTA4,2015-12-31,2016-03-24,27446627,13001621,40448248
4614,FJTA4,2016-03-31,2016-05-13,34581630,13001621,47583251
4615,FJTA4,2016-06-30,2016-08-12,44642459,13636110,58278569
4616,FJTA4,2016-09-30,2016-11-11,44642459,13636110,58278569
4617,FJTA4,2016-12-31,2017-03-27,44642459,13636110,58278569
4618,FJTA4,2017-03-31,2017-05-12,46445314,18242898,64688212
4619,FJTA4,2017-06-30,2017-08-11,46445314,18242898,64688212
4620,FJTA4,2017-09-30,2017-11-10,46445314,18242898,64688212
4621,FJTA4,2017-12-31,2018-04-04,46445314,18242898,64688212
4622,FJTA4,2018-03-31,2018-05-16,46445314,18242898,64688212
4623,FJTA4,2018-06-30,2018-08-14,46445314,18242898,64688212
4624,FJTA4,2018-09-30,2018-11-16,46445314,18242898,64688212
4625,FJTA4,2018-12-31,2019-03-29,46445314,28417312,74862626
4626,FJTA4,2019-03-31,2019-05-14,46445314,38823733,85269047
4627,FJTA4,2019-06-30,2019-08-22,46445314,42014484,88459798
4628,FJTA4,2019-09-30,2019-11-13,46445314,42015334,88460648
4629,FJTA4,2019-12-31,2020-03-30,46445314,42019019,88464333
4630,FJTA4,2020-03-31,2020-06-29,46445314,42042380,88487694
4631,FJTA4,2020-06-30,2020-08-13,46445314,42043312,88488626
4632,FJTA4,2020-09-30,2020-11-12,46445314,42609796,89055110
4633,FJTA4,2020-09-30,2020-11-12,46445314,42609796,89055110
4634,FJTA4,2020-12-31,2021-03-19,46445314,49684169,96129483
4635,TASA3,2010-12-31,2011-04-12,42745,85489,128234
4636,TASA3,2011-03-31,2011-05-13,42745,85489,128234
4637,TASA3,2011-06-30,2011-09-12,47019,94038,141057
4638,TASA3,2011-09-30,2011-11-11,47137539,94275078,141412617
4639,TASA3,2011-12-31,2012-03-27,47137539,94275078,141412617
4640,TASA3,2012-03-31,2012-05-14,47137539,94275078,141412617
4641,TASA3,2012-06-30,2014-03-28,47137539,94275078,141412617
4642,TASA3,2012-09-30,2014-03-28,47137539,94275078,141412617
4643,TASA3,2012-12-31,2014-03-28,47137539,94275078,141412617
4644,TASA3,2013-03-31,2014-03-28,47137539,94275078,141412617
4645,TASA3,2013-06-30,2014-03-28,47137539,94275078,141412617
4646,TASA3,2013-09-30,2014-03-28,47137539,94275078,141412617
4647,TASA3,2013-12-31,2014-03-31,47137539,94275078,141412617
4648,TASA3,2014-03-31,2014-05-15,47137539,94275078,141412617
4649,TASA3,2014-06-30,2014-08-14,47137539,94275078,141412617
4650,TASA3,2014-09-30,2014-11-13,92832547,84751880,177584427
4651,TASA3,2014-12-31,2015-03-30,92832547,84751880,177584427
4652,TASA3,2015-03-31,2015-05-15,8439322,7704716,16144038
4653,TASA3,2015-06-30,2015-08-14,8439322,7704716,16144038
4654,TASA3,2015-09-30,2015-11-13,27446627,13001621,40448248
4655,TASA3,2015-12-31,2016-03-24,27446627,13001621,40448248
4656,TASA3,2016-03-31,2016-05-13,34581630,13001621,47583251
4657,TASA3,2016-06-30,2016-08-12,44642459,13636110,58278569
4658,TASA3,2016-09-30,2016-11-11,44642459,13636110,58278569
4659,TASA3,2016-12-31,2017-03-27,44642459,13636110,58278569
4660,TASA3,2017-03-31,2017-05-12,46445314,18242898,64688212
4661,TASA3,2017-06-30,2017-08-11,46445314,18242898,64688212
4662,TASA3,2017-09-30,2017-11-10,46445314,18242898,64688212
4663,TASA3,2017-12-31,2018-04-04,46445314,18242898,64688212
4664,TASA3,2018-03-31,2018-05-16,46445314,18242898,64688212
4665,TASA3,2018-06-30,2018-08-14,46445314,18242898,64688212
4666,TASA3,2018-09-30,2018-11-16,46445314,18242898,64688212
4667,TASA3,2018-12-31,2019-03-29,46445314,28417312,74862626
4668,TASA3,2019-03-31,2019-05-14,46445314,38823733,85269047
4669,TASA3,2019-06-30,2019-08-22,46445314,42014484,88459798
4670,TASA3,2019-09-30,2019-11-13,46445314,42015334,88460648
4671,TASA3,2019-12-31,2020-03-30,46445314,42019019,88464333
4672,TASA3,2020-03-31,2020-06-29,46445314,42042380,88487694
4673,TASA3,2020-06-30,2020-08-13,46445314,42043312,88488626
4674,TASA3,2020-09-30,2020-11-12,46445314,42609796,89055110
4675,TASA3,2020-09-30,2020-11-12,46445314,42609796,89055110
4676,TASA3,2020-12-31,2021-03-19,46445314,49684169,96129483
4677,TASA4,2010-12-31,2011-04-12,42745,85489,128234
4678,TASA4,2011-03-31,2011-05-13,42745,85489,128234
4679,TASA4,2011-06-30,2011-09-12,47019,94038,141057
4680,TASA4,2011-09-30,2011-11-11,47137539,94275078,141412617
4681,TASA4,2011-12-31,2012-03-27,47137539,94275078,141412617
4682,TASA4,2012-03-31,2012-05-14,47137539,94275078,141412617
4683,TASA4,2012-06-30,2014-03-28,47137539,94275078,141412617
4684,TASA4,2012-09-30,2014-03-28,47137539,94275078,141412617
4685,TASA4,2012-12-31,2014-03-28,47137539,94275078,141412617
4686,TASA4,2013-03-31,2014-03-28,47137539,94275078,141412617
4687,TASA4,2013-06-30,2014-03-28,47137539,94275078,141412617
4688,TASA4,2013-09-30,2014-03-28,47137539,94275078,141412617
4689,TASA4,2013-12-31,2014-03-31,47137539,94275078,141412617
4690,TASA4,2014-03-31,2014-05-15,47137539,94275078,141412617
4691,TASA4,2014-06-30,2014-08-14,47137539,94275078,141412617
4692,TASA4,2014-09-30,2014-11-13,92832547,84751880,177584427
4693,TASA4,2014-12-31,2015-03-30,92832547,84751880,177584427
4694,TASA4,2015-03-31,2015-05-15,8439322,7704716,16144038
4695,TASA4,2015-06-30,2015-08-14,8439322,7704716,16144038
4696,TASA4,2015-09-30,2015-11-13,27446627,13001621,40448248
4697,TASA4,2015-12-31,2016-03-24,27446627,13001621,40448248
4698,TASA4,2016-03-31,2016-05-13,34581630,13001621,47583251
4699,TASA4,2016-06-30,2016-08-12,44642459,13636110,58278569
4700,TASA4,2016-09-30,2016-11-11,44642459,13636110,58278569
4701,TASA4,2016-12-31,2017-03-27,44642459,13636110,58278569
4702,TASA4,2017-03-31,2017-05-12,46445314,18242898,64688212
4703,TASA4,2017-06-30,2017-08-11,46445314,18242898,64688212
4704,TASA4,2017-09-30,2017-11-10,46445314,18242898,64688212
4705,TASA4,2017-12-31,2018-04-04,46445314,18242898,64688212
4706,TASA4,2018-03-31,2018-05-16,46445314,18242898,64688212
4707,TASA4,2018-06-30,2018-08-14,46445314,18242898,64688212
4708,TASA4,2018-09-30,2018-11-16,46445314,18242898,64688212
4709,TASA4,2018-12-31,2019-03-29,46445314,28417312,74862626
4710,TASA4,2019-03-31,2019-05-14,46445314,38823733,85269047
4711,TASA4,2019-06-30,2019-08-22,46445314,42014484,88459798
4712,TASA4,2019-09-30,2019-11-13,46445314,42015334,88460648
4713,TASA4,2019-12-31,2020-03-30,46445314,42019019,88464333
4714,TASA4,2020-03-31,2020-06-29,46445314,42042380,88487694
4715,TASA4,2020-06-30,2020-08-13,46445314,42043312,88488626
4716,TASA4,2020-09-30,2020-11-12,46445314,42609796,89055110
4717,TASA4,2020-09-30,2020-11-12,46445314,42609796,89055110
4718,TASA4,2020-12-31,2021-03-19,46445314,49684169,96129483
4719,FRAS3,2010-12-31,2011-03-14,66174,36207,102381
4720,FRAS3,2011-03-31,2011-05-09,66175,36206,102381
4721,FRAS3,2011-06-30,2011-08-04,66174,36207,102381
4722,FRAS3,2011-09-30,2011-11-03,66174,36207,102381
4723,FRAS3,2011-12-31,2013-02-26,66174,36207,102381
4724,FRAS3,2012-03-31,2012-05-07,66174,36207,102381
4725,FRAS3,2012-06-30,2012-08-08,66174,36207,102381
4726,FRAS3,2012-09-30,2012-11-12,66174,36207,102381
4727,FRAS3,2012-12-31,2013-02-27,66174,36207,102381
4728,FRAS3,2013-03-31,2013-05-07,66174,36207,102381
4729,FRAS3,2013-06-30,2013-08-07,66174,36207,102381
4730,FRAS3,2013-09-30,2013-11-06,66174,36207,102381
4731,FRAS3,2013-12-31,2014-03-12,99981,0,99981
4732,FRAS3,2014-03-31,2014-05-07,124974,0,124974
4733,FRAS3,2014-06-30,2014-08-06,124973,0,124973
4734,FRAS3,2014-09-30,2014-11-05,124973,0,124973
4735,FRAS3,2014-12-31,2015-03-10,124974,0,124974
4736,FRAS3,2015-03-31,2015-05-12,121974,0,121974
4737,FRAS3,2015-06-30,2015-08-11,121974,0,121974
4738,FRAS3,2015-09-30,2015-11-10,121974,0,121974
4739,FRAS3,2015-12-31,2016-03-22,124974,0,124974
4740,FRAS3,2016-03-31,2016-05-19,121974,0,121974
4741,FRAS3,2016-06-30,2016-08-10,217566,0,217566
4742,FRAS3,2016-09-30,2016-11-09,217566,0,217566
4743,FRAS3,2016-12-31,2017-03-23,217566,0,217566
4744,FRAS3,2017-03-31,2017-05-09,217566,0,217566
4745,FRAS3,2017-06-30,2017-08-08,217566,0,217566
4746,FRAS3,2017-09-30,2017-11-07,217566,0,217566
4747,FRAS3,2017-12-31,2018-03-13,217566,0,217566
4748,FRAS3,2018-03-31,2018-05-09,217566,0,217566
4749,FRAS3,2018-06-30,2018-08-07,217566,0,217566
4750,FRAS3,2018-09-30,2018-11-07,217566,0,217566
4751,FRAS3,2018-12-31,2019-03-19,217566,0,217566
4752,FRAS3,2019-03-31,2019-05-08,217566,0,217566
4753,FRAS3,2019-06-30,2019-08-12,217566,0,217566
4754,FRAS3,2019-09-30,2019-11-12,217566,0,217566
4755,FRAS3,2019-12-31,2020-03-04,217566,0,217566
4756,FRAS3,2020-03-31,2020-06-03,217566,0,217566
4757,FRAS3,2020-06-30,2020-08-12,217566,0,217566
4758,FRAS3,2020-09-30,2020-11-11,217566,0,217566
4759,FRAS3,2020-12-31,2021-03-04,217566,0,217566
4760,TUPY3,2010-12-31,2011-03-29,56820,319,57139
4761,TUPY3,2011-03-31,2011-05-13,56820,319,57139
4762,TUPY3,2011-06-30,2011-08-12,56820,319,57139
4763,TUPY3,2011-09-30,2011-11-14,56820,319,57139
4764,TUPY3,2011-12-31,2013-02-15,56820,319,57139
4765,TUPY3,2012-03-31,2012-05-15,56820,319,57139
4766,TUPY3,2012-06-30,2012-08-15,56820,319,57139
4767,TUPY3,2012-09-30,2012-11-14,56820,319,57139
4768,TUPY3,2012-12-31,2013-03-25,114278,0,114278
4769,TUPY3,2013-03-31,2013-05-16,114278,0,114278
4770,TUPY3,2013-06-30,2013-09-25,114278,0,114278
4771,TUPY3,2013-09-30,2013-11-14,114278,0,114278
4772,TUPY3,2013-12-31,2014-03-10,144178,0,144178
4773,TUPY3,2014-03-31,2014-05-09,144178,0,144178
4774,TUPY3,2014-06-30,2014-08-25,144178,0,144178
4775,TUPY3,2014-09-30,2014-11-06,144178,0,144178
4776,TUPY3,2014-12-31,2015-02-26,144178,0,144178
4777,TUPY3,2015-03-31,2015-05-13,144178,0,144178
4778,TUPY3,2015-06-30,2015-08-12,144178,0,144178
4779,TUPY3,2015-09-30,2015-11-12,144178,0,144178
4780,TUPY3,2015-12-31,2016-03-03,144178,0,144178
4781,TUPY3,2016-03-31,2016-05-11,144178,0,144178
4782,TUPY3,2016-06-30,2016-08-04,144178,0,144178
4783,TUPY3,2016-09-30,2016-11-07,144178,0,144178
4784,TUPY3,2016-12-31,2017-03-28,144178,0,144178
4785,TUPY3,2017-03-31,2017-05-15,144178,0,144178
4786,TUPY3,2017-06-30,2017-08-14,144178,0,144178
4787,TUPY3,2017-09-30,2017-11-24,144178,0,144178
4788,TUPY3,2017-12-31,2018-03-13,144178,0,144178
4789,TUPY3,2018-03-31,2018-05-08,144178,0,144178
4790,TUPY3,2018-06-30,2018-08-07,144178,0,144178
4791,TUPY3,2018-09-30,2018-11-07,144178,0,144178
4792,TUPY3,2018-12-31,2019-03-14,144178,0,144178
4793,TUPY3,2019-03-31,2019-05-14,144178,0,144178
4794,TUPY3,2019-06-30,2019-08-14,144178,0,144178
4795,TUPY3,2019-09-30,2019-11-11,144178,0,144178
4796,TUPY3,2019-12-31,2020-03-03,144178,0,144178
4797,TUPY3,2020-03-31,2020-06-29,144178,0,144178
4798,TUPY3,2020-06-30,2020-08-12,144178,0,144178
4799,TUPY3,2020-09-30,2020-10-28,144178,0,144178
4800,TUPY3,2020-12-31,2021-03-04,144178,0,144178
4801,VVAR3,2010-12-31,2011-02-24,322688,0,322688
4802,VVAR3,2011-03-31,2011-05-13,322688,0,322688
4803,VVAR3,2011-06-30,2011-07-25,322688,0,322688
4804,VVAR3,2011-09-30,2011-11-03,322688,0,322688
4805,VVAR3,2011-12-31,2012-02-16,322688,0,322688
4806,VVAR3,2012-03-31,2012-05-07,322688,0,322688
4807,VVAR3,2012-06-30,2012-07-24,322688,0,322688
4808,VVAR3,2012-09-30,2012-10-31,322688,0,322688
4809,VVAR3,2012-12-31,2013-02-20,322688,0,322688
4810,VVAR3,2013-03-31,2013-04-29,322688,0,322688
4811,VVAR3,2013-06-30,2013-07-23,322688,0,322688
4812,VVAR3,2013-09-30,2013-10-16,322688,0,322688
4813,VVAR3,2013-12-31,2014-02-13,659165,631587,1290752
4814,VVAR3,2014-03-31,2014-04-28,659164,631587,1290751
4815,VVAR3,2014-06-30,2014-07-23,659164,631587,1290751
4816,VVAR3,2014-09-30,2014-10-29,659164,631587,1290751
4817,VVAR3,2014-12-31,2015-02-12,655825,634926,1290751
4818,VVAR3,2015-03-31,2016-10-26,655825,634926,1290751
4819,VVAR3,2015-06-30,2016-10-26,655825,634926,1290751
4820,VVAR3,2015-09-30,2016-10-26,655841,634958,1290799
4821,VVAR3,2015-12-31,2016-07-27,655870,635016,1290886
4822,VVAR3,2016-03-31,2016-08-22,655871,635019,1290890
4823,VVAR3,2016-06-30,2016-08-10,655882,635040,1290922
4824,VVAR3,2016-09-30,2016-10-26,655882,635040,1290922
4825,VVAR3,2016-12-31,2017-02-23,655939,635154,1291093
4826,VVAR3,2017-03-31,2017-04-26,655964,635204,1291168
4827,VVAR3,2017-06-30,2017-07-24,655973,635222,1291195
4828,VVAR3,2017-09-30,2017-10-25,656169,635614,1291783
4829,VVAR3,2017-12-31,2018-02-19,656230,635738,1291968
4830,VVAR3,2018-03-31,2018-04-25,656230,635738,1291968
4831,VVAR3,2018-06-30,2018-07-23,656262,635801,1292063
4832,VVAR3,2018-09-30,2018-10-24,656974,637226,1294200
4833,VVAR3,2018-12-31,2019-02-20,1294003,0,1294003
4834,VVAR3,2019-03-31,2019-08-14,1294050,0,1294050
4835,VVAR3,2019-06-30,2019-08-14,1294125,0,1294125
4836,VVAR3,2019-09-30,2019-11-13,1298864,0,1298864
4837,VVAR3,2019-12-31,2020-03-26,1299353,0,1299353
4838,VVAR3,2020-03-31,2020-05-26,1299715,0,1299715
4839,VVAR3,2020-06-30,2020-08-12,1596717,0,1596717
4840,VVAR3,2020-09-30,2020-11-11,1597017,0,1597017
4841,VVAR3,2020-12-31,2021-03-02,1597342,0,1597342
4842,HETA3,2010-12-31,2011-04-28,5136,10164,15300
4843,HETA3,2011-03-31,2011-06-28,5136,10164,15300
4844,HETA3,2011-06-30,2011-08-19,5136,10164,15300
4845,HETA3,2011-09-30,2011-11-14,5136,10164,15300
4846,HETA3,2011-12-31,2012-04-21,5135950,10164050,15300000
4847,HETA3,2012-03-31,2012-06-08,5135950,10164050,15300000
4848,HETA3,2012-06-30,2012-08-21,5135950,10164050,15300000
4849,HETA3,2012-09-30,2012-11-20,5135950,10164050,15300000
4850,HETA3,2012-12-31,2013-04-23,5135950,10164050,15300000
4851,HETA3,2013-03-31,2013-05-16,5135950,10164050,15300000
4852,HETA3,2013-06-30,2013-09-30,5135950,10164050,15300000
4853,HETA3,2013-09-30,2013-11-19,5135950,10164050,15300000
4854,HETA3,2013-12-31,2014-04-17,5135950,10164050,15300000
4855,HETA3,2014-03-31,2014-06-06,5135950,10164050,15300000
4856,HETA3,2014-06-30,2014-10-03,5135950,10164050,15300000
4857,HETA3,2014-09-30,2014-11-17,5135950,10164050,15300000
4858,HETA3,2014-12-31,2015-04-30,5135950,10164050,15300000
4859,HETA3,2015-03-31,2015-05-28,5135950,10164050,15300000
4860,HETA3,2015-06-30,2015-09-21,5135950,10164050,15300000
4861,HETA3,2015-09-30,2015-11-16,5135950,10164050,15300000
4862,HETA3,2015-12-31,2016-06-03,171198,338801,509999
4863,HETA3,2016-03-31,2016-06-29,171198,338801,509999
4864,HETA3,2016-06-30,2016-08-12,171198,338801,509999
4865,HETA3,2016-09-30,2016-11-14,171198,338801,509999
4866,HETA3,2016-12-31,2017-03-30,171198,338801,509999
4867,HETA3,2017-03-31,2017-05-15,171198,338801,509999
4868,HETA3,2017-06-30,2017-08-14,171198,338801,509999
4869,HETA3,2017-09-30,2017-11-14,171198,338801,509999
4870,HETA3,2017-12-31,2018-03-27,171198,338801,509999
4871,HETA3,2018-03-31,2018-05-15,171198,338801,509999
4872,HETA3,2018-06-30,2018-08-14,171198,338801,509999
4873,HETA3,2018-09-30,2018-11-14,171198,338801,509999
4874,HETA3,2018-12-31,2019-03-29,171198,338801,509999
4875,HETA3,2019-03-31,2019-05-15,171198,338801,509999
4876,HETA3,2019-06-30,2019-08-14,171198,338801,509999
4877,HETA3,2019-09-30,2019-11-14,171198,338801,509999
4878,HETA3,2019-12-31,2020-03-27,171198,338801,509999
4879,HETA3,2020-03-31,2020-06-29,171198,338801,509999
4880,HETA3,2020-06-30,2020-08-28,171198,338801,509999
4881,HETA3,2020-09-30,2020-11-13,171198,338801,509999
4882,HETA4,2010-12-31,2011-04-28,5136,10164,15300
4883,HETA4,2011-03-31,2011-06-28,5136,10164,15300
4884,HETA4,2011-06-30,2011-08-19,5136,10164,15300
4885,HETA4,2011-09-30,2011-11-14,5136,10164,15300
4886,HETA4,2011-12-31,2012-04-21,5135950,10164050,15300000
4887,HETA4,2012-03-31,2012-06-08,5135950,10164050,15300000
4888,HETA4,2012-06-30,2012-08-21,5135950,10164050,15300000
4889,HETA4,2012-09-30,2012-11-20,5135950,10164050,15300000
4890,HETA4,2012-12-31,2013-04-23,5135950,10164050,15300000
4891,HETA4,2013-03-31,2013-05-16,5135950,10164050,15300000
4892,HETA4,2013-06-30,2013-09-30,5135950,10164050,15300000
4893,HETA4,2013-09-30,2013-11-19,5135950,10164050,15300000
4894,HETA4,2013-12-31,2014-04-17,5135950,10164050,15300000
4895,HETA4,2014-03-31,2014-06-06,5135950,10164050,15300000
4896,HETA4,2014-06-30,2014-10-03,5135950,10164050,15300000
4897,HETA4,2014-09-30,2014-11-17,5135950,10164050,15300000
4898,HETA4,2014-12-31,2015-04-30,5135950,10164050,15300000
4899,HETA4,2015-03-31,2015-05-28,5135950,10164050,15300000
4900,HETA4,2015-06-30,2015-09-21,5135950,10164050,15300000
4901,HETA4,2015-09-30,2015-11-16,5135950,10164050,15300000
4902,HETA4,2015-12-31,2016-06-03,171198,338801,509999
4903,HETA4,2016-03-31,2016-06-29,171198,338801,509999
4904,HETA4,2016-06-30,2016-08-12,171198,338801,509999
4905,HETA4,2016-09-30,2016-11-14,171198,338801,509999
4906,HETA4,2016-12-31,2017-03-30,171198,338801,509999
4907,HETA4,2017-03-31,2017-05-15,171198,338801,509999
4908,HETA4,2017-06-30,2017-08-14,171198,338801,509999
4909,HETA4,2017-09-30,2017-11-14,171198,338801,509999
4910,HETA4,2017-12-31,2018-03-27,171198,338801,509999
4911,HETA4,2018-03-31,2018-05-15,171198,338801,509999
4912,HETA4,2018-06-30,2018-08-14,171198,338801,509999
4913,HETA4,2018-09-30,2018-11-14,171198,338801,509999
4914,HETA4,2018-12-31,2019-03-29,171198,338801,509999
4915,HETA4,2019-03-31,2019-05-15,171198,338801,509999
4916,HETA4,2019-06-30,2019-08-14,171198,338801,509999
4917,HETA4,2019-09-30,2019-11-14,171198,338801,509999
4918,HETA4,2019-12-31,2020-03-27,171198,338801,509999
4919,HETA4,2020-03-31,2020-06-29,171198,338801,509999
4920,HETA4,2020-06-30,2020-08-28,171198,338801,509999
4921,HETA4,2020-09-30,2020-11-13,171198,338801,509999
4922,HOOT3,2010-12-31,2011-06-07,104779,78945,183724
4923,HOOT3,2011-03-31,2011-06-28,104779,78945,183724
4924,HOOT3,2011-06-30,2011-08-15,104779,78945,183724
4925,HOOT3,2011-09-30,2011-11-09,104779,78945,183724
4926,HOOT3,2011-12-31,2012-03-31,104779,78945,183724
4927,HOOT3,2012-03-31,2012-06-11,104779,78945,183724
4928,HOOT3,2012-06-30,2012-08-15,104779,78945,183724
4929,HOOT3,2012-09-30,2012-11-14,104779,78945,183724
4930,HOOT3,2012-12-31,2013-04-01,104779,78945,183724
4931,HOOT3,2013-03-31,2013-05-15,104779,78945,183724
4932,HOOT3,2013-06-30,2013-08-13,104779,78945,183724
4933,HOOT3,2013-09-30,2013-11-13,104779,78945,183724
4934,HOOT3,2013-12-31,2014-03-28,104779,78945,183724
4935,HOOT3,2014-03-31,2014-05-14,104779,78945,183724
4936,HOOT3,2014-06-30,2014-08-13,104779,78945,183724
4937,HOOT3,2014-09-30,2014-11-14,104779,78945,183724
4938,HOOT3,2014-12-31,2015-03-31,104779,78945,183724
4939,HOOT3,2015-03-31,2015-05-13,104779,78945,183724
4940,HOOT3,2015-06-30,2015-08-12,104779,78945,183724
4941,HOOT3,2015-09-30,2015-11-12,10478,7894,18372
4942,HOOT3,2015-12-31,2016-03-30,10478,7894,18372
4943,HOOT3,2016-03-31,2016-05-13,10478,7894,18372
4944,HOOT3,2016-06-30,2016-08-11,10478,7894,18372
4945,HOOT3,2016-09-30,2016-11-11,10478,7894,18372
4946,HOOT3,2016-12-31,2017-03-28,10478,7894,18372
4947,HOOT3,2017-03-31,2017-05-12,10478,7894,18372
4948,HOOT3,2017-06-30,2017-08-09,10478,7894,18372
4949,HOOT3,2017-09-30,2017-11-13,10478,7894,18372
4950,HOOT3,2017-12-31,2018-03-28,10478,7894,18372
4951,HOOT3,2018-03-31,2018-05-11,10478,7894,18372
4952,HOOT3,2018-06-30,2018-08-13,10478,7894,18372
4953,HOOT3,2018-09-30,2018-11-12,10478,7894,18372
4954,HOOT3,2018-12-31,2019-03-29,10478,7894,18372
4955,HOOT3,2019-03-31,2019-05-14,10478,7894,18372
4956,HOOT3,2019-06-30,2019-08-14,10478,7894,18372
4957,HOOT3,2019-09-30,2019-11-13,10478,7894,18372
4958,HOOT3,2019-12-31,2020-03-24,10478,7894,18372
4959,HOOT3,2020-03-31,2020-06-26,10478,7894,18372
4960,HOOT3,2020-06-30,2020-08-26,10478,7894,18372
4961,HOOT3,2020-09-30,2020-11-12,10478,7894,18372
4962,HOOT4,2010-12-31,2011-06-07,104779,78945,183724
4963,HOOT4,2011-03-31,2011-06-28,104779,78945,183724
4964,HOOT4,2011-06-30,2011-08-15,104779,78945,183724
4965,HOOT4,2011-09-30,2011-11-09,104779,78945,183724
4966,HOOT4,2011-12-31,2012-03-31,104779,78945,183724
4967,HOOT4,2012-03-31,2012-06-11,104779,78945,183724
4968,HOOT4,2012-06-30,2012-08-15,104779,78945,183724
4969,HOOT4,2012-09-30,2012-11-14,104779,78945,183724
4970,HOOT4,2012-12-31,2013-04-01,104779,78945,183724
4971,HOOT4,2013-03-31,2013-05-15,104779,78945,183724
4972,HOOT4,2013-06-30,2013-08-13,104779,78945,183724
4973,HOOT4,2013-09-30,2013-11-13,104779,78945,183724
4974,HOOT4,2013-12-31,2014-03-28,104779,78945,183724
4975,HOOT4,2014-03-31,2014-05-14,104779,78945,183724
4976,HOOT4,2014-06-30,2014-08-13,104779,78945,183724
4977,HOOT4,2014-09-30,2014-11-14,104779,78945,183724
4978,HOOT4,2014-12-31,2015-03-31,104779,78945,183724
4979,HOOT4,2015-03-31,2015-05-13,104779,78945,183724
4980,HOOT4,2015-06-30,2015-08-12,104779,78945,183724
4981,HOOT4,2015-09-30,2015-11-12,10478,7894,18372
4982,HOOT4,2015-12-31,2016-03-30,10478,7894,18372
4983,HOOT4,2016-03-31,2016-05-13,10478,7894,18372
4984,HOOT4,2016-06-30,2016-08-11,10478,7894,18372
4985,HOOT4,2016-09-30,2016-11-11,10478,7894,18372
4986,HOOT4,2016-12-31,2017-03-28,10478,7894,18372
4987,HOOT4,2017-03-31,2017-05-12,10478,7894,18372
4988,HOOT4,2017-06-30,2017-08-09,10478,7894,18372
4989,HOOT4,2017-09-30,2017-11-13,10478,7894,18372
4990,HOOT4,2017-12-31,2018-03-28,10478,7894,18372
4991,HOOT4,2018-03-31,2018-05-11,10478,7894,18372
4992,HOOT4,2018-06-30,2018-08-13,10478,7894,18372
4993,HOOT4,2018-09-30,2018-11-12,10478,7894,18372
4994,HOOT4,2018-12-31,2019-03-29,10478,7894,18372
4995,HOOT4,2019-03-31,2019-05-14,10478,7894,18372
4996,HOOT4,2019-06-30,2019-08-14,10478,7894,18372
4997,HOOT4,2019-09-30,2019-11-13,10478,7894,18372
4998,HOOT4,2019-12-31,2020-03-24,10478,7894,18372
4999,HOOT4,2020-03-31,2020-06-26,10478,7894,18372
5000,HOOT4,2020-06-30,2020-08-26,10478,7894,18372
5001,HOOT4,2020-09-30,2020-11-12,10478,7894,18372
5002,IGBR3,2010-12-31,2011-04-27,12504967,0,12504967
5003,IGBR3,2011-03-31,2011-06-15,12504967,0,12504967
5004,IGBR3,2011-06-30,2011-08-03,12504967,0,12504967
5005,IGBR3,2011-09-30,2016-09-29,12504967,0,12504967
5006,IGBR3,2011-12-31,2013-11-26,12504967,0,12504967
5007,IGBR3,2012-03-31,2013-08-01,12504967,0,12504967
5008,IGBR3,2012-06-30,2013-08-01,12504967,0,12504967
5009,IGBR3,2012-09-30,2013-08-01,12504967,0,12504967
5010,IGBR3,2012-12-31,2013-11-27,12504967,0,12504967
5011,IGBR3,2013-03-31,2013-08-02,12504967,0,12504967
5012,IGBR3,2013-06-30,2013-12-11,12504967,0,12504967
5013,IGBR3,2013-09-30,2014-02-10,12504967,0,12504967
5014,IGBR3,2013-12-31,2014-04-29,12504967,0,12504967
5015,IGBR3,2014-03-31,2014-08-26,12504967,0,12504967
5016,IGBR3,2014-06-30,2014-09-19,12504967,0,12504967
5017,IGBR3,2014-09-30,2014-12-12,12504967,0,12504967
5018,IGBR3,2014-12-31,2015-11-21,12504967,0,12504967
5019,IGBR3,2015-03-31,2015-11-11,12504967,0,12504967
5020,IGBR3,2015-06-30,2015-11-21,12504967,0,12504967
5021,IGBR3,2015-09-30,2015-12-24,12504967,0,12504967
5022,IGBR3,2015-12-31,2016-05-19,12504967,0,12504967
5023,IGBR3,2016-03-31,2016-10-07,12504967,0,12504967
5024,IGBR3,2016-06-30,2016-10-07,12504967,0,12504967
5025,IGBR3,2016-09-30,2016-11-21,12504967,0,12504967
5026,IGBR3,2016-12-31,2017-03-30,12504967,0,12504967
5027,IGBR3,2017-03-31,2017-05-15,12504967,0,12504967
5028,IGBR3,2017-06-30,2017-08-16,12504967,0,12504967
5029,IGBR3,2017-09-30,2017-11-14,12504967,0,12504967
5030,IGBR3,2017-12-31,2018-04-03,12504967,0,12504967
5031,IGBR3,2018-03-31,2018-05-18,12504967,0,12504967
5032,IGBR3,2018-06-30,2018-08-20,12504967,0,12504967
5033,IGBR3,2018-09-30,2018-11-14,12504967,0,12504967
5034,IGBR3,2018-12-31,2019-04-08,12504967,0,12504967
5035,IGBR3,2019-03-31,2019-05-24,12504967,0,12504967
5036,IGBR3,2019-06-30,2019-08-14,12504967,0,12504967
5037,IGBR3,2019-09-30,2019-11-14,12504967,0,12504967
5038,IGBR3,2019-12-31,2020-03-31,12504967,0,12504967
5039,IGBR3,2020-03-31,2020-07-08,12504967,0,12504967
5040,IGBR3,2020-06-30,2020-09-25,12504967,0,12504967
5041,IGBR3,2020-09-30,2020-11-01,12504967,0,12504967
5042,ROMI3,2010-12-31,2011-04-14,74758,0,74758
5043,ROMI3,2011-03-31,2011-04-27,74757547,0,74757547
5044,ROMI3,2011-06-30,2011-07-26,74757547,0,74757547
5045,ROMI3,2011-09-30,2011-10-25,74757547,0,74757547
5046,ROMI3,2011-12-31,2012-03-06,74757547,0,74757547
5047,ROMI3,2012-03-31,2012-04-24,74757547,0,74757547
5048,ROMI3,2012-06-30,2012-07-25,74757547,0,74757547
5049,ROMI3,2012-09-30,2012-10-23,74757547,0,74757547
5050,ROMI3,2012-12-31,2013-02-19,74757547,0,74757547
5051,ROMI3,2013-03-31,2013-04-23,71757647,0,71757647
5052,ROMI3,2013-06-30,2013-08-06,71757647,0,71757647
5053,ROMI3,2013-09-30,2013-10-22,71757647,0,71757647
5054,ROMI3,2013-12-31,2014-02-11,71757647,0,71757647
5055,ROMI3,2014-03-31,2014-04-29,71757647,0,71757647
5056,ROMI3,2014-06-30,2014-07-29,71757647,0,71757647
5057,ROMI3,2014-09-30,2014-10-21,71757647,0,71757647
5058,ROMI3,2014-12-31,2015-02-10,71757647,0,71757647
5059,ROMI3,2015-03-31,2015-04-28,68757647,0,68757647
5060,ROMI3,2015-06-30,2015-07-28,68757647,0,68757647
5061,ROMI3,2015-09-30,2015-10-27,68757647,0,68757647
5062,ROMI3,2015-12-31,2016-02-16,68757647,0,68757647
5063,ROMI3,2016-03-31,2016-04-26,68757647,0,68757647
5064,ROMI3,2016-06-30,2016-07-26,65657647,0,65657647
5065,ROMI3,2016-09-30,2016-10-25,62857647,0,62857647
5066,ROMI3,2016-12-31,2017-02-07,62857647,0,62857647
5067,ROMI3,2017-03-31,2017-04-25,62857647,0,62857647
5068,ROMI3,2017-06-30,2017-07-28,62857647,0,62857647
5069,ROMI3,2017-09-30,2017-10-24,62857647,0,62857647
5070,ROMI3,2017-12-31,2018-02-08,62857647,0,62857647
5071,ROMI3,2018-03-31,2018-04-17,62857647,0,62857647
5072,ROMI3,2018-06-30,2018-07-25,62857647,0,62857647
5073,ROMI3,2018-09-30,2018-10-23,62857647,0,62857647
5074,ROMI3,2018-12-31,2019-02-12,62857647,0,62857647
5075,ROMI3,2019-03-31,2019-04-23,62857647,0,62857647
5076,ROMI3,2019-06-30,2019-07-23,62857647,0,62857647
5077,ROMI3,2019-09-30,2019-10-22,62857647,0,62857647
5078,ROMI3,2019-12-31,2020-02-11,62857647,0,62857647
5079,ROMI3,2020-03-31,2020-04-28,62857647,0,62857647
5080,ROMI3,2020-06-30,2020-07-21,62857647,0,62857647
5081,ROMI3,2020-09-30,2020-10-20,62857647,0,62857647
5082,ROMI3,2020-12-31,2021-02-09,73333922,0,73333922
5083,TXRX3,2010-12-31,2011-04-06,14566031,28026779,42592810
5084,TXRX3,2011-03-31,2011-05-16,14566031,28026779,42592810
5085,TXRX3,2011-06-30,2011-09-07,14566031,28026779,42592810
5086,TXRX3,2011-09-30,2011-11-21,14566,28027,42593
5087,TXRX3,2011-12-31,2012-03-30,14566,28027,42593
5088,TXRX3,2012-03-31,2012-05-14,14566,28026,42592
5089,TXRX3,2012-06-30,2012-08-14,14566,28026,42592
5090,TXRX3,2012-09-30,2012-11-14,14566,28026,42592
5091,TXRX3,2012-12-31,2013-03-27,14566,28026,42592
5092,TXRX3,2013-03-31,2013-11-14,14566,28026,42592
5093,TXRX3,2013-06-30,2013-11-14,14566,28027,42593
5094,TXRX3,2013-09-30,2013-11-18,14566,28027,42593
5095,TXRX3,2013-12-31,2014-04-01,14566,28026,42592
5096,TXRX3,2014-03-31,2014-05-14,14566,28027,42593
5097,TXRX3,2014-06-30,2014-08-14,14566,28027,42593
5098,TXRX3,2014-09-30,2014-11-14,14566,28027,42593
5099,TXRX3,2014-12-31,2015-03-30,14556,28026,42582
5100,TXRX3,2015-03-31,2015-05-14,14566,28027,42593
5101,TXRX3,2015-06-30,2015-08-13,14566,28027,42593
5102,TXRX3,2015-09-30,2015-11-30,14566,28027,42593
5103,TXRX3,2015-12-31,2016-04-01,14556,28026,42582
5104,TXRX3,2016-03-31,2016-05-13,14566,28027,42593
5105,TXRX3,2016-06-30,2016-08-12,1456,2803,4259
5106,TXRX3,2016-09-30,2016-11-11,1456,2803,4259
5107,TXRX3,2016-12-31,2017-03-29,1456,2803,4259
5108,TXRX3,2017-03-31,2017-05-15,1456,2803,4259
5109,TXRX3,2017-06-30,2017-08-15,1456,2803,4259
5110,TXRX3,2017-09-30,2017-11-16,1456,2803,4259
5111,TXRX3,2017-12-31,2018-03-26,1456,2803,4259
5112,TXRX3,2018-03-31,2018-05-14,1456,2803,4259
5113,TXRX3,2018-06-30,2018-08-15,1456,2803,4259
5114,TXRX3,2018-09-30,2018-11-14,1456,2803,4259
5115,TXRX3,2018-12-31,2019-03-28,1456,2803,4259
5116,TXRX3,2019-03-31,2019-05-17,1456,2803,4259
5117,TXRX3,2019-06-30,2019-08-12,1456,2803,4259
5118,TXRX3,2019-09-30,2019-11-11,1456,2803,4259
5119,TXRX3,2019-12-31,2020-03-31,1456,2803,4259
5120,TXRX3,2020-03-31,2020-07-09,1456,2803,4259
5121,TXRX3,2020-06-30,2020-08-28,1456,2803,4259
5122,TXRX3,2020-09-30,2020-11-16,1456,2803,4259
5123,TXRX3,2020-12-31,2021-03-26,1456,2803,4259
5124,TXRX4,2010-12-31,2011-04-06,14566031,28026779,42592810
5125,TXRX4,2011-03-31,2011-05-16,14566031,28026779,42592810
5126,TXRX4,2011-06-30,2011-09-07,14566031,28026779,42592810
5127,TXRX4,2011-09-30,2011-11-21,14566,28027,42593
5128,TXRX4,2011-12-31,2012-03-30,14566,28027,42593
5129,TXRX4,2012-03-31,2012-05-14,14566,28026,42592
5130,TXRX4,2012-06-30,2012-08-14,14566,28026,42592
5131,TXRX4,2012-09-30,2012-11-14,14566,28026,42592
5132,TXRX4,2012-12-31,2013-03-27,14566,28026,42592
5133,TXRX4,2013-03-31,2013-11-14,14566,28026,42592
5134,TXRX4,2013-06-30,2013-11-14,14566,28027,42593
5135,TXRX4,2013-09-30,2013-11-18,14566,28027,42593
5136,TXRX4,2013-12-31,2014-04-01,14566,28026,42592
5137,TXRX4,2014-03-31,2014-05-14,14566,28027,42593
5138,TXRX4,2014-06-30,2014-08-14,14566,28027,42593
5139,TXRX4,2014-09-30,2014-11-14,14566,28027,42593
5140,TXRX4,2014-12-31,2015-03-30,14556,28026,42582
5141,TXRX4,2015-03-31,2015-05-14,14566,28027,42593
5142,TXRX4,2015-06-30,2015-08-13,14566,28027,42593
5143,TXRX4,2015-09-30,2015-11-30,14566,28027,42593
5144,TXRX4,2015-12-31,2016-04-01,14556,28026,42582
5145,TXRX4,2016-03-31,2016-05-13,14566,28027,42593
5146,TXRX4,2016-06-30,2016-08-12,1456,2803,4259
5147,TXRX4,2016-09-30,2016-11-11,1456,2803,4259
5148,TXRX4,2016-12-31,2017-03-29,1456,2803,4259
5149,TXRX4,2017-03-31,2017-05-15,1456,2803,4259
5150,TXRX4,2017-06-30,2017-08-15,1456,2803,4259
5151,TXRX4,2017-09-30,2017-11-16,1456,2803,4259
5152,TXRX4,2017-12-31,2018-03-26,1456,2803,4259
5153,TXRX4,2018-03-31,2018-05-14,1456,2803,4259
5154,TXRX4,2018-06-30,2018-08-15,1456,2803,4259
5155,TXRX4,2018-09-30,2018-11-14,1456,2803,4259
5156,TXRX4,2018-12-31,2019-03-28,1456,2803,4259
5157,TXRX4,2019-03-31,2019-05-17,1456,2803,4259
5158,TXRX4,2019-06-30,2019-08-12,1456,2803,4259
5159,TXRX4,2019-09-30,2019-11-11,1456,2803,4259
5160,TXRX4,2019-12-31,2020-03-31,1456,2803,4259
5161,TXRX4,2020-03-31,2020-07-09,1456,2803,4259
5162,TXRX4,2020-06-30,2020-08-28,1456,2803,4259
5163,TXRX4,2020-09-30,2020-11-16,1456,2803,4259
5164,TXRX4,2020-12-31,2021-03-26,1456,2803,4259
5165,INEP3,2010-12-31,2011-04-29,37165,58495,95660
5166,INEP3,2011-03-31,2011-05-16,37165,58495,95660
5167,INEP3,2011-06-30,2011-08-15,37165,58495,95660
5168,INEP3,2011-09-30,2011-11-16,37165,58495,95660
5169,INEP3,2011-12-31,2012-04-02,37165,58495,95660
5170,INEP3,2012-03-31,2012-05-18,37165,58495,95660
5171,INEP3,2012-06-30,2012-08-15,39892,63136,103028
5172,INEP3,2012-09-30,2012-11-14,39892,63136,103028
5173,INEP3,2012-12-31,2013-04-09,37165,58495,95660
5174,INEP3,2013-03-31,2013-05-15,37165,58495,95660
5175,INEP3,2013-06-30,2013-08-15,39892,63136,103028
5176,INEP3,2013-09-30,2013-11-14,39892,63136,103028
5177,INEP3,2013-12-31,2014-03-28,39892,63136,103028
5178,INEP3,2014-03-31,2014-05-15,39892,63136,103028
5179,INEP3,2014-06-30,2014-08-14,39892,63136,103028
5180,INEP3,2014-09-30,2014-11-18,39892,63136,103028
5181,INEP3,2014-12-31,2015-05-12,39892,63136,103028
5182,INEP3,2015-03-31,2015-07-02,39892,63136,103028
5183,INEP3,2015-06-30,2015-08-28,39892,63136,103028
5184,INEP3,2015-09-30,2015-12-18,39892,63136,103028
5185,INEP3,2015-12-31,2016-06-16,86124,63136,149260
5186,INEP3,2016-03-31,2016-11-30,86124,63136,149260
5187,INEP3,2016-06-30,2016-11-30,86124,63136,149260
5188,INEP3,2016-09-30,2016-12-27,86124,63136,149260
5189,INEP3,2016-12-31,2018-01-30,86124,63136,149260
5190,INEP3,2017-03-31,2018-03-08,86124,63136,149260
5191,INEP3,2017-06-30,2018-03-12,86124,63136,149260
5192,INEP3,2017-09-30,2018-04-27,86124,63136,149260
5193,INEP3,2017-12-31,2018-07-09,3181,3157,6338
5194,INEP3,2018-03-31,2018-08-28,3181,3157,6338
5195,INEP3,2018-06-30,2018-10-01,3181,3157,6338
5196,INEP3,2018-09-30,2018-11-14,3181,3157,6338
5197,INEP3,2018-12-31,2019-06-26,4320,3157,7477
5198,INEP3,2019-03-31,2019-07-24,4414,3157,7571
5199,INEP3,2019-06-30,2019-09-06,4414,3157,7571
5200,INEP3,2019-09-30,2019-12-11,4812,3157,7969
5201,INEP3,2019-12-31,2020-07-15,4812,3157,7969
5202,INEP3,2020-03-31,2020-10-16,4812,3157,7969
5203,INEP3,2020-06-30,2020-12-14,5047,3157,8204
5204,INEP3,2020-09-30,2020-12-18,5047,3157,8204
5205,INEP4,2010-12-31,2011-04-29,37165,58495,95660
5206,INEP4,2011-03-31,2011-05-16,37165,58495,95660
5207,INEP4,2011-06-30,2011-08-15,37165,58495,95660
5208,INEP4,2011-09-30,2011-11-16,37165,58495,95660
5209,INEP4,2011-12-31,2012-04-02,37165,58495,95660
5210,INEP4,2012-03-31,2012-05-18,37165,58495,95660
5211,INEP4,2012-06-30,2012-08-15,39892,63136,103028
5212,INEP4,2012-09-30,2012-11-14,39892,63136,103028
5213,INEP4,2012-12-31,2013-04-09,37165,58495,95660
5214,INEP4,2013-03-31,2013-05-15,37165,58495,95660
5215,INEP4,2013-06-30,2013-08-15,39892,63136,103028
5216,INEP4,2013-09-30,2013-11-14,39892,63136,103028
5217,INEP4,2013-12-31,2014-03-28,39892,63136,103028
5218,INEP4,2014-03-31,2014-05-15,39892,63136,103028
5219,INEP4,2014-06-30,2014-08-14,39892,63136,103028
5220,INEP4,2014-09-30,2014-11-18,39892,63136,103028
5221,INEP4,2014-12-31,2015-05-12,39892,63136,103028
5222,INEP4,2015-03-31,2015-07-02,39892,63136,103028
5223,INEP4,2015-06-30,2015-08-28,39892,63136,103028
5224,INEP4,2015-09-30,2015-12-18,39892,63136,103028
5225,INEP4,2015-12-31,2016-06-16,86124,63136,149260
5226,INEP4,2016-03-31,2016-11-30,86124,63136,149260
5227,INEP4,2016-06-30,2016-11-30,86124,63136,149260
5228,INEP4,2016-09-30,2016-12-27,86124,63136,149260
5229,INEP4,2016-12-31,2018-01-30,86124,63136,149260
5230,INEP4,2017-03-31,2018-03-08,86124,63136,149260
5231,INEP4,2017-06-30,2018-03-12,86124,63136,149260
5232,INEP4,2017-09-30,2018-04-27,86124,63136,149260
5233,INEP4,2017-12-31,2018-07-09,3181,3157,6338
5234,INEP4,2018-03-31,2018-08-28,3181,3157,6338
5235,INEP4,2018-06-30,2018-10-01,3181,3157,6338
5236,INEP4,2018-09-30,2018-11-14,3181,3157,6338
5237,INEP4,2018-12-31,2019-06-26,4320,3157,7477
5238,INEP4,2019-03-31,2019-07-24,4414,3157,7571
5239,INEP4,2019-06-30,2019-09-06,4414,3157,7571
5240,INEP4,2019-09-30,2019-12-11,4812,3157,7969
5241,INEP4,2019-12-31,2020-07-15,4812,3157,7969
5242,INEP4,2020-03-31,2020-10-16,4812,3157,7969
5243,INEP4,2020-06-30,2020-12-14,5047,3157,8204
5244,INEP4,2020-09-30,2020-12-18,5047,3157,8204
5245,ITSA3,2010-12-31,2011-03-29,1680796,2693485,4374281
5246,ITSA3,2011-03-31,2011-05-10,1680796,2693485,4374281
5247,ITSA3,2011-06-30,2011-08-09,1696627,2718855,4415482
5248,ITSA3,2011-09-30,2011-11-08,1696627,2718855,4415482
5249,ITSA3,2011-12-31,2012-02-29,1696627,2718855,4415482
5250,ITSA3,2012-03-31,2012-05-04,1696627,2718855,4415482
5251,ITSA3,2012-06-30,2012-08-07,1866290,2981170,4847460
5252,ITSA3,2012-09-30,2012-10-30,1866290,2981170,4847460
5253,ITSA3,2012-12-31,2013-03-05,1866290,2981170,4847460
5254,ITSA3,2013-03-31,2013-05-07,1866290,2981170,4847460
5255,ITSA3,2013-06-30,2013-08-06,2106227,3364440,5470667
5256,ITSA3,2013-09-30,2013-11-05,2106227,3364440,5470667
5257,ITSA3,2013-12-31,2014-02-19,2106227,3364440,5470667
5258,ITSA3,2014-03-31,2014-05-07,2106227,3364440,5470667
5259,ITSA3,2014-06-30,2014-08-12,2352424,3757710,6110134
5260,ITSA3,2014-09-30,2014-11-04,2352424,3757710,6110134
5261,ITSA3,2014-12-31,2015-02-10,2352424,3757710,6110134
5262,ITSA3,2015-03-31,2015-05-12,2352424,3757710,6110134
5263,ITSA3,2015-06-30,2015-08-19,2597547,4161252,6758799
5264,ITSA3,2015-09-30,2015-11-10,2597547,4161252,6758799
5265,ITSA3,2015-12-31,2016-02-19,2597547,4161252,6758799
5266,ITSA3,2016-03-31,2016-05-10,2597547,4161252,6758799
5267,ITSA3,2016-06-30,2016-08-09,2854931,4575177,7430108
5268,ITSA3,2016-09-30,2016-11-08,2854931,4575177,7430108
5269,ITSA3,2016-12-31,2017-02-14,2854931,4575177,7430108
5270,ITSA3,2017-03-31,2017-05-05,2828112,4575177,7403289
5271,ITSA3,2017-06-30,2017-08-10,2874454,4650146,7524600
5272,ITSA3,2017-09-30,2017-11-07,2823484,4650146,7473630
5273,ITSA3,2017-12-31,2018-02-19,2823484,4650146,7473630
5274,ITSA3,2018-03-31,2018-05-15,2823484,4650146,7473630
5275,ITSA3,2018-06-30,2018-08-14,2889840,5524358,8414198
5276,ITSA3,2018-09-30,2018-11-13,2889840,5524358,8414198
5277,ITSA3,2018-12-31,2019-02-19,2889840,5520858,8410698
5278,ITSA3,2019-03-31,2019-05-13,2889840,5520858,8410698
5279,ITSA3,2019-06-30,2019-08-12,2889840,5520977,8410817
5280,ITSA3,2019-09-30,2019-11-11,2889838,5520977,8410815
5281,ITSA3,2019-12-31,2020-02-17,2889838,5520977,8410815
5282,ITSA3,2020-03-31,2020-05-11,2889838,5520977,8410815
5283,ITSA3,2020-06-30,2020-08-10,2889838,5520977,8410815
5284,ITSA3,2020-09-30,2020-11-09,2889838,5520977,8410815
5285,ITSA3,2020-12-31,2021-02-22,2889838,5520977,8410815
5286,ITSA4,2010-12-31,2011-03-29,1680796,2693485,4374281
5287,ITSA4,2011-03-31,2011-05-10,1680796,2693485,4374281
5288,ITSA4,2011-06-30,2011-08-09,1696627,2718855,4415482
5289,ITSA4,2011-09-30,2011-11-08,1696627,2718855,4415482
5290,ITSA4,2011-12-31,2012-02-29,1696627,2718855,4415482
5291,ITSA4,2012-03-31,2012-05-04,1696627,2718855,4415482
5292,ITSA4,2012-06-30,2012-08-07,1866290,2981170,4847460
5293,ITSA4,2012-09-30,2012-10-30,1866290,2981170,4847460
5294,ITSA4,2012-12-31,2013-03-05,1866290,2981170,4847460
5295,ITSA4,2013-03-31,2013-05-07,1866290,2981170,4847460
5296,ITSA4,2013-06-30,2013-08-06,2106227,3364440,5470667
5297,ITSA4,2013-09-30,2013-11-05,2106227,3364440,5470667
5298,ITSA4,2013-12-31,2014-02-19,2106227,3364440,5470667
5299,ITSA4,2014-03-31,2014-05-07,2106227,3364440,5470667
5300,ITSA4,2014-06-30,2014-08-12,2352424,3757710,6110134
5301,ITSA4,2014-09-30,2014-11-04,2352424,3757710,6110134
5302,ITSA4,2014-12-31,2015-02-10,2352424,3757710,6110134
5303,ITSA4,2015-03-31,2015-05-12,2352424,3757710,6110134
5304,ITSA4,2015-06-30,2015-08-19,2597547,4161252,6758799
5305,ITSA4,2015-09-30,2015-11-10,2597547,4161252,6758799
5306,ITSA4,2015-12-31,2016-02-19,2597547,4161252,6758799
5307,ITSA4,2016-03-31,2016-05-10,2597547,4161252,6758799
5308,ITSA4,2016-06-30,2016-08-09,2854931,4575177,7430108
5309,ITSA4,2016-09-30,2016-11-08,2854931,4575177,7430108
5310,ITSA4,2016-12-31,2017-02-14,2854931,4575177,7430108
5311,ITSA4,2017-03-31,2017-05-05,2828112,4575177,7403289
5312,ITSA4,2017-06-30,2017-08-10,2874454,4650146,7524600
5313,ITSA4,2017-09-30,2017-11-07,2823484,4650146,7473630
5314,ITSA4,2017-12-31,2018-02-19,2823484,4650146,7473630
5315,ITSA4,2018-03-31,2018-05-15,2823484,4650146,7473630
5316,ITSA4,2018-06-30,2018-08-14,2889840,5524358,8414198
5317,ITSA4,2018-09-30,2018-11-13,2889840,5524358,8414198
5318,ITSA4,2018-12-31,2019-02-19,2889840,5520858,8410698
5319,ITSA4,2019-03-31,2019-05-13,2889840,5520858,8410698
5320,ITSA4,2019-06-30,2019-08-12,2889840,5520977,8410817
5321,ITSA4,2019-09-30,2019-11-11,2889838,5520977,8410815
5322,ITSA4,2019-12-31,2020-02-17,2889838,5520977,8410815
5323,ITSA4,2020-03-31,2020-05-11,2889838,5520977,8410815
5324,ITSA4,2020-06-30,2020-08-10,2889838,5520977,8410815
5325,ITSA4,2020-09-30,2020-11-09,2889838,5520977,8410815
5326,ITSA4,2020-12-31,2021-02-22,2889838,5520977,8410815
5327,JFEN3,2010-12-31,2011-03-29,100000000,0,100000000
5328,JFEN3,2011-03-31,2012-05-15,100000000,0,100000000
5329,JFEN3,2011-06-30,2012-08-16,100000000,0,100000000
5330,JFEN3,2011-09-30,2012-08-16,100000000,0,100000000
5331,JFEN3,2011-12-31,2012-04-10,100000000,0,100000000
5332,JFEN3,2012-03-31,2012-07-23,100000000,0,100000000
5333,JFEN3,2012-06-30,2012-08-16,101800000,0,101800000
5334,JFEN3,2012-09-30,2012-11-14,136800000,0,136800000
5335,JFEN3,2012-12-31,2013-11-18,135060000,0,135060000
5336,JFEN3,2013-03-31,2013-06-06,135060000,0,135060000
5337,JFEN3,2013-06-30,2013-08-14,137770363,0,137770363
5338,JFEN3,2013-09-30,2013-11-13,177770363,0,177770363
5339,JFEN3,2013-12-31,2014-05-15,177770363,0,177770363
5340,JFEN3,2014-03-31,2014-05-22,177770363,0,177770363
5341,JFEN3,2014-06-30,2014-08-14,177770363,0,177770363
5342,JFEN3,2014-09-30,2014-11-13,177770363,0,177770363
5343,JFEN3,2014-12-31,2015-03-31,240928258,0,240928258
5344,JFEN3,2015-03-31,2015-05-15,240928528,0,240928528
5345,JFEN3,2015-06-30,2015-08-14,240928528,0,240928528
5346,JFEN3,2015-09-30,2015-11-13,315928258,0,315928258
5347,JFEN3,2015-12-31,2016-04-01,315928258,0,315928258
5348,JFEN3,2016-03-31,2016-05-13,315928258,0,315928258
5349,JFEN3,2016-06-30,2016-08-13,315928258,0,315928258
5350,JFEN3,2016-09-30,2016-11-11,315928258,0,315928258
5351,JFEN3,2016-12-31,2017-03-28,315928258,0,315928258
5352,JFEN3,2017-03-31,2017-05-15,315928258,0,315928258
5353,JFEN3,2017-06-30,2017-08-11,315928258,0,315928258
5354,JFEN3,2017-09-30,2017-11-14,540261204,0,540261204
5355,JFEN3,2017-12-31,2018-03-28,540261204,0,540261204
5356,JFEN3,2018-03-31,2018-05-16,1052038158,0,1052038158
5357,JFEN3,2018-06-30,2018-08-13,105203815,0,105203815
5358,JFEN3,2018-09-30,2018-11-12,105203815,0,105203815
5359,JFEN3,2018-12-31,2019-06-07,105203815,0,105203815
5360,JFEN3,2019-03-31,2020-10-02,105203815,0,105203815
5361,JFEN3,2019-06-30,2020-10-15,105203815,0,105203815
5362,JFEN3,2019-09-30,2020-10-27,105203815,0,105203815
5363,JFEN3,2019-12-31,2021-02-08,105203815,0,105203815
5364,JFEN3,2020-03-31,2021-02-12,105203815,0,105203815
5365,JFEN3,2020-06-30,2021-02-19,105203815,0,105203815
5366,JFEN3,2020-09-30,2021-02-25,105203815,0,105203815
5367,KEPL3,2010-12-31,2011-03-28,1308211,1061,1309272
5368,KEPL3,2011-03-31,2011-05-12,1308213508,1060410,1309273918
5369,KEPL3,2011-06-30,2011-08-15,1308319,954,1309273
5370,KEPL3,2011-09-30,2011-12-20,1308321,951,1309272
5371,KEPL3,2011-12-31,2012-03-15,1308320,951,1309271
5372,KEPL3,2012-03-31,2012-05-11,1309235,0,1309235
5373,KEPL3,2012-06-30,2012-08-13,1309235,0,1309235
5374,KEPL3,2012-09-30,2012-11-14,26185,0,26185
5375,KEPL3,2012-12-31,2013-03-14,26185,0,26185
5376,KEPL3,2013-03-31,2013-05-10,26185,0,26185
5377,KEPL3,2013-06-30,2013-08-15,26185,0,26185
5378,KEPL3,2013-09-30,2013-11-11,26185,0,26185
5379,KEPL3,2013-12-31,2014-03-24,26185,0,26185
5380,KEPL3,2014-03-31,2014-05-12,26185,0,26185
5381,KEPL3,2014-06-30,2014-08-15,26186,0,26186
5382,KEPL3,2014-09-30,2014-11-13,26309,0,26309
5383,KEPL3,2014-12-31,2015-03-20,26309,0,26309
5384,KEPL3,2015-03-31,2015-05-11,26309,0,26309
5385,KEPL3,2015-06-30,2015-08-14,26312,0,26312
5386,KEPL3,2015-09-30,2015-11-13,26312,0,26312
5387,KEPL3,2015-12-31,2016-03-18,26312,0,26312
5388,KEPL3,2016-03-31,2016-05-13,26312,0,26312
5389,KEPL3,2016-06-30,2016-08-12,26312,0,26312
5390,KEPL3,2016-09-30,2016-11-11,26312,0,26312
5391,KEPL3,2016-12-31,2017-03-17,26312,0,26312
5392,KEPL3,2017-03-31,2017-05-12,26312,0,26312
5393,KEPL3,2017-06-30,2017-08-11,26312,0,26312
5394,KEPL3,2017-09-30,2017-11-14,26312,0,26312
5395,KEPL3,2017-12-31,2018-03-23,26312,0,26312
5396,KEPL3,2018-03-31,2018-05-10,26312,0,26312
5397,KEPL3,2018-06-30,2018-08-09,26312,0,26312
5398,KEPL3,2018-09-30,2018-11-08,26312,0,26312
5399,KEPL3,2018-12-31,2019-03-20,26312,0,26312
5400,KEPL3,2019-03-31,2019-05-08,26312,0,26312
5401,KEPL3,2019-06-30,2019-08-08,26312,0,26312
5402,KEPL3,2019-09-30,2019-11-07,26312,0,26312
5403,KEPL3,2019-12-31,2021-03-12,26312,0,26312
5404,KEPL3,2020-03-31,2020-05-14,26312,0,26312
5405,KEPL3,2020-06-30,2020-08-13,26312,0,26312
5406,KEPL3,2020-09-30,2020-11-11,26312,0,26312
5407,KEPL3,2020-12-31,2021-02-24,26312,0,26312
5408,LAME3,2010-12-31,2011-06-21,281689106,476613879,758302985
5409,LAME3,2011-03-31,2011-06-21,287098878,485767134,772866012
5410,LAME3,2011-06-30,2011-08-04,287098878,486700787,773799665
5411,LAME3,2011-09-30,2011-11-10,287098878,487872832,774971710
5412,LAME3,2011-12-31,2012-03-06,287098878,487872832,774971710
5413,LAME3,2012-03-31,2012-05-08,287098878,487872832,774971710
5414,LAME3,2012-06-30,2012-08-14,367025080,625057273,992082353
5415,LAME3,2012-09-30,2012-11-13,367025080,625068830,992093910
5416,LAME3,2012-12-31,2013-03-18,367025080,625068830,992093910
5417,LAME3,2013-03-31,2013-05-09,367025080,625068830,992093910
5418,LAME3,2013-06-30,2013-08-14,367025080,625068830,992093910
5419,LAME3,2013-09-30,2013-11-13,367025080,626638720,993663800
5420,LAME3,2013-12-31,2014-03-19,367025080,626706258,993731338
5421,LAME3,2014-03-31,2014-05-08,361671082,608448687,970119769
5422,LAME3,2014-06-30,2014-08-13,452088853,763052048,1215140901
5423,LAME3,2014-09-30,2014-11-12,452088853,763095114,1215183967
5424,LAME3,2014-12-31,2015-03-18,452088853,763128273,1215217126
5425,LAME3,2015-03-31,2015-05-07,448742605,749700733,1198443338
5426,LAME3,2015-06-30,2015-08-13,448742605,751593250,1200335855
5427,LAME3,2015-09-30,2015-11-12,448742605,751732507,1200475112
5428,LAME3,2015-12-31,2016-03-16,448742605,751749258,1200491863
5429,LAME3,2016-03-31,2016-05-05,530640068,879901018,1410541086
5430,LAME3,2016-06-30,2016-08-11,530640068,880161234,1410801302
5431,LAME3,2016-09-30,2016-11-10,530640068,882695739,1413335807
5432,LAME3,2016-12-31,2017-02-20,530640068,897393456,1428033524
5433,LAME3,2017-03-31,2017-05-11,539943630,1040318790,1580262420
5434,LAME3,2017-06-30,2017-08-10,539943630,1042625666,1582569296
5435,LAME3,2017-09-30,2017-11-01,539943630,1057250774,1597194404
5436,LAME3,2017-12-31,2018-03-14,539943630,1057488141,1597431771
5437,LAME3,2018-03-31,2018-05-10,539943630,1057488141,1597431771
5438,LAME3,2018-06-30,2018-08-09,539943630,1057488141,1597431771
5439,LAME3,2018-09-30,2018-10-31,539943630,1060710334,1600653964
5440,LAME3,2018-12-31,2019-03-20,539943630,1060710334,1600653964
5441,LAME3,2019-03-31,2019-05-09,539943630,1060710334,1600653964
5442,LAME3,2019-06-30,2019-08-08,539943630,1060710334,1600653964
5443,LAME3,2019-09-30,2019-10-30,539943630,1065402464,1605346094
5444,LAME3,2019-12-31,2020-02-20,539943630,1065434334,1605377964
5445,LAME3,2020-03-31,2020-05-07,545154656,1075694696,1620849352
5446,LAME3,2020-06-30,2020-08-13,545154656,1078406137,1623560793
5447,LAME3,2020-09-30,2020-10-29,653154656,1214196917,1867351573
5448,LAME3,2020-12-31,2021-03-04,653154656,1214381060,1867535716
5449,LAME4,2010-12-31,2011-06-21,281689106,476613879,758302985
5450,LAME4,2011-03-31,2011-06-21,287098878,485767134,772866012
5451,LAME4,2011-06-30,2011-08-04,287098878,486700787,773799665
5452,LAME4,2011-09-30,2011-11-10,287098878,487872832,774971710
5453,LAME4,2011-12-31,2012-03-06,287098878,487872832,774971710
5454,LAME4,2012-03-31,2012-05-08,287098878,487872832,774971710
5455,LAME4,2012-06-30,2012-08-14,367025080,625057273,992082353
5456,LAME4,2012-09-30,2012-11-13,367025080,625068830,992093910
5457,LAME4,2012-12-31,2013-03-18,367025080,625068830,992093910
5458,LAME4,2013-03-31,2013-05-09,367025080,625068830,992093910
5459,LAME4,2013-06-30,2013-08-14,367025080,625068830,992093910
5460,LAME4,2013-09-30,2013-11-13,367025080,626638720,993663800
5461,LAME4,2013-12-31,2014-03-19,367025080,626706258,993731338
5462,LAME4,2014-03-31,2014-05-08,361671082,608448687,970119769
5463,LAME4,2014-06-30,2014-08-13,452088853,763052048,1215140901
5464,LAME4,2014-09-30,2014-11-12,452088853,763095114,1215183967
5465,LAME4,2014-12-31,2015-03-18,452088853,763128273,1215217126
5466,LAME4,2015-03-31,2015-05-07,448742605,749700733,1198443338
5467,LAME4,2015-06-30,2015-08-13,448742605,751593250,1200335855
5468,LAME4,2015-09-30,2015-11-12,448742605,751732507,1200475112
5469,LAME4,2015-12-31,2016-03-16,448742605,751749258,1200491863
5470,LAME4,2016-03-31,2016-05-05,530640068,879901018,1410541086
5471,LAME4,2016-06-30,2016-08-11,530640068,880161234,1410801302
5472,LAME4,2016-09-30,2016-11-10,530640068,882695739,1413335807
5473,LAME4,2016-12-31,2017-02-20,530640068,897393456,1428033524
5474,LAME4,2017-03-31,2017-05-11,539943630,1040318790,1580262420
5475,LAME4,2017-06-30,2017-08-10,539943630,1042625666,1582569296
5476,LAME4,2017-09-30,2017-11-01,539943630,1057250774,1597194404
5477,LAME4,2017-12-31,2018-03-14,539943630,1057488141,1597431771
5478,LAME4,2018-03-31,2018-05-10,539943630,1057488141,1597431771
5479,LAME4,2018-06-30,2018-08-09,539943630,1057488141,1597431771
5480,LAME4,2018-09-30,2018-10-31,539943630,1060710334,1600653964
5481,LAME4,2018-12-31,2019-03-20,539943630,1060710334,1600653964
5482,LAME4,2019-03-31,2019-05-09,539943630,1060710334,1600653964
5483,LAME4,2019-06-30,2019-08-08,539943630,1060710334,1600653964
5484,LAME4,2019-09-30,2019-10-30,539943630,1065402464,1605346094
5485,LAME4,2019-12-31,2020-02-20,539943630,1065434334,1605377964
5486,LAME4,2020-03-31,2020-05-07,545154656,1075694696,1620849352
5487,LAME4,2020-06-30,2020-08-13,545154656,1078406137,1623560793
5488,LAME4,2020-09-30,2020-10-29,653154656,1214196917,1867351573
5489,LAME4,2020-12-31,2021-03-04,653154656,1214381060,1867535716
5490,LHER3,2010-12-31,2011-04-05,46,85,131
5491,LHER3,2011-03-31,2011-05-17,46,85,131
5492,LHER3,2011-06-30,2011-08-15,46,85,131
5493,LHER3,2011-09-30,2011-11-11,46,85,131
5494,LHER3,2011-12-31,2012-03-30,46,85,131
5495,LHER3,2012-03-31,2012-05-11,46,85,131
5496,LHER3,2012-06-30,2012-08-06,46,85,131
5497,LHER3,2012-09-30,2012-11-09,46,85,131
5498,LHER3,2012-12-31,2013-03-20,46,85,131
5499,LHER3,2013-03-31,2013-05-10,46,85,131
5500,LHER3,2013-06-30,2013-08-05,46,85,131
5501,LHER3,2013-09-30,2013-11-01,46,85,131
5502,LHER3,2013-12-31,2014-04-16,46,85,131
5503,LHER3,2014-03-31,2014-05-12,46,85,131
5504,LHER3,2014-06-30,2014-08-06,46,85,131
5505,LHER3,2014-09-30,2014-11-11,46,85,131
5506,LHER3,2014-12-31,2015-04-01,46,85,131
5507,LHER3,2015-03-31,2015-05-11,46,85,131
5508,LHER3,2015-06-30,2015-08-05,46,85,131
5509,LHER3,2015-09-30,2015-11-11,46,85,131
5510,LHER3,2015-12-31,2016-03-23,46,85,131
5511,LHER3,2016-03-31,2016-05-10,46,85,131
5512,LHER3,2016-06-30,2016-08-12,46,85,131
5513,LHER3,2016-09-30,2016-11-11,46,85,131
5514,LHER3,2016-12-31,2017-03-09,46,85,131
5515,LHER3,2017-03-31,2017-05-12,46,85,131
5516,LHER3,2017-06-30,2017-08-11,46,85,131
5517,LHER3,2017-09-30,2017-11-14,46,85,131
5518,LHER3,2017-12-31,2018-03-15,46,85,131
5519,LHER3,2018-03-31,2018-05-11,46,85,131
5520,LHER3,2018-06-30,2018-08-14,46,85,131
5521,LHER3,2018-09-30,2018-11-15,46,85,131
5522,LHER3,2018-12-31,2019-03-26,46,85,131
5523,LHER4,2010-12-31,2011-04-05,46,85,131
5524,LHER4,2011-03-31,2011-05-17,46,85,131
5525,LHER4,2011-06-30,2011-08-15,46,85,131
5526,LHER4,2011-09-30,2011-11-11,46,85,131
5527,LHER4,2011-12-31,2012-03-30,46,85,131
5528,LHER4,2012-03-31,2012-05-11,46,85,131
5529,LHER4,2012-06-30,2012-08-06,46,85,131
5530,LHER4,2012-09-30,2012-11-09,46,85,131
5531,LHER4,2012-12-31,2013-03-20,46,85,131
5532,LHER4,2013-03-31,2013-05-10,46,85,131
5533,LHER4,2013-06-30,2013-08-05,46,85,131
5534,LHER4,2013-09-30,2013-11-01,46,85,131
5535,LHER4,2013-12-31,2014-04-16,46,85,131
5536,LHER4,2014-03-31,2014-05-12,46,85,131
5537,LHER4,2014-06-30,2014-08-06,46,85,131
5538,LHER4,2014-09-30,2014-11-11,46,85,131
5539,LHER4,2014-12-31,2015-04-01,46,85,131
5540,LHER4,2015-03-31,2015-05-11,46,85,131
5541,LHER4,2015-06-30,2015-08-05,46,85,131
5542,LHER4,2015-09-30,2015-11-11,46,85,131
5543,LHER4,2015-12-31,2016-03-23,46,85,131
5544,LHER4,2016-03-31,2016-05-10,46,85,131
5545,LHER4,2016-06-30,2016-08-12,46,85,131
5546,LHER4,2016-09-30,2016-11-11,46,85,131
5547,LHER4,2016-12-31,2017-03-09,46,85,131
5548,LHER4,2017-03-31,2017-05-12,46,85,131
5549,LHER4,2017-06-30,2017-08-11,46,85,131
5550,LHER4,2017-09-30,2017-11-14,46,85,131
5551,LHER4,2017-12-31,2018-03-15,46,85,131
5552,LHER4,2018-03-31,2018-05-11,46,85,131
5553,LHER4,2018-06-30,2018-08-14,46,85,131
5554,LHER4,2018-09-30,2018-11-15,46,85,131
5555,LHER4,2018-12-31,2019-03-26,46,85,131
5556,LREN3,2010-12-31,2011-02-16,122349,0,122349
5557,LREN3,2011-03-31,2011-04-28,122349,0,122349
5558,LREN3,2011-06-30,2011-08-15,122537,0,122537
5559,LREN3,2011-09-30,2011-10-27,122551,0,122551
5560,LREN3,2011-12-31,2012-02-08,122821,0,122821
5561,LREN3,2012-03-31,2012-04-27,122821,0,122821
5562,LREN3,2012-06-30,2012-08-09,123420,0,123420
5563,LREN3,2012-09-30,2012-10-30,123528,0,123528
5564,LREN3,2012-12-31,2013-02-26,124170,0,124170
5565,LREN3,2013-03-31,2013-05-08,124184,0,124184
5566,LREN3,2013-06-30,2013-08-14,124975,0,124975
5567,LREN3,2013-09-30,2013-10-24,124975,0,124975
5568,LREN3,2013-12-31,2014-02-20,125895,0,125895
5569,LREN3,2014-03-31,2014-04-29,125895,0,125895
5570,LREN3,2014-06-30,2014-07-22,126024,0,126024
5571,LREN3,2014-09-30,2014-10-23,126156,0,126156
5572,LREN3,2014-12-31,2015-02-12,127395,0,127395
5573,LREN3,2015-03-31,2015-04-29,127395,0,127395
5574,LREN3,2015-06-30,2015-07-30,127840,0,127840
5575,LREN3,2015-09-30,2015-10-22,639375,0,639375
5576,LREN3,2015-12-31,2016-02-04,640041,0,640041
5577,LREN3,2016-03-31,2016-04-25,640041,0,640041
5578,LREN3,2016-06-30,2016-07-25,642086,0,642086
5579,LREN3,2016-09-30,2016-10-24,642853,0,642853
5580,LREN3,2016-12-31,2017-02-09,643551,0,643551
5581,LREN3,2017-03-31,2017-04-25,643551,0,643551
5582,LREN3,2017-06-30,2017-07-25,711146,0,711146
5583,LREN3,2017-09-30,2017-10-24,712986,0,712986
5584,LREN3,2017-12-31,2018-02-08,713235,0,713235
5585,LREN3,2018-03-31,2018-05-03,713235,0,713235
5586,LREN3,2018-06-30,2018-07-26,716675,0,716675
5587,LREN3,2018-09-30,2018-10-25,717966,0,717966
5588,LREN3,2018-12-31,2019-02-07,720024,0,720024
5589,LREN3,2019-03-31,2019-04-25,720024,0,720024
5590,LREN3,2019-06-30,2019-07-31,793812,0,793812
5591,LREN3,2019-09-30,2019-10-25,795247,0,795247
5592,LREN3,2019-12-31,2020-02-06,795558,0,795558
5593,LREN3,2020-03-31,2020-05-21,795558,0,795558
5594,LREN3,2020-06-30,2020-08-31,795590,0,795590
5595,LREN3,2020-09-30,2020-11-05,795648,0,795648
5596,LREN3,2020-12-31,2021-02-11,796170,0,796170
5597,LUXM3,2010-12-31,2011-03-31,766,985,1751
5598,LUXM3,2011-03-31,2011-05-16,766,985,1751
5599,LUXM3,2011-06-30,2011-08-10,766,985,1751
5600,LUXM3,2011-09-30,2011-11-10,766,985,1751
5601,LUXM3,2011-12-31,2012-03-29,766,985,1751
5602,LUXM3,2012-03-31,2012-05-15,766,985,1751
5603,LUXM3,2012-06-30,2012-08-13,766,985,1751
5604,LUXM3,2012-09-30,2012-11-14,766,985,1751
5605,LUXM3,2012-12-31,2013-04-01,766,985,1751
5606,LUXM3,2013-03-31,2013-05-15,766,985,1751
5607,LUXM3,2013-06-30,2014-09-22,766,975,1741
5608,LUXM3,2013-09-30,2013-11-13,766,975,1741
5609,LUXM3,2013-12-31,2014-03-24,766,975,1741
5610,LUXM3,2014-03-31,2014-05-15,766,975,1741
5611,LUXM3,2014-06-30,2014-08-14,766,967,1733
5612,LUXM3,2014-09-30,2014-11-14,766,967,1733
5613,LUXM3,2014-12-31,2015-03-25,766,967,1733
5614,LUXM3,2015-03-31,2015-05-18,766,967,1733
5615,LUXM3,2015-06-30,2015-10-20,1532,1932,3464
5616,LUXM3,2015-09-30,2015-11-06,1532,1932,3464
5617,LUXM3,2015-12-31,2016-03-21,1532,1932,3464
5618,LUXM3,2016-03-31,2016-05-13,1532,1932,3464
5619,LUXM3,2016-06-30,2016-08-11,1532,1932,3464
5620,LUXM3,2016-09-30,2016-11-14,1532,1932,3464
5621,LUXM3,2016-12-31,2017-03-22,1532,1932,3464
5622,LUXM3,2017-03-31,2017-05-15,1532,1932,3464
5623,LUXM3,2017-06-30,2017-08-14,2298,2898,5196
5624,LUXM3,2017-09-30,2017-11-14,2298,2898,5196
5625,LUXM3,2017-12-31,2018-03-22,2298,2898,5196
5626,LUXM3,2018-03-31,2018-05-15,2298,2898,5196
5627,LUXM3,2018-06-30,2018-08-14,2298,2898,5196
5628,LUXM3,2018-09-30,2018-11-14,2298,2898,5196
5629,LUXM3,2018-12-31,2019-03-26,2298,2898,5196
5630,LUXM3,2019-03-31,2019-05-15,2298,2898,5196
5631,LUXM3,2019-06-30,2019-08-14,2298,2898,5196
5632,LUXM3,2019-09-30,2019-11-13,2298,2898,5196
5633,LUXM3,2019-12-31,2020-03-25,2298,2898,5196
5634,LUXM3,2020-03-31,2020-05-29,2298,2898,5196
5635,LUXM3,2020-06-30,2020-08-19,2298,2898,5196
5636,LUXM3,2020-09-30,2020-10-29,2298,2898,5196
5637,LUXM3,2020-12-31,2021-03-22,2298,2898,5196
5638,LUXM4,2010-12-31,2011-03-31,766,985,1751
5639,LUXM4,2011-03-31,2011-05-16,766,985,1751
5640,LUXM4,2011-06-30,2011-08-10,766,985,1751
5641,LUXM4,2011-09-30,2011-11-10,766,985,1751
5642,LUXM4,2011-12-31,2012-03-29,766,985,1751
5643,LUXM4,2012-03-31,2012-05-15,766,985,1751
5644,LUXM4,2012-06-30,2012-08-13,766,985,1751
5645,LUXM4,2012-09-30,2012-11-14,766,985,1751
5646,LUXM4,2012-12-31,2013-04-01,766,985,1751
5647,LUXM4,2013-03-31,2013-05-15,766,985,1751
5648,LUXM4,2013-06-30,2014-09-22,766,975,1741
5649,LUXM4,2013-09-30,2013-11-13,766,975,1741
5650,LUXM4,2013-12-31,2014-03-24,766,975,1741
5651,LUXM4,2014-03-31,2014-05-15,766,975,1741
5652,LUXM4,2014-06-30,2014-08-14,766,967,1733
5653,LUXM4,2014-09-30,2014-11-14,766,967,1733
5654,LUXM4,2014-12-31,2015-03-25,766,967,1733
5655,LUXM4,2015-03-31,2015-05-18,766,967,1733
5656,LUXM4,2015-06-30,2015-10-20,1532,1932,3464
5657,LUXM4,2015-09-30,2015-11-06,1532,1932,3464
5658,LUXM4,2015-12-31,2016-03-21,1532,1932,3464
5659,LUXM4,2016-03-31,2016-05-13,1532,1932,3464
5660,LUXM4,2016-06-30,2016-08-11,1532,1932,3464
5661,LUXM4,2016-09-30,2016-11-14,1532,1932,3464
5662,LUXM4,2016-12-31,2017-03-22,1532,1932,3464
5663,LUXM4,2017-03-31,2017-05-15,1532,1932,3464
5664,LUXM4,2017-06-30,2017-08-14,2298,2898,5196
5665,LUXM4,2017-09-30,2017-11-14,2298,2898,5196
5666,LUXM4,2017-12-31,2018-03-22,2298,2898,5196
5667,LUXM4,2018-03-31,2018-05-15,2298,2898,5196
5668,LUXM4,2018-06-30,2018-08-14,2298,2898,5196
5669,LUXM4,2018-09-30,2018-11-14,2298,2898,5196
5670,LUXM4,2018-12-31,2019-03-26,2298,2898,5196
5671,LUXM4,2019-03-31,2019-05-15,2298,2898,5196
5672,LUXM4,2019-06-30,2019-08-14,2298,2898,5196
5673,LUXM4,2019-09-30,2019-11-13,2298,2898,5196
5674,LUXM4,2019-12-31,2020-03-25,2298,2898,5196
5675,LUXM4,2020-03-31,2020-05-29,2298,2898,5196
5676,LUXM4,2020-06-30,2020-08-19,2298,2898,5196
5677,LUXM4,2020-09-30,2020-10-29,2298,2898,5196
5678,LUXM4,2020-12-31,2021-03-22,2298,2898,5196
5679,MGEL3,2010-12-31,2011-05-02,6201730,11147908,17349638
5680,MGEL3,2011-03-31,2011-05-13,6201730,11147908,17349638
5681,MGEL3,2011-06-30,2011-08-12,6201730,11147908,17349638
5682,MGEL3,2011-09-30,2011-11-11,6201730,11147908,17349638
5683,MGEL3,2011-12-31,2012-03-27,6201730,11147908,17349638
5684,MGEL3,2012-03-31,2012-05-15,6201730,11147908,17349638
5685,MGEL3,2012-06-30,2012-08-14,6201730,11147908,17349638
5686,MGEL3,2012-09-30,2012-11-14,6201730,11147908,17349638
5687,MGEL3,2012-12-31,2013-03-20,6201730,11147908,17349638
5688,MGEL3,2013-03-31,2013-06-14,6201730,11147908,17349638
5689,MGEL3,2013-06-30,2013-09-16,6201730,11147908,17349638
5690,MGEL3,2013-09-30,2014-05-14,6201730,11147908,17349638
5691,MGEL3,2013-12-31,2014-05-14,6201730,11147908,17349638
5692,MGEL3,2014-03-31,2014-05-15,6201730,11147908,17349638
5693,MGEL3,2014-06-30,2014-08-14,6201730,11147908,17349638
5694,MGEL3,2014-09-30,2014-11-14,6201730,11147908,17349638
5695,MGEL3,2014-12-31,2015-03-31,6201730,11147908,17349638
5696,MGEL3,2015-03-31,2015-05-15,6201730,11147908,17349638
5697,MGEL3,2015-06-30,2015-08-14,6201730,11147908,17349638
5698,MGEL3,2015-09-30,2015-11-13,6201730,11147908,17349638
5699,MGEL3,2015-12-31,2016-03-30,6201730,11147908,17349638
5700,MGEL3,2016-03-31,2016-05-13,6201730,11147908,17349638
5701,MGEL3,2016-06-30,2016-08-15,2067243,3715969,5783212
5702,MGEL3,2016-09-30,2016-11-11,2067243,3715969,5783212
5703,MGEL3,2016-12-31,2017-03-29,2067243,3715969,5783212
5704,MGEL3,2017-03-31,2017-05-15,2067243,3715969,5783212
5705,MGEL3,2017-06-30,2017-08-14,2067243,3715969,5783212
5706,MGEL3,2017-09-30,2017-11-14,2067243,3715969,5783212
5707,MGEL3,2017-12-31,2018-03-16,2067243,3715969,5783212
5708,MGEL3,2018-03-31,2018-05-04,2067243,3715969,5783212
5709,MGEL3,2018-06-30,2018-08-10,2067243,3715969,5783212
5710,MGEL3,2018-09-30,2018-11-09,2067243,3715969,5783212
5711,MGEL3,2018-12-31,2019-02-28,2067243,3673869,5741112
5712,MGEL3,2019-03-31,2019-05-16,2067243,3715969,5783212
5713,MGEL3,2019-06-30,2019-08-15,2067243,3715969,5783212
5714,MGEL3,2019-09-30,2019-11-13,2067243,3715969,5783212
5715,MGEL3,2019-12-31,2020-03-12,2067243,3715969,5783212
5716,MGEL3,2020-03-31,2020-07-01,2067243,3715969,5783212
5717,MGEL3,2020-06-30,2020-08-30,2067243,3715969,5783212
5718,MGEL3,2020-09-30,2020-11-16,2067243,3715969,5783212
5719,MGEL3,2020-12-31,2021-03-22,2067243,3715969,5783212
5720,MGEL4,2010-12-31,2011-05-02,6201730,11147908,17349638
5721,MGEL4,2011-03-31,2011-05-13,6201730,11147908,17349638
5722,MGEL4,2011-06-30,2011-08-12,6201730,11147908,17349638
5723,MGEL4,2011-09-30,2011-11-11,6201730,11147908,17349638
5724,MGEL4,2011-12-31,2012-03-27,6201730,11147908,17349638
5725,MGEL4,2012-03-31,2012-05-15,6201730,11147908,17349638
5726,MGEL4,2012-06-30,2012-08-14,6201730,11147908,17349638
5727,MGEL4,2012-09-30,2012-11-14,6201730,11147908,17349638
5728,MGEL4,2012-12-31,2013-03-20,6201730,11147908,17349638
5729,MGEL4,2013-03-31,2013-06-14,6201730,11147908,17349638
5730,MGEL4,2013-06-30,2013-09-16,6201730,11147908,17349638
5731,MGEL4,2013-09-30,2014-05-14,6201730,11147908,17349638
5732,MGEL4,2013-12-31,2014-05-14,6201730,11147908,17349638
5733,MGEL4,2014-03-31,2014-05-15,6201730,11147908,17349638
5734,MGEL4,2014-06-30,2014-08-14,6201730,11147908,17349638
5735,MGEL4,2014-09-30,2014-11-14,6201730,11147908,17349638
5736,MGEL4,2014-12-31,2015-03-31,6201730,11147908,17349638
5737,MGEL4,2015-03-31,2015-05-15,6201730,11147908,17349638
5738,MGEL4,2015-06-30,2015-08-14,6201730,11147908,17349638
5739,MGEL4,2015-09-30,2015-11-13,6201730,11147908,17349638
5740,MGEL4,2015-12-31,2016-03-30,6201730,11147908,17349638
5741,MGEL4,2016-03-31,2016-05-13,6201730,11147908,17349638
5742,MGEL4,2016-06-30,2016-08-15,2067243,3715969,5783212
5743,MGEL4,2016-09-30,2016-11-11,2067243,3715969,5783212
5744,MGEL4,2016-12-31,2017-03-29,2067243,3715969,5783212
5745,MGEL4,2017-03-31,2017-05-15,2067243,3715969,5783212
5746,MGEL4,2017-06-30,2017-08-14,2067243,3715969,5783212
5747,MGEL4,2017-09-30,2017-11-14,2067243,3715969,5783212
5748,MGEL4,2017-12-31,2018-03-16,2067243,3715969,5783212
5749,MGEL4,2018-03-31,2018-05-04,2067243,3715969,5783212
5750,MGEL4,2018-06-30,2018-08-10,2067243,3715969,5783212
5751,MGEL4,2018-09-30,2018-11-09,2067243,3715969,5783212
5752,MGEL4,2018-12-31,2019-02-28,2067243,3673869,5741112
5753,MGEL4,2019-03-31,2019-05-16,2067243,3715969,5783212
5754,MGEL4,2019-06-30,2019-08-15,2067243,3715969,5783212
5755,MGEL4,2019-09-30,2019-11-13,2067243,3715969,5783212
5756,MGEL4,2019-12-31,2020-03-12,2067243,3715969,5783212
5757,MGEL4,2020-03-31,2020-07-01,2067243,3715969,5783212
5758,MGEL4,2020-06-30,2020-08-30,2067243,3715969,5783212
5759,MGEL4,2020-09-30,2020-11-16,2067243,3715969,5783212
5760,MGEL4,2020-12-31,2021-03-22,2067243,3715969,5783212
5761,ESTR3,2010-12-31,2013-10-09,5389,10778,16167
5762,ESTR3,2011-03-31,2011-07-08,5389,10778,16167
5763,ESTR3,2011-03-31,2011-07-11,5389,10778,16167
5764,ESTR3,2011-06-30,2011-08-15,5389,10778,16167
5765,ESTR3,2011-09-30,2011-11-11,5389,10778,16167
5766,ESTR3,2011-12-31,2012-04-03,5389,10778,16167
5767,ESTR3,2012-03-31,2012-05-15,5389,10778,16167
5768,ESTR3,2012-06-30,2012-08-15,5389,10778,16167
5769,ESTR3,2012-09-30,2012-11-12,5389,10778,16167
5770,ESTR3,2012-12-31,2013-03-28,5389,10778,16167
5771,ESTR3,2013-03-31,2013-10-28,5389,10778,16167
5772,ESTR3,2013-06-30,2013-10-28,5389,10778,16167
5773,ESTR3,2013-09-30,2013-11-14,5389,10778,16167
5774,ESTR3,2013-12-31,2014-03-28,5389,10778,16167
5775,ESTR3,2014-03-31,2014-05-15,5389,10778,16167
5776,ESTR3,2014-06-30,2014-08-12,5389,10778,16167
5777,ESTR3,2014-09-30,2014-11-13,5389,10778,16167
5778,ESTR3,2014-12-31,2015-03-30,5389,10778,16167
5779,ESTR3,2015-03-31,2015-05-15,5389,10778,16167
5780,ESTR3,2015-06-30,2015-08-14,5389,10778,16167
5781,ESTR3,2015-09-30,2015-10-30,5389,10778,16167
5782,ESTR3,2015-12-31,2016-03-31,5389,10778,16167
5783,ESTR3,2016-03-31,2016-05-11,5389,10778,16167
5784,ESTR3,2016-06-30,2016-08-12,5389,10778,16167
5785,ESTR3,2016-09-30,2016-11-11,10778,5389,16167
5786,ESTR3,2016-12-31,2017-03-28,5389,10778,16167
5787,ESTR3,2017-03-31,2017-05-15,5389,10778,16167
5788,ESTR3,2017-06-30,2017-08-14,269,539,808
5789,ESTR3,2017-09-30,2017-11-10,269,539,808
5790,ESTR3,2017-12-31,2018-03-27,269,539,808
5791,ESTR3,2018-03-31,2018-05-14,269,539,808
5792,ESTR3,2018-06-30,2018-08-14,269,539,808
5793,ESTR3,2018-09-30,2018-11-19,269,539,808
5794,ESTR3,2018-12-31,2019-03-29,269,539,808
5795,ESTR3,2019-03-31,2019-05-15,269,539,808
5796,ESTR3,2019-06-30,2019-08-14,269,539,808
5797,ESTR3,2019-09-30,2019-11-14,269,539,808
5798,ESTR3,2019-12-31,2020-03-31,269,539,808
5799,ESTR3,2020-03-31,2020-06-30,269,539,808
5800,ESTR3,2020-06-30,2020-08-28,269,539,808
5801,ESTR3,2020-09-30,2020-11-16,269,539,808
5802,ESTR4,2010-12-31,2013-10-09,5389,10778,16167
5803,ESTR4,2011-03-31,2011-07-08,5389,10778,16167
5804,ESTR4,2011-03-31,2011-07-11,5389,10778,16167
5805,ESTR4,2011-06-30,2011-08-15,5389,10778,16167
5806,ESTR4,2011-09-30,2011-11-11,5389,10778,16167
5807,ESTR4,2011-12-31,2012-04-03,5389,10778,16167
5808,ESTR4,2012-03-31,2012-05-15,5389,10778,16167
5809,ESTR4,2012-06-30,2012-08-15,5389,10778,16167
5810,ESTR4,2012-09-30,2012-11-12,5389,10778,16167
5811,ESTR4,2012-12-31,2013-03-28,5389,10778,16167
5812,ESTR4,2013-03-31,2013-10-28,5389,10778,16167
5813,ESTR4,2013-06-30,2013-10-28,5389,10778,16167
5814,ESTR4,2013-09-30,2013-11-14,5389,10778,16167
5815,ESTR4,2013-12-31,2014-03-28,5389,10778,16167
5816,ESTR4,2014-03-31,2014-05-15,5389,10778,16167
5817,ESTR4,2014-06-30,2014-08-12,5389,10778,16167
5818,ESTR4,2014-09-30,2014-11-13,5389,10778,16167
5819,ESTR4,2014-12-31,2015-03-30,5389,10778,16167
5820,ESTR4,2015-03-31,2015-05-15,5389,10778,16167
5821,ESTR4,2015-06-30,2015-08-14,5389,10778,16167
5822,ESTR4,2015-09-30,2015-10-30,5389,10778,16167
5823,ESTR4,2015-12-31,2016-03-31,5389,10778,16167
5824,ESTR4,2016-03-31,2016-05-11,5389,10778,16167
5825,ESTR4,2016-06-30,2016-08-12,5389,10778,16167
5826,ESTR4,2016-09-30,2016-11-11,10778,5389,16167
5827,ESTR4,2016-12-31,2017-03-28,5389,10778,16167
5828,ESTR4,2017-03-31,2017-05-15,5389,10778,16167
5829,ESTR4,2017-06-30,2017-08-14,269,539,808
5830,ESTR4,2017-09-30,2017-11-10,269,539,808
5831,ESTR4,2017-12-31,2018-03-27,269,539,808
5832,ESTR4,2018-03-31,2018-05-14,269,539,808
5833,ESTR4,2018-06-30,2018-08-14,269,539,808
5834,ESTR4,2018-09-30,2018-11-19,269,539,808
5835,ESTR4,2018-12-31,2019-03-29,269,539,808
5836,ESTR4,2019-03-31,2019-05-15,269,539,808
5837,ESTR4,2019-06-30,2019-08-14,269,539,808
5838,ESTR4,2019-09-30,2019-11-14,269,539,808
5839,ESTR4,2019-12-31,2020-03-31,269,539,808
5840,ESTR4,2020-03-31,2020-06-30,269,539,808
5841,ESTR4,2020-06-30,2020-08-28,269,539,808
5842,ESTR4,2020-09-30,2020-11-16,269,539,808
5843,POMO3,2010-12-31,2011-02-24,170812872,277637170,448450042
5844,POMO3,2011-03-31,2011-05-09,170812872,277637170,448450042
5845,POMO3,2011-06-30,2011-08-08,170812872,277637170,448450042
5846,POMO3,2011-09-30,2011-11-07,170812872,277637170,448450042
5847,POMO3,2011-12-31,2012-02-28,170812872,277637170,448450042
5848,POMO3,2012-03-31,2012-05-07,170812872,277637170,448450042
5849,POMO3,2012-06-30,2012-08-06,170812872,277637170,448450042
5850,POMO3,2012-09-30,2012-11-05,170812872,277637170,448450042
5851,POMO3,2012-12-31,2013-02-21,170812872,277637170,448450042
5852,POMO3,2013-03-31,2013-05-06,170812872,277637170,448450042
5853,POMO3,2013-06-30,2013-08-05,170812872,277637170,448450042
5854,POMO3,2013-09-30,2013-11-04,341625744,555274340,896900084
5855,POMO3,2013-12-31,2014-02-25,341625744,555274340,896900084
5856,POMO3,2014-03-31,2014-05-12,341625744,555274340,896900084
5857,POMO3,2014-06-30,2014-08-11,341625744,555274340,896900084
5858,POMO3,2014-09-30,2014-11-10,341625744,555274340,896900084
5859,POMO3,2014-12-31,2015-02-24,341625744,555274340,896900084
5860,POMO3,2015-03-31,2015-05-04,341625744,555274340,896900084
5861,POMO3,2015-06-30,2015-08-03,341625744,555274340,896900084
5862,POMO3,2015-09-30,2015-11-03,341625744,555274340,896900084
5863,POMO3,2015-12-31,2016-02-23,341625744,555274340,896900084
5864,POMO3,2016-03-31,2016-05-02,341625744,555274340,896900084
5865,POMO3,2016-06-30,2016-08-08,341625744,555274340,896900084
5866,POMO3,2016-09-30,2016-11-07,341625744,567382491,909008235
5867,POMO3,2016-12-31,2017-02-23,341625744,583570265,925196009
5868,POMO3,2017-03-31,2017-05-08,341625744,583570265,925196009
5869,POMO3,2017-06-30,2017-08-07,341625744,583570265,925196009
5870,POMO3,2017-09-30,2017-11-06,341625744,583570265,925196009
5871,POMO3,2017-12-31,2018-02-22,341625744,583570265,925196009
5872,POMO3,2018-03-31,2018-05-07,341625744,583570265,925196009
5873,POMO3,2018-06-30,2018-08-06,341625744,583570265,925196009
5874,POMO3,2018-09-30,2018-11-05,341625744,583570265,925196009
5875,POMO3,2018-12-31,2019-02-26,341625744,583570265,925196009
5876,POMO3,2019-03-31,2019-05-06,341625744,605267138,946892882
5877,POMO3,2019-06-30,2019-08-05,341625744,605267138,946892882
5878,POMO3,2019-09-30,2019-11-04,341625744,605267138,946892882
5879,POMO3,2019-12-31,2020-02-27,341625744,605267138,946892882
5880,POMO3,2020-03-31,2020-05-25,341625744,605267138,946892882
5881,POMO3,2020-06-30,2020-08-03,341625744,605267138,946892882
5882,POMO3,2020-09-30,2020-11-03,341625744,605267138,946892882
5883,POMO3,2020-12-31,2021-02-25,341625744,605267138,946892882
5884,POMO4,2010-12-31,2011-02-24,170812872,277637170,448450042
5885,POMO4,2011-03-31,2011-05-09,170812872,277637170,448450042
5886,POMO4,2011-06-30,2011-08-08,170812872,277637170,448450042
5887,POMO4,2011-09-30,2011-11-07,170812872,277637170,448450042
5888,POMO4,2011-12-31,2012-02-28,170812872,277637170,448450042
5889,POMO4,2012-03-31,2012-05-07,170812872,277637170,448450042
5890,POMO4,2012-06-30,2012-08-06,170812872,277637170,448450042
5891,POMO4,2012-09-30,2012-11-05,170812872,277637170,448450042
5892,POMO4,2012-12-31,2013-02-21,170812872,277637170,448450042
5893,POMO4,2013-03-31,2013-05-06,170812872,277637170,448450042
5894,POMO4,2013-06-30,2013-08-05,170812872,277637170,448450042
5895,POMO4,2013-09-30,2013-11-04,341625744,555274340,896900084
5896,POMO4,2013-12-31,2014-02-25,341625744,555274340,896900084
5897,POMO4,2014-03-31,2014-05-12,341625744,555274340,896900084
5898,POMO4,2014-06-30,2014-08-11,341625744,555274340,896900084
5899,POMO4,2014-09-30,2014-11-10,341625744,555274340,896900084
5900,POMO4,2014-12-31,2015-02-24,341625744,555274340,896900084
5901,POMO4,2015-03-31,2015-05-04,341625744,555274340,896900084
5902,POMO4,2015-06-30,2015-08-03,341625744,555274340,896900084
5903,POMO4,2015-09-30,2015-11-03,341625744,555274340,896900084
5904,POMO4,2015-12-31,2016-02-23,341625744,555274340,896900084
5905,POMO4,2016-03-31,2016-05-02,341625744,555274340,896900084
5906,POMO4,2016-06-30,2016-08-08,341625744,555274340,896900084
5907,POMO4,2016-09-30,2016-11-07,341625744,567382491,909008235
5908,POMO4,2016-12-31,2017-02-23,341625744,583570265,925196009
5909,POMO4,2017-03-31,2017-05-08,341625744,583570265,925196009
5910,POMO4,2017-06-30,2017-08-07,341625744,583570265,925196009
5911,POMO4,2017-09-30,2017-11-06,341625744,583570265,925196009
5912,POMO4,2017-12-31,2018-02-22,341625744,583570265,925196009
5913,POMO4,2018-03-31,2018-05-07,341625744,583570265,925196009
5914,POMO4,2018-06-30,2018-08-06,341625744,583570265,925196009
5915,POMO4,2018-09-30,2018-11-05,341625744,583570265,925196009
5916,POMO4,2018-12-31,2019-02-26,341625744,583570265,925196009
5917,POMO4,2019-03-31,2019-05-06,341625744,605267138,946892882
5918,POMO4,2019-06-30,2019-08-05,341625744,605267138,946892882
5919,POMO4,2019-09-30,2019-11-04,341625744,605267138,946892882
5920,POMO4,2019-12-31,2020-02-27,341625744,605267138,946892882
5921,POMO4,2020-03-31,2020-05-25,341625744,605267138,946892882
5922,POMO4,2020-06-30,2020-08-03,341625744,605267138,946892882
5923,POMO4,2020-09-30,2020-11-03,341625744,605267138,946892882
5924,POMO4,2020-12-31,2021-02-25,341625744,605267138,946892882
5925,MERC3,2010-12-31,2011-03-01,6647,5113,11760
5926,MERC3,2011-03-31,2011-05-17,6647,5113,11760
5927,MERC3,2011-06-30,2011-08-12,6647,5113,11760
5928,MERC3,2011-09-30,2011-11-14,6647,5113,11760
5929,MERC3,2011-12-31,2012-03-01,6647,5113,11760
5930,MERC3,2012-03-31,2012-05-18,6647,5113,11760
5931,MERC3,2012-06-30,2012-08-14,6647,5113,11760
5932,MERC3,2012-09-30,2012-11-14,6647,5113,11760
5933,MERC3,2012-12-31,2013-02-27,6647,5113,11760
5934,MERC3,2013-03-31,2013-05-14,6647,5113,11760
5935,MERC3,2013-06-30,2013-08-14,6647,5113,11760
5936,MERC3,2013-09-30,2013-11-13,6647,5113,11760
5937,MERC3,2013-12-31,2014-02-26,6647,5113,11760
5938,MERC3,2014-03-31,2014-05-15,6647,5113,11760
5939,MERC3,2014-06-30,2014-08-14,10180,7830,18010
5940,MERC3,2014-09-30,2014-11-14,10180,7830,18010
5941,MERC3,2014-12-31,2015-03-05,10180,7830,18010
5942,MERC3,2015-03-31,2015-05-15,10180,7830,18010
5943,MERC3,2015-06-30,2015-08-14,10180,7830,18010
5944,MERC3,2015-09-30,2015-11-13,10180,7830,18010
5945,MERC3,2015-12-31,2016-03-16,10180,7830,18010
5946,MERC3,2016-03-31,2016-05-13,10180,7830,18010
5947,MERC3,2016-06-30,2016-08-12,10180,7830,18010
5948,MERC3,2016-09-30,2016-11-11,10180,7830,18010
5949,MERC3,2016-12-31,2017-03-09,10180,7830,18010
5950,MERC3,2017-03-31,2017-05-15,10180,7830,18010
5951,MERC3,2017-06-30,2017-08-14,10180,7830,18010
5952,MERC3,2017-09-30,2017-11-14,10180,7830,18010
5953,MERC3,2017-12-31,2018-03-05,10180,7830,18010
5954,MERC3,2018-03-31,2018-05-15,10180,7830,18010
5955,MERC3,2018-06-30,2018-08-14,10180,7830,18010
5956,MERC3,2018-09-30,2018-11-14,10180,7830,18010
5957,MERC3,2018-12-31,2019-02-28,10180,7830,18010
5958,MERC3,2019-03-31,2019-05-15,10180,7830,18010
5959,MERC3,2019-06-30,2019-08-14,10180,7830,18010
5960,MERC3,2019-09-30,2019-11-14,10180,7830,18010
5961,MERC3,2019-12-31,2020-03-05,10180,7830,18010
5962,MERC3,2020-03-31,2020-05-15,10180,7830,18010
5963,MERC3,2020-06-30,2020-08-14,10180,7830,18010
5964,MERC3,2020-09-30,2020-11-13,10180,7830,18010
5965,MERC3,2020-12-31,2021-03-01,10180,7830,18010
5966,MERC4,2010-12-31,2011-03-01,6647,5113,11760
5967,MERC4,2011-03-31,2011-05-17,6647,5113,11760
5968,MERC4,2011-06-30,2011-08-12,6647,5113,11760
5969,MERC4,2011-09-30,2011-11-14,6647,5113,11760
5970,MERC4,2011-12-31,2012-03-01,6647,5113,11760
5971,MERC4,2012-03-31,2012-05-18,6647,5113,11760
5972,MERC4,2012-06-30,2012-08-14,6647,5113,11760
5973,MERC4,2012-09-30,2012-11-14,6647,5113,11760
5974,MERC4,2012-12-31,2013-02-27,6647,5113,11760
5975,MERC4,2013-03-31,2013-05-14,6647,5113,11760
5976,MERC4,2013-06-30,2013-08-14,6647,5113,11760
5977,MERC4,2013-09-30,2013-11-13,6647,5113,11760
5978,MERC4,2013-12-31,2014-02-26,6647,5113,11760
5979,MERC4,2014-03-31,2014-05-15,6647,5113,11760
5980,MERC4,2014-06-30,2014-08-14,10180,7830,18010
5981,MERC4,2014-09-30,2014-11-14,10180,7830,18010
5982,MERC4,2014-12-31,2015-03-05,10180,7830,18010
5983,MERC4,2015-03-31,2015-05-15,10180,7830,18010
5984,MERC4,2015-06-30,2015-08-14,10180,7830,18010
5985,MERC4,2015-09-30,2015-11-13,10180,7830,18010
5986,MERC4,2015-12-31,2016-03-16,10180,7830,18010
5987,MERC4,2016-03-31,2016-05-13,10180,7830,18010
5988,MERC4,2016-06-30,2016-08-12,10180,7830,18010
5989,MERC4,2016-09-30,2016-11-11,10180,7830,18010
5990,MERC4,2016-12-31,2017-03-09,10180,7830,18010
5991,MERC4,2017-03-31,2017-05-15,10180,7830,18010
5992,MERC4,2017-06-30,2017-08-14,10180,7830,18010
5993,MERC4,2017-09-30,2017-11-14,10180,7830,18010
5994,MERC4,2017-12-31,2018-03-05,10180,7830,18010
5995,MERC4,2018-03-31,2018-05-15,10180,7830,18010
5996,MERC4,2018-06-30,2018-08-14,10180,7830,18010
5997,MERC4,2018-09-30,2018-11-14,10180,7830,18010
5998,MERC4,2018-12-31,2019-02-28,10180,7830,18010
5999,MERC4,2019-03-31,2019-05-15,10180,7830,18010
6000,MERC4,2019-06-30,2019-08-14,10180,7830,18010
6001,MERC4,2019-09-30,2019-11-14,10180,7830,18010
6002,MERC4,2019-12-31,2020-03-05,10180,7830,18010
6003,MERC4,2020-03-31,2020-05-15,10180,7830,18010
6004,MERC4,2020-06-30,2020-08-14,10180,7830,18010
6005,MERC4,2020-09-30,2020-11-13,10180,7830,18010
6006,MERC4,2020-12-31,2021-03-01,10180,7830,18010
6007,LEVE3,2010-12-31,2011-03-29,42769500,0,42769500
6008,LEVE3,2011-03-31,2011-05-02,42769500,0,42769500
6009,LEVE3,2011-06-30,2011-08-12,42769500,0,42769500
6010,LEVE3,2011-09-30,2011-11-09,42769500,0,42769500
6011,LEVE3,2011-12-31,2012-03-10,42769500,0,42769500
6012,LEVE3,2012-03-31,2012-05-08,42769500,0,42769500
6013,LEVE3,2012-06-30,2012-08-06,128308500,0,128308500
6014,LEVE3,2012-09-30,2012-11-07,128308500,0,128308500
6015,LEVE3,2012-12-31,2013-03-11,128308500,0,128308500
6016,LEVE3,2013-03-31,2013-05-08,128308500,0,128308500
6017,LEVE3,2013-06-30,2013-08-08,128308500,0,128308500
6018,LEVE3,2013-09-30,2013-11-08,128308500,0,128308500
6019,LEVE3,2013-12-31,2014-03-14,128308500,0,128308500
6020,LEVE3,2014-03-31,2014-05-12,128308500,0,128308500
6021,LEVE3,2014-06-30,2014-08-11,128308500,0,128308500
6022,LEVE3,2014-09-30,2014-11-10,128308500,0,128308500
6023,LEVE3,2014-12-31,2015-03-16,128308500,0,128308500
6024,LEVE3,2015-03-31,2015-05-11,128308500,0,128308500
6025,LEVE3,2015-06-30,2015-08-10,128308500,0,128308500
6026,LEVE3,2015-09-30,2015-11-09,128308500,0,128308500
6027,LEVE3,2015-12-31,2016-03-18,128308500,0,128308500
6028,LEVE3,2016-03-31,2016-05-11,128308500,0,128308500
6029,LEVE3,2016-06-30,2016-08-10,128308500,0,128308500
6030,LEVE3,2016-09-30,2016-11-09,128308500,0,128308500
6031,LEVE3,2016-12-31,2017-03-20,128308500,0,128308500
6032,LEVE3,2017-03-31,2017-05-11,128308500,0,128308500
6033,LEVE3,2017-06-30,2017-08-14,128308500,0,128308500
6034,LEVE3,2017-09-30,2017-11-14,128308500,0,128308500
6035,LEVE3,2017-12-31,2018-03-19,128308500,0,128308500
6036,LEVE3,2018-03-31,2018-05-14,128308500,0,128308500
6037,LEVE3,2018-06-30,2018-08-13,128308500,0,128308500
6038,LEVE3,2018-09-30,2018-11-13,128308500,0,128308500
6039,LEVE3,2018-12-31,2019-03-18,128308500,0,128308500
6040,LEVE3,2019-03-31,2019-05-15,128308500,0,128308500
6041,LEVE3,2019-06-30,2019-08-12,128308500,0,128308500
6042,LEVE3,2019-09-30,2019-11-14,128308500,0,128308500
6043,LEVE3,2019-12-31,2020-03-30,128308500,0,128308500
6044,LEVE3,2020-03-31,2020-05-13,128308500,0,128308500
6045,LEVE3,2020-06-30,2020-08-12,128308500,0,128308500
6046,LEVE3,2020-09-30,2020-11-11,128308500,0,128308500
6047,LEVE3,2020-12-31,2021-03-15,128308500,0,128308500
6048,MTIG3,2010-12-31,2011-03-25,104172000,208344000,312516000
6049,MTIG3,2011-03-31,2011-08-11,104172,208344,312516
6050,MTIG3,2011-06-30,2011-08-11,104172,208344,312516
6051,MTIG3,2011-09-30,2011-11-11,104172,208344,312516
6052,MTIG3,2011-12-31,2012-03-23,104172000,208344000,312516000
6053,MTIG3,2012-03-31,2012-05-07,104172,208344,312516
6054,MTIG3,2012-06-30,2012-07-31,104172,208344,312516
6055,MTIG3,2012-09-30,2012-11-07,104172,208344,312516
6056,MTIG3,2012-12-31,2013-03-21,104172000,208344000,312516000
6057,MTIG3,2013-03-31,2013-05-10,104172,208344,312516
6058,MTIG3,2013-06-30,2013-08-14,104172,208344,312516
6059,MTIG3,2013-09-30,2013-11-12,104172,208344,312516
6060,MTIG3,2013-12-31,2014-03-20,104172000,208344000,312516000
6061,MTIG3,2014-03-31,2014-05-26,104172,208344,312516
6062,MTIG3,2014-06-30,2014-08-13,104172,208344,312516
6063,MTIG3,2014-09-30,2014-11-12,104172,208344,312516
6064,MTIG3,2014-12-31,2015-03-27,104172000,208344000,312516000
6065,MTIG3,2015-03-31,2015-05-19,104172,208344,312516
6066,MTIG3,2015-06-30,2015-08-06,2083,4167,6250
6067,MTIG3,2015-09-30,2015-12-11,2083,4167,6250
6068,MTIG3,2015-12-31,2016-03-24,2083440,4166880,6250320
6069,MTIG3,2016-03-31,2016-05-13,2083440,4166880,6250320
6070,MTIG3,2016-06-30,2016-08-11,69448,138896,208344
6071,MTIG3,2016-09-30,2016-11-08,69448,138896,208344
6072,MTIG3,2016-12-31,2017-03-28,80448,160896,241344
6073,MTIG3,2017-03-31,2017-05-15,80448,160896,241344
6074,MTIG3,2017-06-30,2017-08-17,80448,160896,241344
6075,MTIG3,2017-09-30,2017-11-10,80448,160896,241344
6076,MTIG3,2017-12-31,2018-04-02,80448,160896,241344
6077,MTIG3,2018-03-31,2018-05-15,80448,160896,241344
6078,MTIG3,2018-06-30,2018-08-14,80448,160896,241344
6079,MTIG3,2018-09-30,2018-11-09,80448,160896,241344
6080,MTIG3,2018-12-31,2019-03-25,80448,160896,241344
6081,MTIG3,2019-03-31,2019-05-13,80448,160896,241344
6082,MTIG3,2019-06-30,2019-08-13,80448,160896,241344
6083,MTIG3,2019-09-30,2019-11-07,80448,160896,241344
6084,MTIG3,2019-12-31,2020-03-26,80448,160896,241344
6085,MTIG3,2020-03-31,2020-06-18,80448,160896,241344
6086,MTIG3,2020-06-30,2020-08-19,80448,160896,241344
6087,MTIG3,2020-09-30,2020-11-10,80448,160896,241344
6088,MTIG4,2010-12-31,2011-03-25,104172000,208344000,312516000
6089,MTIG4,2011-03-31,2011-08-11,104172,208344,312516
6090,MTIG4,2011-06-30,2011-08-11,104172,208344,312516
6091,MTIG4,2011-09-30,2011-11-11,104172,208344,312516
6092,MTIG4,2011-12-31,2012-03-23,104172000,208344000,312516000
6093,MTIG4,2012-03-31,2012-05-07,104172,208344,312516
6094,MTIG4,2012-06-30,2012-07-31,104172,208344,312516
6095,MTIG4,2012-09-30,2012-11-07,104172,208344,312516
6096,MTIG4,2012-12-31,2013-03-21,104172000,208344000,312516000
6097,MTIG4,2013-03-31,2013-05-10,104172,208344,312516
6098,MTIG4,2013-06-30,2013-08-14,104172,208344,312516
6099,MTIG4,2013-09-30,2013-11-12,104172,208344,312516
6100,MTIG4,2013-12-31,2014-03-20,104172000,208344000,312516000
6101,MTIG4,2014-03-31,2014-05-26,104172,208344,312516
6102,MTIG4,2014-06-30,2014-08-13,104172,208344,312516
6103,MTIG4,2014-09-30,2014-11-12,104172,208344,312516
6104,MTIG4,2014-12-31,2015-03-27,104172000,208344000,312516000
6105,MTIG4,2015-03-31,2015-05-19,104172,208344,312516
6106,MTIG4,2015-06-30,2015-08-06,2083,4167,6250
6107,MTIG4,2015-09-30,2015-12-11,2083,4167,6250
6108,MTIG4,2015-12-31,2016-03-24,2083440,4166880,6250320
6109,MTIG4,2016-03-31,2016-05-13,2083440,4166880,6250320
6110,MTIG4,2016-06-30,2016-08-11,69448,138896,208344
6111,MTIG4,2016-09-30,2016-11-08,69448,138896,208344
6112,MTIG4,2016-12-31,2017-03-28,80448,160896,241344
6113,MTIG4,2017-03-31,2017-05-15,80448,160896,241344
6114,MTIG4,2017-06-30,2017-08-17,80448,160896,241344
6115,MTIG4,2017-09-30,2017-11-10,80448,160896,241344
6116,MTIG4,2017-12-31,2018-04-02,80448,160896,241344
6117,MTIG4,2018-03-31,2018-05-15,80448,160896,241344
6118,MTIG4,2018-06-30,2018-08-14,80448,160896,241344
6119,MTIG4,2018-09-30,2018-11-09,80448,160896,241344
6120,MTIG4,2018-12-31,2019-03-25,80448,160896,241344
6121,MTIG4,2019-03-31,2019-05-13,80448,160896,241344
6122,MTIG4,2019-06-30,2019-08-13,80448,160896,241344
6123,MTIG4,2019-09-30,2019-11-07,80448,160896,241344
6124,MTIG4,2019-12-31,2020-03-26,80448,160896,241344
6125,MTIG4,2020-03-31,2020-06-18,80448,160896,241344
6126,MTIG4,2020-06-30,2020-08-19,80448,160896,241344
6127,MTIG4,2020-09-30,2020-11-10,80448,160896,241344
6128,GOAU3,2010-12-31,2011-03-03,137619,275063,412682
6129,GOAU3,2011-03-31,2011-05-12,137618994,275062544,412681538
6130,GOAU3,2011-06-30,2011-08-04,137618994,275062544,412681538
6131,GOAU3,2011-09-30,2011-11-10,137618994,275062544,412681538
6132,GOAU3,2011-12-31,2012-02-16,137619,275062,412681
6133,GOAU3,2012-03-31,2012-05-03,137618994,275062544,412681538
6134,GOAU3,2012-06-30,2012-08-02,137618994,275062544,412681538
6135,GOAU3,2012-09-30,2012-11-01,137618994,275062544,412681538
6136,GOAU3,2012-12-31,2013-02-21,137618994,275062544,412681538
6137,GOAU3,2013-03-31,2013-05-07,137618994,275062544,412681538
6138,GOAU3,2013-06-30,2013-08-01,137618994,275062544,412681538
6139,GOAU3,2013-09-30,2013-10-31,137618994,275062544,412681538
6140,GOAU3,2013-12-31,2014-02-21,137618994,275062544,412681538
6141,GOAU3,2014-03-31,2014-05-13,137618994,275062544,412681538
6142,GOAU3,2014-06-30,2014-07-30,137618994,275062544,412681538
6143,GOAU3,2014-09-30,2014-11-12,137618994,275062544,412681538
6144,GOAU3,2014-12-31,2015-03-11,137618994,275062544,412681538
6145,GOAU3,2015-03-31,2015-05-06,137618994,275062544,412681538
6146,GOAU3,2015-06-30,2015-08-12,137618994,275062544,412681538
6147,GOAU3,2015-09-30,2015-10-29,137618994,275062544,412681538
6148,GOAU3,2015-12-31,2016-03-15,306923979,605757559,912681538
6149,GOAU3,2016-03-31,2016-05-04,306923979,605757559,912681538
6150,GOAU3,2016-06-30,2016-08-10,306923979,605757559,912681538
6151,GOAU3,2016-09-30,2016-11-09,307666387,607242375,914908762
6152,GOAU3,2016-12-31,2017-02-22,323987702,639885005,963872707
6153,GOAU3,2017-03-31,2017-05-04,329467079,650843759,980310838
6154,GOAU3,2017-06-30,2017-08-09,329957462,651824525,981781987
6155,GOAU3,2017-09-30,2017-11-08,330021614,651952829,981974443
6156,GOAU3,2017-12-31,2018-02-28,330071442,652052485,982123927
6157,GOAU3,2018-03-31,2018-05-09,330460178,652829957,983290135
6158,GOAU3,2018-06-30,2018-08-08,330521314,652952229,983473543
6159,GOAU3,2018-09-30,2018-11-07,330698131,653305863,984003994
6160,GOAU3,2018-12-31,2019-02-21,331256682,654422965,985679647
6161,GOAU3,2019-03-31,2019-05-08,331640474,655190549,986831023
6162,GOAU3,2019-06-30,2019-08-07,331870871,655651343,987522214
6163,GOAU3,2019-09-30,2019-10-30,365111201,722132003,1087243204
6164,GOAU3,2019-12-31,2020-02-19,365111201,722132003,1087243204
6165,GOAU3,2020-03-31,2020-05-06,365111201,722132003,1087243204
6166,GOAU3,2020-06-30,2020-08-05,365111201,722132003,1087243204
6167,GOAU3,2020-09-30,2020-10-28,365111201,722132003,1087243204
6168,GOAU3,2020-12-31,2021-02-24,365111201,722132003,1087243204
6169,GOAU4,2010-12-31,2011-03-03,137619,275063,412682
6170,GOAU4,2011-03-31,2011-05-12,137618994,275062544,412681538
6171,GOAU4,2011-06-30,2011-08-04,137618994,275062544,412681538
6172,GOAU4,2011-09-30,2011-11-10,137618994,275062544,412681538
6173,GOAU4,2011-12-31,2012-02-16,137619,275062,412681
6174,GOAU4,2012-03-31,2012-05-03,137618994,275062544,412681538
6175,GOAU4,2012-06-30,2012-08-02,137618994,275062544,412681538
6176,GOAU4,2012-09-30,2012-11-01,137618994,275062544,412681538
6177,GOAU4,2012-12-31,2013-02-21,137618994,275062544,412681538
6178,GOAU4,2013-03-31,2013-05-07,137618994,275062544,412681538
6179,GOAU4,2013-06-30,2013-08-01,137618994,275062544,412681538
6180,GOAU4,2013-09-30,2013-10-31,137618994,275062544,412681538
6181,GOAU4,2013-12-31,2014-02-21,137618994,275062544,412681538
6182,GOAU4,2014-03-31,2014-05-13,137618994,275062544,412681538
6183,GOAU4,2014-06-30,2014-07-30,137618994,275062544,412681538
6184,GOAU4,2014-09-30,2014-11-12,137618994,275062544,412681538
6185,GOAU4,2014-12-31,2015-03-11,137618994,275062544,412681538
6186,GOAU4,2015-03-31,2015-05-06,137618994,275062544,412681538
6187,GOAU4,2015-06-30,2015-08-12,137618994,275062544,412681538
6188,GOAU4,2015-09-30,2015-10-29,137618994,275062544,412681538
6189,GOAU4,2015-12-31,2016-03-15,306923979,605757559,912681538
6190,GOAU4,2016-03-31,2016-05-04,306923979,605757559,912681538
6191,GOAU4,2016-06-30,2016-08-10,306923979,605757559,912681538
6192,GOAU4,2016-09-30,2016-11-09,307666387,607242375,914908762
6193,GOAU4,2016-12-31,2017-02-22,323987702,639885005,963872707
6194,GOAU4,2017-03-31,2017-05-04,329467079,650843759,980310838
6195,GOAU4,2017-06-30,2017-08-09,329957462,651824525,981781987
6196,GOAU4,2017-09-30,2017-11-08,330021614,651952829,981974443
6197,GOAU4,2017-12-31,2018-02-28,330071442,652052485,982123927
6198,GOAU4,2018-03-31,2018-05-09,330460178,652829957,983290135
6199,GOAU4,2018-06-30,2018-08-08,330521314,652952229,983473543
6200,GOAU4,2018-09-30,2018-11-07,330698131,653305863,984003994
6201,GOAU4,2018-12-31,2019-02-21,331256682,654422965,985679647
6202,GOAU4,2019-03-31,2019-05-08,331640474,655190549,986831023
6203,GOAU4,2019-06-30,2019-08-07,331870871,655651343,987522214
6204,GOAU4,2019-09-30,2019-10-30,365111201,722132003,1087243204
6205,GOAU4,2019-12-31,2020-02-19,365111201,722132003,1087243204
6206,GOAU4,2020-03-31,2020-05-06,365111201,722132003,1087243204
6207,GOAU4,2020-06-30,2020-08-05,365111201,722132003,1087243204
6208,GOAU4,2020-09-30,2020-10-28,365111201,722132003,1087243204
6209,GOAU4,2020-12-31,2021-02-24,365111201,722132003,1087243204
6210,JPSA3,2010-12-31,2011-06-10,385823,578116,963939
6211,JPSA3,2011-03-31,2012-05-29,385823,578116,963939
6212,JPSA3,2011-06-30,2012-05-29,385823,578116,963939
6213,JPSA3,2011-09-30,2012-05-29,385823,578116,963939
6214,JPSA3,2011-12-31,2012-03-30,385823,578116,963939
6215,JPSA3,2012-03-31,2012-05-29,385823,578116,963939
6216,JPSA3,2012-06-30,2012-08-15,385823,578116,963939
6217,JPSA3,2012-09-30,2012-11-14,385823,578116,963939
6218,JPSA3,2012-12-31,2013-03-20,385823,578116,963939
6219,JPSA3,2013-03-31,2013-05-14,385823,578116,963939
6220,JPSA3,2013-06-30,2013-08-14,385823,578116,963939
6221,JPSA3,2013-09-30,2013-11-13,385823,578116,963939
6222,JPSA3,2013-12-31,2014-03-26,385823,578116,963939
6223,JPSA3,2014-03-31,2014-05-28,385823,578116,963939
6224,JPSA3,2014-06-30,2014-08-27,385823,578116,963939
6225,JPSA3,2014-09-30,2014-11-14,385823,578116,963939
6226,JPSA3,2014-12-31,2015-03-30,385823,578116,963939
6227,JPSA3,2015-03-31,2015-05-14,385823,578116,963939
6228,JPSA3,2015-06-30,2015-08-14,385823,578116,963939
6229,JPSA3,2015-09-30,2015-11-15,385823,578116,963939
6230,JPSA3,2015-12-31,2016-03-23,385823,578116,963939
6231,JPSA3,2016-03-31,2016-05-13,385823,578116,963939
6232,JPSA3,2016-06-30,2016-08-12,38582,57812,96394
6233,JPSA3,2016-09-30,2016-11-10,38582,57812,96394
6234,JPSA3,2016-12-31,2017-03-10,38578,55487,94065
6235,JPSA3,2017-03-31,2017-05-11,38577,54794,93371
6236,JPSA3,2017-06-30,2017-08-10,38577,54794,93371
6237,JPSA3,2017-09-30,2017-11-13,38577,54794,93371
6238,JPSA3,2017-12-31,2018-03-14,87892,0,87892
6239,JPSA3,2018-03-31,2018-05-10,87889,0,87889
6240,JPSA3,2018-06-30,2018-08-08,87889,0,87889
6241,JPSA3,2018-09-30,2018-11-13,87889,0,87889
6242,JPSA3,2018-12-31,2019-03-14,87889,0,87889
6243,JPSA3,2019-03-31,2019-05-14,87889,0,87889
6244,JPSA3,2019-06-30,2019-08-12,87889,0,87889
6245,JPSA3,2019-09-30,2019-11-12,87889,0,87889
6246,JPSA3,2019-12-31,2020-03-12,87889,0,87889
6247,JPSA3,2020-03-31,2020-06-04,87889,0,87889
6248,JPSA3,2020-06-30,2020-08-11,87889,0,87889
6249,JPSA3,2020-09-30,2020-11-12,87889,0,87889
6250,JPSA3,2020-12-31,2021-03-11,87889,0,87889
6251,MTSA3,2010-12-31,2011-03-30,4212530,5551953,9764483
6252,MTSA3,2011-03-31,2011-05-13,4212530,5551953,9764483
6253,MTSA3,2011-06-30,2011-08-12,4212530,5551953,9764483
6254,MTSA3,2011-09-30,2011-10-31,4212530,5551953,9764483
6255,MTSA3,2011-12-31,2012-03-09,4212530,5551953,9764483
6256,MTSA3,2012-03-31,2012-05-14,4212530,5551953,9764483
6257,MTSA3,2012-06-30,2012-08-13,4212530,5551953,9764483
6258,MTSA3,2012-09-30,2012-11-12,4212530,5551953,9764483
6259,MTSA3,2012-12-31,2013-03-18,4212530,5551953,9764483
6260,MTSA3,2013-03-31,2013-05-08,4212530,5551953,9764483
6261,MTSA3,2013-06-30,2013-08-12,4212530,5551953,9764483
6262,MTSA3,2013-09-30,2013-11-07,4212530,5551953,9764483
6263,MTSA3,2013-12-31,2014-03-21,4212530,5551953,9764483
6264,MTSA3,2014-03-31,2014-04-30,4212530,5551953,9764483
6265,MTSA3,2014-06-30,2014-08-01,4212530,5551953,9764483
6266,MTSA3,2014-09-30,2014-11-04,4212530,5551953,9764483
6267,MTSA3,2014-12-31,2015-03-24,4212530,5551953,9764483
6268,MTSA3,2015-03-31,2015-05-07,4212530,5551953,9764483
6269,MTSA3,2015-06-30,2015-08-13,4212530,4924733,9137263
6270,MTSA3,2015-09-30,2015-11-09,4212530,4924733,9137263
6271,MTSA3,2015-12-31,2016-03-24,4212530,4924733,9137263
6272,MTSA3,2016-03-31,2016-05-12,4212530,4924733,9137263
6273,MTSA3,2016-06-30,2016-08-12,4212530,4924733,9137263
6274,MTSA3,2016-09-30,2016-11-08,4212530,4924733,9137263
6275,MTSA3,2016-12-31,2017-03-28,4212530,4924733,9137263
6276,MTSA3,2017-03-31,2017-05-05,4212530,4924733,9137263
6277,MTSA3,2017-06-30,2017-08-14,4212530,4924733,9137263
6278,MTSA3,2017-09-30,2017-11-10,4212530,4924733,9137263
6279,MTSA3,2017-12-31,2018-03-22,4212530,4924733,9137263
6280,MTSA3,2018-03-31,2018-05-15,4212530,4924733,9137263
6281,MTSA3,2018-06-30,2018-08-10,4212530,4924733,9137263
6282,MTSA3,2018-09-30,2018-11-12,4212530,4924733,9137263
6283,MTSA3,2018-12-31,2019-03-20,4212530,4924733,9137263
6284,MTSA3,2019-03-31,2019-05-14,4212530,4924733,9137263
6285,MTSA3,2019-06-30,2019-08-09,4212530,4924733,9137263
6286,MTSA3,2019-09-30,2019-11-13,4212530,4924733,9137263
6287,MTSA3,2019-12-31,2020-03-24,4212530,4924733,9137263
6288,MTSA3,2020-03-31,2020-05-13,4212530,4924733,9137263
6289,MTSA3,2020-06-30,2020-08-13,4212530,4924733,9137263
6290,MTSA3,2020-09-30,2020-11-10,4212530,4924733,9137263
6291,MTSA3,2020-12-31,2021-03-26,4212530,4924733,9137263
6292,MTSA4,2010-12-31,2011-03-30,4212530,5551953,9764483
6293,MTSA4,2011-03-31,2011-05-13,4212530,5551953,9764483
6294,MTSA4,2011-06-30,2011-08-12,4212530,5551953,9764483
6295,MTSA4,2011-09-30,2011-10-31,4212530,5551953,9764483
6296,MTSA4,2011-12-31,2012-03-09,4212530,5551953,9764483
6297,MTSA4,2012-03-31,2012-05-14,4212530,5551953,9764483
6298,MTSA4,2012-06-30,2012-08-13,4212530,5551953,9764483
6299,MTSA4,2012-09-30,2012-11-12,4212530,5551953,9764483
6300,MTSA4,2012-12-31,2013-03-18,4212530,5551953,9764483
6301,MTSA4,2013-03-31,2013-05-08,4212530,5551953,9764483
6302,MTSA4,2013-06-30,2013-08-12,4212530,5551953,9764483
6303,MTSA4,2013-09-30,2013-11-07,4212530,5551953,9764483
6304,MTSA4,2013-12-31,2014-03-21,4212530,5551953,9764483
6305,MTSA4,2014-03-31,2014-04-30,4212530,5551953,9764483
6306,MTSA4,2014-06-30,2014-08-01,4212530,5551953,9764483
6307,MTSA4,2014-09-30,2014-11-04,4212530,5551953,9764483
6308,MTSA4,2014-12-31,2015-03-24,4212530,5551953,9764483
6309,MTSA4,2015-03-31,2015-05-07,4212530,5551953,9764483
6310,MTSA4,2015-06-30,2015-08-13,4212530,4924733,9137263
6311,MTSA4,2015-09-30,2015-11-09,4212530,4924733,9137263
6312,MTSA4,2015-12-31,2016-03-24,4212530,4924733,9137263
6313,MTSA4,2016-03-31,2016-05-12,4212530,4924733,9137263
6314,MTSA4,2016-06-30,2016-08-12,4212530,4924733,9137263
6315,MTSA4,2016-09-30,2016-11-08,4212530,4924733,9137263
6316,MTSA4,2016-12-31,2017-03-28,4212530,4924733,9137263
6317,MTSA4,2017-03-31,2017-05-05,4212530,4924733,9137263
6318,MTSA4,2017-06-30,2017-08-14,4212530,4924733,9137263
6319,MTSA4,2017-09-30,2017-11-10,4212530,4924733,9137263
6320,MTSA4,2017-12-31,2018-03-22,4212530,4924733,9137263
6321,MTSA4,2018-03-31,2018-05-15,4212530,4924733,9137263
6322,MTSA4,2018-06-30,2018-08-10,4212530,4924733,9137263
6323,MTSA4,2018-09-30,2018-11-12,4212530,4924733,9137263
6324,MTSA4,2018-12-31,2019-03-20,4212530,4924733,9137263
6325,MTSA4,2019-03-31,2019-05-14,4212530,4924733,9137263
6326,MTSA4,2019-06-30,2019-08-09,4212530,4924733,9137263
6327,MTSA4,2019-09-30,2019-11-13,4212530,4924733,9137263
6328,MTSA4,2019-12-31,2020-03-24,4212530,4924733,9137263
6329,MTSA4,2020-03-31,2020-05-13,4212530,4924733,9137263
6330,MTSA4,2020-06-30,2020-08-13,4212530,4924733,9137263
6331,MTSA4,2020-09-30,2020-11-10,4212530,4924733,9137263
6332,MTSA4,2020-12-31,2021-03-26,4212530,4924733,9137263
6333,MMAQ3,2010-12-31,2011-03-11,22,22,44
6334,MMAQ3,2011-03-31,2011-05-12,22,22,44
6335,MMAQ3,2011-06-30,2011-08-11,22,22,44
6336,MMAQ3,2011-09-30,2011-11-10,22,22,44
6337,MMAQ3,2011-12-31,2012-03-09,22,22,44
6338,MMAQ3,2012-03-31,2012-05-14,22,22,44
6339,MMAQ3,2012-06-30,2012-08-14,22,22,44
6340,MMAQ3,2012-09-30,2012-11-06,22,22,44
6341,MMAQ3,2012-12-31,2013-03-08,22,22,44
6342,MMAQ3,2013-03-31,2013-05-10,22,22,44
6343,MMAQ3,2013-06-30,2013-08-12,22,22,44
6344,MMAQ3,2013-09-30,2013-11-12,22,22,44
6345,MMAQ3,2013-12-31,2014-03-14,22,22,44
6346,MMAQ3,2014-03-31,2014-05-14,22,22,44
6347,MMAQ3,2014-06-30,2014-08-13,22,22,44
6348,MMAQ3,2014-09-30,2014-11-12,22,22,44
6349,MMAQ3,2014-12-31,2015-03-06,22,22,44
6350,MMAQ3,2015-03-31,2015-05-14,22,22,44
6351,MMAQ3,2015-06-30,2015-08-12,22,22,44
6352,MMAQ3,2015-09-30,2015-11-11,22,22,44
6353,MMAQ3,2015-12-31,2016-03-11,22,22,44
6354,MMAQ3,2016-03-31,2016-05-12,22,22,44
6355,MMAQ3,2016-06-30,2016-08-12,22,22,44
6356,MMAQ3,2016-09-30,2016-11-11,22,22,44
6357,MMAQ3,2016-12-31,2017-01-27,22,22,44
6358,MMAQ3,2017-03-31,2017-05-12,22,22,44
6359,MMAQ3,2017-06-30,2017-08-03,22,22,44
6360,MMAQ3,2017-09-30,2017-11-07,22,22,44
6361,MMAQ3,2017-12-31,2018-03-23,22,22,44
6362,MMAQ3,2018-03-31,2018-05-14,22,22,44
6363,MMAQ3,2018-06-30,2018-08-10,22,22,44
6364,MMAQ3,2018-09-30,2018-11-13,22,22,44
6365,MMAQ3,2018-12-31,2019-03-23,22,22,44
6366,MMAQ3,2019-03-31,2019-05-14,22,22,44
6367,MMAQ3,2019-06-30,2019-08-13,22,22,44
6368,MMAQ3,2019-09-30,2019-11-13,22,22,44
6369,MMAQ3,2019-12-31,2020-03-20,22,22,44
6370,MMAQ3,2020-03-31,2020-05-14,22,22,44
6371,MMAQ3,2020-06-30,2020-08-13,22,22,44
6372,MMAQ3,2020-09-30,2020-11-12,22,22,44
6373,MMAQ3,2020-12-31,2021-03-19,22,22,44
6374,MMAQ4,2010-12-31,2011-03-11,22,22,44
6375,MMAQ4,2011-03-31,2011-05-12,22,22,44
6376,MMAQ4,2011-06-30,2011-08-11,22,22,44
6377,MMAQ4,2011-09-30,2011-11-10,22,22,44
6378,MMAQ4,2011-12-31,2012-03-09,22,22,44
6379,MMAQ4,2012-03-31,2012-05-14,22,22,44
6380,MMAQ4,2012-06-30,2012-08-14,22,22,44
6381,MMAQ4,2012-09-30,2012-11-06,22,22,44
6382,MMAQ4,2012-12-31,2013-03-08,22,22,44
6383,MMAQ4,2013-03-31,2013-05-10,22,22,44
6384,MMAQ4,2013-06-30,2013-08-12,22,22,44
6385,MMAQ4,2013-09-30,2013-11-12,22,22,44
6386,MMAQ4,2013-12-31,2014-03-14,22,22,44
6387,MMAQ4,2014-03-31,2014-05-14,22,22,44
6388,MMAQ4,2014-06-30,2014-08-13,22,22,44
6389,MMAQ4,2014-09-30,2014-11-12,22,22,44
6390,MMAQ4,2014-12-31,2015-03-06,22,22,44
6391,MMAQ4,2015-03-31,2015-05-14,22,22,44
6392,MMAQ4,2015-06-30,2015-08-12,22,22,44
6393,MMAQ4,2015-09-30,2015-11-11,22,22,44
6394,MMAQ4,2015-12-31,2016-03-11,22,22,44
6395,MMAQ4,2016-03-31,2016-05-12,22,22,44
6396,MMAQ4,2016-06-30,2016-08-12,22,22,44
6397,MMAQ4,2016-09-30,2016-11-11,22,22,44
6398,MMAQ4,2016-12-31,2017-01-27,22,22,44
6399,MMAQ4,2017-03-31,2017-05-12,22,22,44
6400,MMAQ4,2017-06-30,2017-08-03,22,22,44
6401,MMAQ4,2017-09-30,2017-11-07,22,22,44
6402,MMAQ4,2017-12-31,2018-03-23,22,22,44
6403,MMAQ4,2018-03-31,2018-05-14,22,22,44
6404,MMAQ4,2018-06-30,2018-08-10,22,22,44
6405,MMAQ4,2018-09-30,2018-11-13,22,22,44
6406,MMAQ4,2018-12-31,2019-03-23,22,22,44
6407,MMAQ4,2019-03-31,2019-05-14,22,22,44
6408,MMAQ4,2019-06-30,2019-08-13,22,22,44
6409,MMAQ4,2019-09-30,2019-11-13,22,22,44
6410,MMAQ4,2019-12-31,2020-03-20,22,22,44
6411,MMAQ4,2020-03-31,2020-05-14,22,22,44
6412,MMAQ4,2020-06-30,2020-08-13,22,22,44
6413,MMAQ4,2020-09-30,2020-11-12,22,22,44
6414,MMAQ4,2020-12-31,2021-03-19,22,22,44
6415,MOAR3,2010-12-31,2011-07-14,11298,0,11298
6416,MOAR3,2011-03-31,2011-09-17,11298,0,11298
6417,MOAR3,2011-06-30,2011-10-10,11298,0,11298
6418,MOAR3,2011-09-30,2011-11-14,11298,0,11298
6419,MOAR3,2011-12-31,2012-05-22,11298,0,11298
6420,MOAR3,2012-03-31,2012-07-06,11298,0,11298
6421,MOAR3,2012-06-30,2012-09-10,11298,0,11298
6422,MOAR3,2012-09-30,2013-01-25,11298,0,11298
6423,MOAR3,2012-12-31,2013-05-15,11298,0,11298
6424,MOAR3,2013-03-31,2013-06-28,12251,0,12251
6425,MOAR3,2013-06-30,2013-08-14,12251,0,12251
6426,MOAR3,2013-09-30,2013-11-14,12251,0,12251
6427,MOAR3,2013-12-31,2014-03-31,12251,0,12251
6428,MOAR3,2014-03-31,2014-05-20,12251,0,12251
6429,MOAR3,2014-06-30,2014-08-15,12251,0,12251
6430,MOAR3,2014-09-30,2014-11-13,12251,0,12251
6431,MOAR3,2014-12-31,2015-03-31,12251,0,12251
6432,MOAR3,2015-03-31,2017-01-24,12251,0,12251
6433,MOAR3,2015-06-30,2015-08-14,12251,0,12251
6434,MOAR3,2015-09-30,2015-11-13,12251,0,12251
6435,MOAR3,2015-12-31,2016-03-30,12251,0,12251
6436,MOAR3,2016-03-31,2016-05-19,12251,0,12251
6437,MOAR3,2016-06-30,2016-08-12,12251,0,12251
6438,MOAR3,2016-09-30,2016-11-14,12251,0,12251
6439,MOAR3,2016-12-31,2017-03-28,12251,0,12251
6440,MOAR3,2017-03-31,2017-05-15,12251,0,12251
6441,MOAR3,2017-06-30,2017-08-14,12251,0,12251
6442,MOAR3,2017-09-30,2017-11-14,12251,0,12251
6443,MOAR3,2017-12-31,2018-04-04,12251,0,12251
6444,MOAR3,2018-03-31,2018-05-15,12251,0,12251
6445,MOAR3,2018-06-30,2018-08-14,12251,0,12251
6446,MOAR3,2018-09-30,2018-11-14,12251,0,12251
6447,MOAR3,2018-12-31,2019-04-02,12251221,0,12251221
6448,MOAR3,2019-03-31,2019-05-15,12251221,0,12251221
6449,MOAR3,2019-06-30,2019-08-14,12251221,0,12251221
6450,MOAR3,2019-09-30,2019-11-14,12251221,0,12251221
6451,MOAR3,2019-12-31,2020-03-26,12251221,0,12251221
6452,MOAR3,2020-03-31,2020-05-15,12251221,0,12251221
6453,MOAR3,2020-06-30,2020-08-14,12251221,0,12251221
6454,MOAR3,2020-09-30,2020-11-13,12251221,0,12251221
6455,NAFG3,2010-12-31,2011-10-04,5514,8065,13579
6456,NAFG3,2011-03-31,2011-05-20,5514,8065,13579
6457,NAFG3,2011-06-30,2011-08-15,5514,8065,13579
6458,NAFG3,2011-09-30,2011-11-11,5514,8065,13579
6459,NAFG3,2011-12-31,2012-03-30,5514,8065,13579
6460,NAFG3,2012-03-31,2012-05-15,5514,8065,13579
6461,NAFG3,2012-06-30,2012-08-14,5514,8065,13579
6462,NAFG3,2012-09-30,2012-11-14,5514,8065,13579
6463,NAFG3,2012-12-31,2013-03-29,5514,8065,13579
6464,NAFG3,2013-03-31,2013-05-15,5514,8065,13579
6465,NAFG3,2013-06-30,2013-08-15,5514,8065,13579
6466,NAFG3,2013-09-30,2013-11-13,5514,8065,13579
6467,NAFG3,2013-12-31,2014-03-28,5514,8065,13579
6468,NAFG3,2014-03-31,2014-05-15,5514,8065,13579
6469,NAFG3,2014-06-30,2014-08-14,5514,8065,13579
6470,NAFG3,2014-09-30,2014-11-13,5514,8065,13579
6471,NAFG3,2014-12-31,2015-03-30,5514,8065,13579
6472,NAFG3,2015-03-31,2015-05-14,5514,8065,13579
6473,NAFG3,2015-06-30,2015-08-13,5514,8065,13579
6474,NAFG3,2015-09-30,2015-11-12,5514,8065,13579
6475,NAFG3,2015-12-31,2016-03-23,5514,8065,13579
6476,NAFG3,2016-03-31,2016-05-12,5514,8065,13579
6477,NAFG3,2016-06-30,2016-08-12,5514,8065,13579
6478,NAFG3,2016-09-30,2016-11-11,5514,8065,13579
6479,NAFG3,2016-12-31,2017-03-17,5514,8065,13579
6480,NAFG3,2017-03-31,2017-05-12,5514,8065,13579
6481,NAFG3,2017-06-30,2017-08-11,5514,8065,13579
6482,NAFG3,2017-09-30,2017-11-10,5514,8065,13579
6483,NAFG3,2017-12-31,2018-03-15,5514,8065,13579
6484,NAFG3,2018-03-31,2018-05-04,5514,8065,13579
6485,NAFG3,2018-06-30,2018-08-13,5514,8065,13579
6486,NAFG3,2018-09-30,2018-11-12,5514,8065,13579
6487,NAFG3,2018-12-31,2019-03-08,5514,8065,13579
6488,NAFG3,2019-03-31,2019-05-15,5514,8065,13579
6489,NAFG3,2019-06-30,2019-08-14,5514,8065,13579
6490,NAFG3,2019-09-30,2019-11-14,5514,8065,13579
6491,NAFG3,2019-12-31,2020-03-05,5514,8065,13579
6492,NAFG4,2010-12-31,2011-10-04,5514,8065,13579
6493,NAFG4,2011-03-31,2011-05-20,5514,8065,13579
6494,NAFG4,2011-06-30,2011-08-15,5514,8065,13579
6495,NAFG4,2011-09-30,2011-11-11,5514,8065,13579
6496,NAFG4,2011-12-31,2012-03-30,5514,8065,13579
6497,NAFG4,2012-03-31,2012-05-15,5514,8065,13579
6498,NAFG4,2012-06-30,2012-08-14,5514,8065,13579
6499,NAFG4,2012-09-30,2012-11-14,5514,8065,13579
6500,NAFG4,2012-12-31,2013-03-29,5514,8065,13579
6501,NAFG4,2013-03-31,2013-05-15,5514,8065,13579
6502,NAFG4,2013-06-30,2013-08-15,5514,8065,13579
6503,NAFG4,2013-09-30,2013-11-13,5514,8065,13579
6504,NAFG4,2013-12-31,2014-03-28,5514,8065,13579
6505,NAFG4,2014-03-31,2014-05-15,5514,8065,13579
6506,NAFG4,2014-06-30,2014-08-14,5514,8065,13579
6507,NAFG4,2014-09-30,2014-11-13,5514,8065,13579
6508,NAFG4,2014-12-31,2015-03-30,5514,8065,13579
6509,NAFG4,2015-03-31,2015-05-14,5514,8065,13579
6510,NAFG4,2015-06-30,2015-08-13,5514,8065,13579
6511,NAFG4,2015-09-30,2015-11-12,5514,8065,13579
6512,NAFG4,2015-12-31,2016-03-23,5514,8065,13579
6513,NAFG4,2016-03-31,2016-05-12,5514,8065,13579
6514,NAFG4,2016-06-30,2016-08-12,5514,8065,13579
6515,NAFG4,2016-09-30,2016-11-11,5514,8065,13579
6516,NAFG4,2016-12-31,2017-03-17,5514,8065,13579
6517,NAFG4,2017-03-31,2017-05-12,5514,8065,13579
6518,NAFG4,2017-06-30,2017-08-11,5514,8065,13579
6519,NAFG4,2017-09-30,2017-11-10,5514,8065,13579
6520,NAFG4,2017-12-31,2018-03-15,5514,8065,13579
6521,NAFG4,2018-03-31,2018-05-04,5514,8065,13579
6522,NAFG4,2018-06-30,2018-08-13,5514,8065,13579
6523,NAFG4,2018-09-30,2018-11-12,5514,8065,13579
6524,NAFG4,2018-12-31,2019-03-08,5514,8065,13579
6525,NAFG4,2019-03-31,2019-05-15,5514,8065,13579
6526,NAFG4,2019-06-30,2019-08-14,5514,8065,13579
6527,NAFG4,2019-09-30,2019-11-14,5514,8065,13579
6528,NAFG4,2019-12-31,2020-03-05,5514,8065,13579
6529,NEMO3,2010-12-31,2011-03-29,53200,73553,126753
6530,NEMO3,2011-03-31,2011-05-12,53200,73553,126753
6531,NEMO3,2011-06-30,2011-08-12,53200,73553,126753
6532,NEMO3,2011-09-30,2011-11-10,53200,73553,126753
6533,NEMO3,2011-12-31,2012-04-04,53200,73553,126753
6534,NEMO3,2012-03-31,2012-05-14,53200,73553,126753
6535,NEMO3,2012-06-30,2012-08-14,53200,73553,126753
6536,NEMO3,2012-09-30,2012-11-14,53200,73553,126753
6537,NEMO3,2012-12-31,2013-04-10,53200,73553,126753
6538,NEMO3,2013-03-31,2013-05-14,53200,73553,126753
6539,NEMO3,2013-06-30,2013-08-14,70805,97893,168698
6540,NEMO3,2013-09-30,2013-11-11,70805,97893,168698
6541,NEMO3,2013-12-31,2014-04-09,70805,97893,168698
6542,NEMO3,2014-03-31,2014-05-15,70805,97893,168698
6543,NEMO3,2014-06-30,2014-08-14,70805,97893,168698
6544,NEMO3,2014-09-30,2014-11-13,70805,97893,168698
6545,NEMO3,2014-12-31,2015-04-10,70805,97893,168698
6546,NEMO3,2015-03-31,2015-05-12,70805,97893,168698
6547,NEMO3,2015-06-30,2015-08-13,70805,97893,168698
6548,NEMO3,2015-09-30,2015-11-12,70805,97893,168698
6549,NEMO3,2015-12-31,2016-03-24,70805,97893,168698
6550,NEMO3,2016-03-31,2016-05-12,70805,97893,168698
6551,NEMO3,2016-06-30,2016-08-12,70805,97893,168698
6552,NEMO3,2016-09-30,2016-11-10,75034,97893,172927
6553,NEMO3,2016-12-31,2017-05-04,75034,97893,172927
6554,NEMO3,2017-03-31,2017-05-12,75034,97893,172927
6555,NEMO3,2017-06-30,2017-08-10,75034,97893,172927
6556,NEMO3,2017-09-30,2017-11-10,75034,97893,172927
6557,NEMO3,2017-12-31,2018-03-06,75034,97893,172927
6558,NEMO3,2018-03-31,2018-05-14,75034,97893,172927
6559,NEMO3,2018-06-30,2018-08-14,75034,97893,172927
6560,NEMO3,2018-09-30,2018-11-14,75034,97893,172927
6561,NEMO3,2018-12-31,2019-03-20,75034,97893,172927
6562,NEMO3,2019-03-31,2019-05-15,75034,97893,172927
6563,NEMO3,2019-06-30,2019-08-14,75034,97893,172927
6564,NEMO3,2019-09-30,2019-11-14,75034,97893,172927
6565,NEMO3,2019-12-31,2020-03-17,75034,97893,172927
6566,NEMO3,2020-03-31,2020-05-26,75034,97893,172927
6567,NEMO3,2020-06-30,2020-08-14,75034,97893,172927
6568,NEMO3,2020-09-30,2020-11-10,75034,97893,172927
6569,NEMO3,2020-12-31,2021-03-15,75034,97893,172927
6570,NEMO5,2010-12-31,2011-03-29,53200,73553,126753
6571,NEMO5,2011-03-31,2011-05-12,53200,73553,126753
6572,NEMO5,2011-06-30,2011-08-12,53200,73553,126753
6573,NEMO5,2011-09-30,2011-11-10,53200,73553,126753
6574,NEMO5,2011-12-31,2012-04-04,53200,73553,126753
6575,NEMO5,2012-03-31,2012-05-14,53200,73553,126753
6576,NEMO5,2012-06-30,2012-08-14,53200,73553,126753
6577,NEMO5,2012-09-30,2012-11-14,53200,73553,126753
6578,NEMO5,2012-12-31,2013-04-10,53200,73553,126753
6579,NEMO5,2013-03-31,2013-05-14,53200,73553,126753
6580,NEMO5,2013-06-30,2013-08-14,70805,97893,168698
6581,NEMO5,2013-09-30,2013-11-11,70805,97893,168698
6582,NEMO5,2013-12-31,2014-04-09,70805,97893,168698
6583,NEMO5,2014-03-31,2014-05-15,70805,97893,168698
6584,NEMO5,2014-06-30,2014-08-14,70805,97893,168698
6585,NEMO5,2014-09-30,2014-11-13,70805,97893,168698
6586,NEMO5,2014-12-31,2015-04-10,70805,97893,168698
6587,NEMO5,2015-03-31,2015-05-12,70805,97893,168698
6588,NEMO5,2015-06-30,2015-08-13,70805,97893,168698
6589,NEMO5,2015-09-30,2015-11-12,70805,97893,168698
6590,NEMO5,2015-12-31,2016-03-24,70805,97893,168698
6591,NEMO5,2016-03-31,2016-05-12,70805,97893,168698
6592,NEMO5,2016-06-30,2016-08-12,70805,97893,168698
6593,NEMO5,2016-09-30,2016-11-10,75034,97893,172927
6594,NEMO5,2016-12-31,2017-05-04,75034,97893,172927
6595,NEMO5,2017-03-31,2017-05-12,75034,97893,172927
6596,NEMO5,2017-06-30,2017-08-10,75034,97893,172927
6597,NEMO5,2017-09-30,2017-11-10,75034,97893,172927
6598,NEMO5,2017-12-31,2018-03-06,75034,97893,172927
6599,NEMO5,2018-03-31,2018-05-14,75034,97893,172927
6600,NEMO5,2018-06-30,2018-08-14,75034,97893,172927
6601,NEMO5,2018-09-30,2018-11-14,75034,97893,172927
6602,NEMO5,2018-12-31,2019-03-20,75034,97893,172927
6603,NEMO5,2019-03-31,2019-05-15,75034,97893,172927
6604,NEMO5,2019-06-30,2019-08-14,75034,97893,172927
6605,NEMO5,2019-09-30,2019-11-14,75034,97893,172927
6606,NEMO5,2019-12-31,2020-03-17,75034,97893,172927
6607,NEMO5,2020-03-31,2020-05-26,75034,97893,172927
6608,NEMO5,2020-06-30,2020-08-14,75034,97893,172927
6609,NEMO5,2020-09-30,2020-11-10,75034,97893,172927
6610,NEMO5,2020-12-31,2021-03-15,75034,97893,172927
6611,NEMO6,2010-12-31,2011-03-29,53200,73553,126753
6612,NEMO6,2011-03-31,2011-05-12,53200,73553,126753
6613,NEMO6,2011-06-30,2011-08-12,53200,73553,126753
6614,NEMO6,2011-09-30,2011-11-10,53200,73553,126753
6615,NEMO6,2011-12-31,2012-04-04,53200,73553,126753
6616,NEMO6,2012-03-31,2012-05-14,53200,73553,126753
6617,NEMO6,2012-06-30,2012-08-14,53200,73553,126753
6618,NEMO6,2012-09-30,2012-11-14,53200,73553,126753
6619,NEMO6,2012-12-31,2013-04-10,53200,73553,126753
6620,NEMO6,2013-03-31,2013-05-14,53200,73553,126753
6621,NEMO6,2013-06-30,2013-08-14,70805,97893,168698
6622,NEMO6,2013-09-30,2013-11-11,70805,97893,168698
6623,NEMO6,2013-12-31,2014-04-09,70805,97893,168698
6624,NEMO6,2014-03-31,2014-05-15,70805,97893,168698
6625,NEMO6,2014-06-30,2014-08-14,70805,97893,168698
6626,NEMO6,2014-09-30,2014-11-13,70805,97893,168698
6627,NEMO6,2014-12-31,2015-04-10,70805,97893,168698
6628,NEMO6,2015-03-31,2015-05-12,70805,97893,168698
6629,NEMO6,2015-06-30,2015-08-13,70805,97893,168698
6630,NEMO6,2015-09-30,2015-11-12,70805,97893,168698
6631,NEMO6,2015-12-31,2016-03-24,70805,97893,168698
6632,NEMO6,2016-03-31,2016-05-12,70805,97893,168698
6633,NEMO6,2016-06-30,2016-08-12,70805,97893,168698
6634,NEMO6,2016-09-30,2016-11-10,75034,97893,172927
6635,NEMO6,2016-12-31,2017-05-04,75034,97893,172927
6636,NEMO6,2017-03-31,2017-05-12,75034,97893,172927
6637,NEMO6,2017-06-30,2017-08-10,75034,97893,172927
6638,NEMO6,2017-09-30,2017-11-10,75034,97893,172927
6639,NEMO6,2017-12-31,2018-03-06,75034,97893,172927
6640,NEMO6,2018-03-31,2018-05-14,75034,97893,172927
6641,NEMO6,2018-06-30,2018-08-14,75034,97893,172927
6642,NEMO6,2018-09-30,2018-11-14,75034,97893,172927
6643,NEMO6,2018-12-31,2019-03-20,75034,97893,172927
6644,NEMO6,2019-03-31,2019-05-15,75034,97893,172927
6645,NEMO6,2019-06-30,2019-08-14,75034,97893,172927
6646,NEMO6,2019-09-30,2019-11-14,75034,97893,172927
6647,NEMO6,2019-12-31,2020-03-17,75034,97893,172927
6648,NEMO6,2020-03-31,2020-05-26,75034,97893,172927
6649,NEMO6,2020-06-30,2020-08-14,75034,97893,172927
6650,NEMO6,2020-09-30,2020-11-10,75034,97893,172927
6651,NEMO6,2020-12-31,2021-03-15,75034,97893,172927
6652,NORD3,2010-12-31,2011-03-29,6621487,0,6621487
6653,NORD3,2011-03-31,2011-04-29,6621487,0,6621487
6654,NORD3,2011-06-30,2011-07-29,6621487,0,6621487
6655,NORD3,2011-09-30,2011-10-31,6621487,0,6621487
6656,NORD3,2011-12-31,2012-03-28,6621487,0,6621487
6657,NORD3,2012-03-31,2012-08-20,6621487,0,6621487
6658,NORD3,2012-06-30,2012-08-20,6621487,0,6621487
6659,NORD3,2012-09-30,2012-10-29,6621487,0,6621487
6660,NORD3,2012-12-31,2013-03-28,6621487,0,6621487
6661,NORD3,2013-03-31,2013-04-29,6621487,0,6621487
6662,NORD3,2013-06-30,2013-07-30,6621487,0,6621487
6663,NORD3,2013-09-30,2013-10-31,6621487,0,6621487
6664,NORD3,2013-12-31,2014-03-28,6621487,0,6621487
6665,NORD3,2014-03-31,2014-05-06,6621487,0,6621487
6666,NORD3,2014-06-30,2014-08-14,6621487,0,6621487
6667,NORD3,2014-09-30,2014-10-31,6621487,0,6621487
6668,NORD3,2014-12-31,2015-03-26,6621487,0,6621487
6669,NORD3,2015-03-31,2015-05-11,6621487,0,6621487
6670,NORD3,2015-06-30,2015-08-14,6621487,0,6621487
6671,NORD3,2015-09-30,2015-11-13,6621487,0,6621487
6672,NORD3,2015-12-31,2016-03-30,6621487,0,6621487
6673,NORD3,2016-03-31,2016-05-17,6621487,0,6621487
6674,NORD3,2016-06-30,2016-08-15,6621,0,6621
6675,NORD3,2016-09-30,2016-11-16,6621,0,6621
6676,NORD3,2016-12-31,2017-04-20,6621,0,6621
6677,NORD3,2017-03-31,2017-05-15,6621,0,6621
6678,NORD3,2017-06-30,2017-08-15,6621,0,6621
6679,NORD3,2017-09-30,2017-11-14,6621,0,6621
6680,NORD3,2017-12-31,2018-03-29,6621,0,6621
6681,NORD3,2018-03-31,2018-05-14,6621,0,6621
6682,NORD3,2018-06-30,2018-08-15,6621,0,6621
6683,NORD3,2018-09-30,2018-11-14,6621,0,6621
6684,NORD3,2018-12-31,2019-03-29,6621,0,6621
6685,NORD3,2019-03-31,2019-05-15,6621,0,6621
6686,NORD3,2019-06-30,2019-08-13,6621,0,6621
6687,NORD3,2019-09-30,2019-11-14,6621,0,6621
6688,NORD3,2019-12-31,2020-03-27,6621,0,6621
6689,NORD3,2020-03-31,2020-05-15,6621,0,6621
6690,NORD3,2020-06-30,2020-08-31,6621,0,6621
6691,NORD3,2020-09-30,2020-11-16,6621,0,6621
6692,PNVL3,2010-12-31,2011-05-12,4142194,450003,4592197
6693,PNVL3,2011-03-31,2011-05-20,4142194,450003,4592197
6694,PNVL3,2011-06-30,2011-08-13,4128059,450003,4578062
6695,PNVL3,2011-09-30,2011-11-14,4128059,450003,4578062
6696,PNVL3,2011-12-31,2012-03-26,4128059,450003,4578062
6697,PNVL3,2012-03-31,2012-05-11,4128059,450003,4578062
6698,PNVL3,2012-06-30,2012-08-14,4121059,449523,4570582
6699,PNVL3,2012-09-30,2012-11-12,4121059,449523,4570582
6700,PNVL3,2012-12-31,2013-03-26,4121059,449523,4570582
6701,PNVL3,2013-03-31,2013-05-15,4121059,449523,4570582
6702,PNVL3,2013-06-30,2013-08-14,4119052,449523,4568575
6703,PNVL3,2013-09-30,2013-11-13,4119052,449523,4568575
6704,PNVL3,2013-12-31,2014-03-28,4119052,449523,4568575
6705,PNVL3,2014-03-31,2014-05-15,4119052,449523,4568575
6706,PNVL3,2014-06-30,2014-08-14,4116052,449523,4565575
6707,PNVL3,2014-09-30,2014-11-14,4116052,449523,4565575
6708,PNVL3,2014-12-31,2015-03-27,4116052,449523,4565575
6709,PNVL3,2015-03-31,2015-05-15,4116052,449523,4565575
6710,PNVL3,2015-06-30,2015-08-14,4116052,449523,4565575
6711,PNVL3,2015-09-30,2015-11-13,4116052,449523,4565575
6712,PNVL3,2015-12-31,2016-03-29,4116052,449523,4565575
6713,PNVL3,2016-03-31,2016-05-13,4116052,449523,4565575
6714,PNVL3,2016-06-30,2016-08-15,4109790,449523,4559313
6715,PNVL3,2016-09-30,2016-11-14,4109790,449523,4559313
6716,PNVL3,2016-12-31,2017-03-28,4109790,449523,4559313
6717,PNVL3,2017-03-31,2017-05-15,4109790,449523,4559313
6718,PNVL3,2017-06-30,2017-08-14,4109790,449523,4559313
6719,PNVL3,2017-09-30,2017-11-10,4109790,449523,4559313
6720,PNVL3,2017-12-31,2018-03-26,4109790,449523,4559313
6721,PNVL3,2018-03-31,2018-05-11,4109790,449523,4559313
6722,PNVL3,2018-06-30,2018-08-14,4094790,449523,4544313
6723,PNVL3,2018-09-30,2018-11-14,4092790,449523,4542313
6724,PNVL3,2018-12-31,2019-03-26,4092790,449523,4542313
6725,PNVL3,2019-03-31,2019-05-15,4092790,449523,4542313
6726,PNVL3,2019-06-30,2019-08-14,4066490,449523,4516013
6727,PNVL3,2019-09-30,2019-11-13,4066490,449523,4516013
6728,PNVL3,2019-12-31,2020-03-31,4066490,449523,4516013
6729,PNVL3,2020-03-31,2020-05-22,121994700,13485690,135480390
6730,PNVL3,2020-06-30,2020-08-27,121994700,13485690,135480390
6731,PNVL3,2020-09-30,2020-11-16,137994700,13485690,151480390
6732,PNVL3,2020-12-31,2021-03-24,137994700,13485690,151480390
6733,PNVL4,2010-12-31,2011-05-12,4142194,450003,4592197
6734,PNVL4,2011-03-31,2011-05-20,4142194,450003,4592197
6735,PNVL4,2011-06-30,2011-08-13,4128059,450003,4578062
6736,PNVL4,2011-09-30,2011-11-14,4128059,450003,4578062
6737,PNVL4,2011-12-31,2012-03-26,4128059,450003,4578062
6738,PNVL4,2012-03-31,2012-05-11,4128059,450003,4578062
6739,PNVL4,2012-06-30,2012-08-14,4121059,449523,4570582
6740,PNVL4,2012-09-30,2012-11-12,4121059,449523,4570582
6741,PNVL4,2012-12-31,2013-03-26,4121059,449523,4570582
6742,PNVL4,2013-03-31,2013-05-15,4121059,449523,4570582
6743,PNVL4,2013-06-30,2013-08-14,4119052,449523,4568575
6744,PNVL4,2013-09-30,2013-11-13,4119052,449523,4568575
6745,PNVL4,2013-12-31,2014-03-28,4119052,449523,4568575
6746,PNVL4,2014-03-31,2014-05-15,4119052,449523,4568575
6747,PNVL4,2014-06-30,2014-08-14,4116052,449523,4565575
6748,PNVL4,2014-09-30,2014-11-14,4116052,449523,4565575
6749,PNVL4,2014-12-31,2015-03-27,4116052,449523,4565575
6750,PNVL4,2015-03-31,2015-05-15,4116052,449523,4565575
6751,PNVL4,2015-06-30,2015-08-14,4116052,449523,4565575
6752,PNVL4,2015-09-30,2015-11-13,4116052,449523,4565575
6753,PNVL4,2015-12-31,2016-03-29,4116052,449523,4565575
6754,PNVL4,2016-03-31,2016-05-13,4116052,449523,4565575
6755,PNVL4,2016-06-30,2016-08-15,4109790,449523,4559313
6756,PNVL4,2016-09-30,2016-11-14,4109790,449523,4559313
6757,PNVL4,2016-12-31,2017-03-28,4109790,449523,4559313
6758,PNVL4,2017-03-31,2017-05-15,4109790,449523,4559313
6759,PNVL4,2017-06-30,2017-08-14,4109790,449523,4559313
6760,PNVL4,2017-09-30,2017-11-10,4109790,449523,4559313
6761,PNVL4,2017-12-31,2018-03-26,4109790,449523,4559313
6762,PNVL4,2018-03-31,2018-05-11,4109790,449523,4559313
6763,PNVL4,2018-06-30,2018-08-14,4094790,449523,4544313
6764,PNVL4,2018-09-30,2018-11-14,4092790,449523,4542313
6765,PNVL4,2018-12-31,2019-03-26,4092790,449523,4542313
6766,PNVL4,2019-03-31,2019-05-15,4092790,449523,4542313
6767,PNVL4,2019-06-30,2019-08-14,4066490,449523,4516013
6768,PNVL4,2019-09-30,2019-11-13,4066490,449523,4516013
6769,PNVL4,2019-12-31,2020-03-31,4066490,449523,4516013
6770,PNVL4,2020-03-31,2020-05-22,121994700,13485690,135480390
6771,PNVL4,2020-06-30,2020-08-27,121994700,13485690,135480390
6772,PNVL4,2020-09-30,2020-11-16,137994700,13485690,151480390
6773,PNVL4,2020-12-31,2021-03-24,137994700,13485690,151480390
6774,PMAM3,2010-12-31,2011-04-28,319176942,0,319176942
6775,PMAM3,2011-03-31,2011-05-13,319176942,0,319176942
6776,PMAM3,2011-06-30,2011-08-12,319176942,0,319176942
6777,PMAM3,2011-09-30,2011-11-10,319176942,0,319176942
6778,PMAM3,2011-12-31,2012-03-27,319176942,0,319176942
6779,PMAM3,2012-03-31,2012-05-11,319176942,0,319176942
6780,PMAM3,2012-06-30,2012-08-10,319176942,0,319176942
6781,PMAM3,2012-09-30,2012-11-14,319176942,0,319176942
6782,PMAM3,2012-12-31,2013-02-28,319176942,0,319176942
6783,PMAM3,2013-03-31,2013-04-30,319176942,0,319176942
6784,PMAM3,2013-06-30,2013-07-31,319176942,0,319176942
6785,PMAM3,2013-09-30,2013-10-31,319176942,0,319176942
6786,PMAM3,2013-12-31,2014-02-26,319176942,0,319176942
6787,PMAM3,2014-03-31,2014-06-24,319176942,0,319176942
6788,PMAM3,2014-06-30,2014-07-31,319176942,0,319176942
6789,PMAM3,2014-09-30,2014-10-31,319176942,0,319176942
6790,PMAM3,2014-12-31,2015-02-11,319176942,0,319176942
6791,PMAM3,2015-03-31,2015-04-27,319176942,0,319176942
6792,PMAM3,2015-06-30,2015-07-29,319176942,0,319176942
6793,PMAM3,2015-09-30,2015-10-28,319176942,0,319176942
6794,PMAM3,2015-12-31,2016-02-11,319176942,0,319176942
6795,PMAM3,2016-03-31,2016-04-28,319176942,0,319176942
6796,PMAM3,2016-06-30,2016-08-23,319176942,0,319176942
6797,PMAM3,2016-09-30,2016-10-26,319176942,0,319176942
6798,PMAM3,2016-12-31,2017-03-30,319176942,0,319176942
6799,PMAM3,2017-03-31,2017-05-15,319176942,0,319176942
6800,PMAM3,2017-06-30,2017-07-25,319176942,0,319176942
6801,PMAM3,2017-09-30,2017-10-26,545047960,0,545047960
6802,PMAM3,2017-12-31,2018-02-07,688933769,0,688933769
6803,PMAM3,2018-03-31,2018-04-27,692370186,0,692370186
6804,PMAM3,2018-06-30,2018-07-26,692370186,0,692370186
6805,PMAM3,2018-09-30,2018-10-25,692370186,0,692370186
6806,PMAM3,2018-12-31,2019-02-13,692370186,0,692370186
6807,PMAM3,2019-03-31,2019-04-26,692370186,0,692370186
6808,PMAM3,2019-06-30,2019-08-12,41350802,0,41350802
6809,PMAM3,2019-09-30,2019-11-07,43403849,0,43403849
6810,PMAM3,2019-12-31,2020-03-16,43403849,0,43403849
6811,PMAM3,2020-03-31,2020-05-07,43403849,0,43403849
6812,PMAM3,2020-06-30,2020-08-03,43403849,0,43403849
6813,PMAM3,2020-09-30,2020-10-30,43403849,0,43403849
6814,PMAM3,2020-12-31,2021-03-04,43403849,0,43403849
6815,AHEB3,2010-12-31,2011-04-01,4080,114,4194
6816,AHEB3,2011-03-31,2011-05-13,4080,114,4194
6817,AHEB3,2011-06-30,2011-08-15,4080,114,4194
6818,AHEB3,2011-09-30,2011-11-16,4080,114,4194
6819,AHEB3,2011-12-31,2014-09-03,4080,114,4194
6820,AHEB3,2012-03-31,2012-05-15,4455,98,4553
6821,AHEB3,2012-06-30,2012-08-20,4455,98,4553
6822,AHEB3,2012-09-30,2012-12-10,4460,114,4574
6823,AHEB3,2012-12-31,2013-03-28,4460,113,4573
6824,AHEB3,2013-03-31,2013-05-14,4460,113,4573
6825,AHEB3,2013-06-30,2013-08-14,4460,113,4573
6826,AHEB3,2013-09-30,2013-11-14,4460,113,4573
6827,AHEB3,2013-12-31,2014-03-27,4460,113,4573
6828,AHEB3,2014-03-31,2014-05-14,4460,113,4573
6829,AHEB3,2014-06-30,2014-10-13,5064,113,5177
6830,AHEB3,2014-09-30,2014-11-14,5064,113,5177
6831,AHEB3,2014-12-31,2015-03-27,5064,113,5177
6832,AHEB3,2015-03-31,2015-05-15,5064,113,5177
6833,AHEB3,2015-06-30,2015-08-13,5064,113,5177
6834,AHEB3,2015-09-30,2015-11-13,5064,113,5177
6835,AHEB3,2015-12-31,2016-03-30,5064,113,5177
6836,AHEB3,2016-03-31,2016-07-14,5064,113,5177
6837,AHEB3,2016-06-30,2016-08-12,5064,113,5177
6838,AHEB3,2016-09-30,2016-11-11,5064,113,5177
6839,AHEB3,2016-12-31,2017-07-31,5064,113,5177
6840,AHEB3,2017-03-31,2017-08-14,5064,113,5177
6841,AHEB3,2017-06-30,2017-08-14,5064,113,5177
6842,AHEB3,2017-09-30,2017-11-13,5064,113,5177
6843,AHEB3,2017-12-31,2018-03-22,5064,113,5177
6844,AHEB3,2018-03-31,2018-05-10,5064,113,5177
6845,AHEB3,2018-06-30,2018-08-06,5064,113,5177
6846,AHEB3,2018-09-30,2018-11-09,7390,132,7522
6847,AHEB3,2018-12-31,2019-03-28,7390,132,7522
6848,AHEB3,2019-03-31,2019-05-14,7390,131,7521
6849,AHEB3,2019-06-30,2019-08-13,7390,131,7521
6850,AHEB3,2019-09-30,2019-11-13,7390,131,7521
6851,AHEB3,2019-12-31,2020-03-27,7390,131,7521
6852,AHEB3,2020-03-31,2020-07-15,7390,131,7521
6853,AHEB3,2020-06-30,2020-10-08,8407,135,8542
6854,AHEB3,2020-09-30,2020-11-23,8407,136,8543
6855,AHEB3,2020-12-31,2021-03-26,8407,136,8543
6856,AHEB5,2010-12-31,2011-04-01,4080,114,4194
6857,AHEB5,2011-03-31,2011-05-13,4080,114,4194
6858,AHEB5,2011-06-30,2011-08-15,4080,114,4194
6859,AHEB5,2011-09-30,2011-11-16,4080,114,4194
6860,AHEB5,2011-12-31,2014-09-03,4080,114,4194
6861,AHEB5,2012-03-31,2012-05-15,4455,98,4553
6862,AHEB5,2012-06-30,2012-08-20,4455,98,4553
6863,AHEB5,2012-09-30,2012-12-10,4460,114,4574
6864,AHEB5,2012-12-31,2013-03-28,4460,113,4573
6865,AHEB5,2013-03-31,2013-05-14,4460,113,4573
6866,AHEB5,2013-06-30,2013-08-14,4460,113,4573
6867,AHEB5,2013-09-30,2013-11-14,4460,113,4573
6868,AHEB5,2013-12-31,2014-03-27,4460,113,4573
6869,AHEB5,2014-03-31,2014-05-14,4460,113,4573
6870,AHEB5,2014-06-30,2014-10-13,5064,113,5177
6871,AHEB5,2014-09-30,2014-11-14,5064,113,5177
6872,AHEB5,2014-12-31,2015-03-27,5064,113,5177
6873,AHEB5,2015-03-31,2015-05-15,5064,113,5177
6874,AHEB5,2015-06-30,2015-08-13,5064,113,5177
6875,AHEB5,2015-09-30,2015-11-13,5064,113,5177
6876,AHEB5,2015-12-31,2016-03-30,5064,113,5177
6877,AHEB5,2016-03-31,2016-07-14,5064,113,5177
6878,AHEB5,2016-06-30,2016-08-12,5064,113,5177
6879,AHEB5,2016-09-30,2016-11-11,5064,113,5177
6880,AHEB5,2016-12-31,2017-07-31,5064,113,5177
6881,AHEB5,2017-03-31,2017-08-14,5064,113,5177
6882,AHEB5,2017-06-30,2017-08-14,5064,113,5177
6883,AHEB5,2017-09-30,2017-11-13,5064,113,5177
6884,AHEB5,2017-12-31,2018-03-22,5064,113,5177
6885,AHEB5,2018-03-31,2018-05-10,5064,113,5177
6886,AHEB5,2018-06-30,2018-08-06,5064,113,5177
6887,AHEB5,2018-09-30,2018-11-09,7390,132,7522
6888,AHEB5,2018-12-31,2019-03-28,7390,132,7522
6889,AHEB5,2019-03-31,2019-05-14,7390,131,7521
6890,AHEB5,2019-06-30,2019-08-13,7390,131,7521
6891,AHEB5,2019-09-30,2019-11-13,7390,131,7521
6892,AHEB5,2019-12-31,2020-03-27,7390,131,7521
6893,AHEB5,2020-03-31,2020-07-15,7390,131,7521
6894,AHEB5,2020-06-30,2020-10-08,8407,135,8542
6895,AHEB5,2020-09-30,2020-11-23,8407,136,8543
6896,AHEB5,2020-12-31,2021-03-26,8407,136,8543
6897,AHEB6,2010-12-31,2011-04-01,4080,114,4194
6898,AHEB6,2011-03-31,2011-05-13,4080,114,4194
6899,AHEB6,2011-06-30,2011-08-15,4080,114,4194
6900,AHEB6,2011-09-30,2011-11-16,4080,114,4194
6901,AHEB6,2011-12-31,2014-09-03,4080,114,4194
6902,AHEB6,2012-03-31,2012-05-15,4455,98,4553
6903,AHEB6,2012-06-30,2012-08-20,4455,98,4553
6904,AHEB6,2012-09-30,2012-12-10,4460,114,4574
6905,AHEB6,2012-12-31,2013-03-28,4460,113,4573
6906,AHEB6,2013-03-31,2013-05-14,4460,113,4573
6907,AHEB6,2013-06-30,2013-08-14,4460,113,4573
6908,AHEB6,2013-09-30,2013-11-14,4460,113,4573
6909,AHEB6,2013-12-31,2014-03-27,4460,113,4573
6910,AHEB6,2014-03-31,2014-05-14,4460,113,4573
6911,AHEB6,2014-06-30,2014-10-13,5064,113,5177
6912,AHEB6,2014-09-30,2014-11-14,5064,113,5177
6913,AHEB6,2014-12-31,2015-03-27,5064,113,5177
6914,AHEB6,2015-03-31,2015-05-15,5064,113,5177
6915,AHEB6,2015-06-30,2015-08-13,5064,113,5177
6916,AHEB6,2015-09-30,2015-11-13,5064,113,5177
6917,AHEB6,2015-12-31,2016-03-30,5064,113,5177
6918,AHEB6,2016-03-31,2016-07-14,5064,113,5177
6919,AHEB6,2016-06-30,2016-08-12,5064,113,5177
6920,AHEB6,2016-09-30,2016-11-11,5064,113,5177
6921,AHEB6,2016-12-31,2017-07-31,5064,113,5177
6922,AHEB6,2017-03-31,2017-08-14,5064,113,5177
6923,AHEB6,2017-06-30,2017-08-14,5064,113,5177
6924,AHEB6,2017-09-30,2017-11-13,5064,113,5177
6925,AHEB6,2017-12-31,2018-03-22,5064,113,5177
6926,AHEB6,2018-03-31,2018-05-10,5064,113,5177
6927,AHEB6,2018-06-30,2018-08-06,5064,113,5177
6928,AHEB6,2018-09-30,2018-11-09,7390,132,7522
6929,AHEB6,2018-12-31,2019-03-28,7390,132,7522
6930,AHEB6,2019-03-31,2019-05-14,7390,131,7521
6931,AHEB6,2019-06-30,2019-08-13,7390,131,7521
6932,AHEB6,2019-09-30,2019-11-13,7390,131,7521
6933,AHEB6,2019-12-31,2020-03-27,7390,131,7521
6934,AHEB6,2020-03-31,2020-07-15,7390,131,7521
6935,AHEB6,2020-06-30,2020-10-08,8407,135,8542
6936,AHEB6,2020-09-30,2020-11-23,8407,136,8543
6937,AHEB6,2020-12-31,2021-03-26,8407,136,8543
6938,PETR3,2010-12-31,2011-03-04,7442454,5602043,13044497
6939,PETR3,2011-03-31,2011-05-13,7442454,5602043,13044497
6940,PETR3,2011-06-30,2011-08-15,7442454,5602043,13044497
6941,PETR3,2011-09-30,2011-11-11,7442454,5602043,13044497
6942,PETR3,2011-12-31,2012-02-14,7442454,5602043,13044497
6943,PETR3,2012-03-31,2012-05-15,7442454,5602043,13044497
6944,PETR3,2012-06-30,2012-08-03,7442454,5602043,13044497
6945,PETR3,2012-09-30,2012-10-26,7442454,5602043,13044497
6946,PETR3,2012-12-31,2013-02-04,7442454,5602043,13044497
6947,PETR3,2013-03-31,2013-04-26,7442454,5602043,13044497
6948,PETR3,2013-06-30,2013-08-09,7442454,5602043,13044497
6949,PETR3,2013-09-30,2013-10-25,7442454,5602043,13044497
6950,PETR3,2013-12-31,2014-02-25,7442454,5602043,13044497
6951,PETR3,2014-03-31,2014-05-09,7442454,5602043,13044497
6952,PETR3,2014-06-30,2014-08-08,7442454,5602043,13044497
6953,PETR3,2014-09-30,2015-04-22,7442454,5602043,13044497
6954,PETR3,2014-12-31,2015-04-24,7442454,5602043,13044497
6955,PETR3,2015-03-31,2015-05-15,7442454,5602043,13044497
6956,PETR3,2015-06-30,2015-08-06,7442454,5602043,13044497
6957,PETR3,2015-09-30,2015-11-12,7442454,5602042,13044496
6958,PETR3,2015-12-31,2016-03-21,7442454,5602043,13044497
6959,PETR3,2016-03-31,2016-05-12,7442454,5602043,13044497
6960,PETR3,2016-06-30,2016-08-11,7442454,5602043,13044497
6961,PETR3,2016-09-30,2016-11-10,7442454,5602043,13044497
6962,PETR3,2016-12-31,2017-03-24,7442454,5602043,13044497
6963,PETR3,2017-03-31,2017-05-12,7442454,5602043,13044497
6964,PETR3,2017-06-30,2017-08-10,7442454,5602043,13044497
6965,PETR3,2017-09-30,2017-11-13,7442454,5602043,13044497
6966,PETR3,2017-12-31,2018-03-16,7442454,5602043,13044497
6967,PETR3,2018-03-31,2018-05-08,7442454,5602043,13044497
6968,PETR3,2018-06-30,2018-08-03,7442454,5602043,13044497
6969,PETR3,2018-09-30,2018-11-06,7442454,5602043,13044497
6970,PETR3,2018-12-31,2019-02-27,7442454,5602043,13044497
6971,PETR3,2019-03-31,2019-05-07,7442454,5602043,13044497
6972,PETR3,2019-06-30,2019-08-01,7442454,5602043,13044497
6973,PETR3,2019-09-30,2019-10-24,7442454,5602043,13044497
6974,PETR3,2019-12-31,2020-02-19,7442454,5602043,13044497
6975,PETR3,2020-03-31,2020-05-14,7442454,5602043,13044497
6976,PETR3,2020-06-30,2020-07-30,7442454,5602043,13044497
6977,PETR3,2020-09-30,2020-10-28,7442454,5602043,13044497
6978,PETR3,2020-12-31,2021-03-22,7442454,5602043,13044497
6979,PETR4,2010-12-31,2011-03-04,7442454,5602043,13044497
6980,PETR4,2011-03-31,2011-05-13,7442454,5602043,13044497
6981,PETR4,2011-06-30,2011-08-15,7442454,5602043,13044497
6982,PETR4,2011-09-30,2011-11-11,7442454,5602043,13044497
6983,PETR4,2011-12-31,2012-02-14,7442454,5602043,13044497
6984,PETR4,2012-03-31,2012-05-15,7442454,5602043,13044497
6985,PETR4,2012-06-30,2012-08-03,7442454,5602043,13044497
6986,PETR4,2012-09-30,2012-10-26,7442454,5602043,13044497
6987,PETR4,2012-12-31,2013-02-04,7442454,5602043,13044497
6988,PETR4,2013-03-31,2013-04-26,7442454,5602043,13044497
6989,PETR4,2013-06-30,2013-08-09,7442454,5602043,13044497
6990,PETR4,2013-09-30,2013-10-25,7442454,5602043,13044497
6991,PETR4,2013-12-31,2014-02-25,7442454,5602043,13044497
6992,PETR4,2014-03-31,2014-05-09,7442454,5602043,13044497
6993,PETR4,2014-06-30,2014-08-08,7442454,5602043,13044497
6994,PETR4,2014-09-30,2015-04-22,7442454,5602043,13044497
6995,PETR4,2014-12-31,2015-04-24,7442454,5602043,13044497
6996,PETR4,2015-03-31,2015-05-15,7442454,5602043,13044497
6997,PETR4,2015-06-30,2015-08-06,7442454,5602043,13044497
6998,PETR4,2015-09-30,2015-11-12,7442454,5602042,13044496
6999,PETR4,2015-12-31,2016-03-21,7442454,5602043,13044497
7000,PETR4,2016-03-31,2016-05-12,7442454,5602043,13044497
7001,PETR4,2016-06-30,2016-08-11,7442454,5602043,13044497
7002,PETR4,2016-09-30,2016-11-10,7442454,5602043,13044497
7003,PETR4,2016-12-31,2017-03-24,7442454,5602043,13044497
7004,PETR4,2017-03-31,2017-05-12,7442454,5602043,13044497
7005,PETR4,2017-06-30,2017-08-10,7442454,5602043,13044497
7006,PETR4,2017-09-30,2017-11-13,7442454,5602043,13044497
7007,PETR4,2017-12-31,2018-03-16,7442454,5602043,13044497
7008,PETR4,2018-03-31,2018-05-08,7442454,5602043,13044497
7009,PETR4,2018-06-30,2018-08-03,7442454,5602043,13044497
7010,PETR4,2018-09-30,2018-11-06,7442454,5602043,13044497
7011,PETR4,2018-12-31,2019-02-27,7442454,5602043,13044497
7012,PETR4,2019-03-31,2019-05-07,7442454,5602043,13044497
7013,PETR4,2019-06-30,2019-08-01,7442454,5602043,13044497
7014,PETR4,2019-09-30,2019-10-24,7442454,5602043,13044497
7015,PETR4,2019-12-31,2020-02-19,7442454,5602043,13044497
7016,PETR4,2020-03-31,2020-05-14,7442454,5602043,13044497
7017,PETR4,2020-06-30,2020-07-30,7442454,5602043,13044497
7018,PETR4,2020-09-30,2020-10-28,7442454,5602043,13044497
7019,PETR4,2020-12-31,2021-03-22,7442454,5602043,13044497
7020,PTNT3,2011-06-30,2011-09-27,16016924,32029564,48046488
7021,PTNT3,2011-09-30,2011-11-14,16016924,32029564,48046488
7022,PTNT3,2011-12-31,2012-02-14,16016924,32029564,48046488
7023,PTNT3,2012-03-31,2012-05-15,16016924,32029564,48046488
7024,PTNT3,2012-06-30,2012-09-27,16016924,32029564,48046488
7025,PTNT3,2012-09-30,2012-11-14,16016924,32029564,48046488
7026,PTNT3,2012-12-31,2013-02-14,16016924,32029564,48046488
7027,PTNT3,2013-03-31,2013-05-14,16016924,32029564,48046488
7028,PTNT3,2013-06-30,2013-09-09,16016924,32029564,48046488
7029,PTNT3,2013-09-30,2013-11-14,16016924,32029564,48046488
7030,PTNT3,2013-12-31,2014-02-14,16016924,32029564,48046488
7031,PTNT3,2014-03-31,2014-05-15,16016924,32029564,48046488
7032,PTNT3,2014-06-30,2014-09-15,16016924,32029564,48046488
7033,PTNT3,2014-09-30,2014-11-14,16016924,32029564,48046488
7034,PTNT3,2014-12-31,2015-02-13,16016924,32029564,48046488
7035,PTNT3,2015-03-31,2015-05-15,16016924,32029564,48046488
7036,PTNT3,2015-06-30,2015-09-18,16016924,32029564,48046488
7037,PTNT3,2015-09-30,2015-11-18,16016924,32029564,48046488
7038,PTNT3,2015-12-31,2016-02-13,16016924,32029564,48046488
7039,PTNT3,2016-03-31,2016-05-13,16016924,32029564,48046488
7040,PTNT3,2016-06-30,2016-09-26,16016924,32029564,48046488
7041,PTNT3,2016-09-30,2016-11-23,16016924,32029564,48046488
7042,PTNT3,2016-12-31,2017-02-14,16016924,32029564,48046488
7043,PTNT3,2017-03-31,2017-05-15,16016924,32029564,48046488
7044,PTNT3,2017-06-30,2017-09-22,16016924,32029564,48046488
7045,PTNT3,2017-09-30,2017-11-14,16016924,32029564,48046488
7046,PTNT3,2017-12-31,2018-02-15,16016924,32029564,48046488
7047,PTNT3,2018-03-31,2018-05-15,16016924,32029564,48046488
7048,PTNT3,2018-06-30,2018-09-21,16016924,32029564,48046488
7049,PTNT3,2018-09-30,2018-12-28,16016924,32029564,48046488
7050,PTNT3,2018-12-31,2019-03-18,16016924,32029564,48046488
7051,PTNT3,2019-03-31,2019-05-15,16016924,32029564,48046488
7052,PTNT3,2019-06-30,2019-09-24,16016924,32029564,48046488
7053,PTNT3,2019-09-30,2019-11-14,16016924,32029564,48046488
7054,PTNT3,2019-12-31,2020-02-14,16016924,32029564,48046488
7055,PTNT3,2020-03-31,2020-06-25,16016924,32029564,48046488
7056,PTNT3,2020-06-30,2020-09-29,16016924,32029564,48046488
7057,PTNT3,2020-09-30,2020-11-26,16016924,32029564,48046488
7058,PTNT3,2020-12-31,2021-03-01,16016924,32029564,48046488
7059,PTNT4,2011-06-30,2011-09-27,16016924,32029564,48046488
7060,PTNT4,2011-09-30,2011-11-14,16016924,32029564,48046488
7061,PTNT4,2011-12-31,2012-02-14,16016924,32029564,48046488
7062,PTNT4,2012-03-31,2012-05-15,16016924,32029564,48046488
7063,PTNT4,2012-06-30,2012-09-27,16016924,32029564,48046488
7064,PTNT4,2012-09-30,2012-11-14,16016924,32029564,48046488
7065,PTNT4,2012-12-31,2013-02-14,16016924,32029564,48046488
7066,PTNT4,2013-03-31,2013-05-14,16016924,32029564,48046488
7067,PTNT4,2013-06-30,2013-09-09,16016924,32029564,48046488
7068,PTNT4,2013-09-30,2013-11-14,16016924,32029564,48046488
7069,PTNT4,2013-12-31,2014-02-14,16016924,32029564,48046488
7070,PTNT4,2014-03-31,2014-05-15,16016924,32029564,48046488
7071,PTNT4,2014-06-30,2014-09-15,16016924,32029564,48046488
7072,PTNT4,2014-09-30,2014-11-14,16016924,32029564,48046488
7073,PTNT4,2014-12-31,2015-02-13,16016924,32029564,48046488
7074,PTNT4,2015-03-31,2015-05-15,16016924,32029564,48046488
7075,PTNT4,2015-06-30,2015-09-18,16016924,32029564,48046488
7076,PTNT4,2015-09-30,2015-11-18,16016924,32029564,48046488
7077,PTNT4,2015-12-31,2016-02-13,16016924,32029564,48046488
7078,PTNT4,2016-03-31,2016-05-13,16016924,32029564,48046488
7079,PTNT4,2016-06-30,2016-09-26,16016924,32029564,48046488
7080,PTNT4,2016-09-30,2016-11-23,16016924,32029564,48046488
7081,PTNT4,2016-12-31,2017-02-14,16016924,32029564,48046488
7082,PTNT4,2017-03-31,2017-05-15,16016924,32029564,48046488
7083,PTNT4,2017-06-30,2017-09-22,16016924,32029564,48046488
7084,PTNT4,2017-09-30,2017-11-14,16016924,32029564,48046488
7085,PTNT4,2017-12-31,2018-02-15,16016924,32029564,48046488
7086,PTNT4,2018-03-31,2018-05-15,16016924,32029564,48046488
7087,PTNT4,2018-06-30,2018-09-21,16016924,32029564,48046488
7088,PTNT4,2018-09-30,2018-12-28,16016924,32029564,48046488
7089,PTNT4,2018-12-31,2019-03-18,16016924,32029564,48046488
7090,PTNT4,2019-03-31,2019-05-15,16016924,32029564,48046488
7091,PTNT4,2019-06-30,2019-09-24,16016924,32029564,48046488
7092,PTNT4,2019-09-30,2019-11-14,16016924,32029564,48046488
7093,PTNT4,2019-12-31,2020-02-14,16016924,32029564,48046488
7094,PTNT4,2020-03-31,2020-06-25,16016924,32029564,48046488
7095,PTNT4,2020-06-30,2020-09-29,16016924,32029564,48046488
7096,PTNT4,2020-09-30,2020-11-26,16016924,32029564,48046488
7097,PTNT4,2020-12-31,2021-03-01,16016924,32029564,48046488
7098,RPAD3,2010-12-31,2012-09-04,46011632,38670637,84682269
7099,RPAD3,2011-03-31,2011-05-16,46011632,38670637,84682269
7100,RPAD3,2011-06-30,2011-08-12,46011632,38670637,84682269
7101,RPAD3,2011-09-30,2011-11-11,46011632,38670637,84682269
7102,RPAD3,2011-12-31,2012-03-09,46011632,38670637,84682269
7103,RPAD3,2012-03-31,2012-05-14,46011632,38670637,84682269
7104,RPAD3,2012-06-30,2012-08-14,46011632,38670637,84682269
7105,RPAD3,2012-09-30,2012-11-14,46011632,38670637,84682269
7106,RPAD3,2012-12-31,2013-03-14,46011632,38670637,84682269
7107,RPAD3,2013-03-31,2013-05-16,46011632,38670637,84682269
7108,RPAD3,2013-06-30,2013-08-14,46011632,38670637,84682269
7109,RPAD3,2013-09-30,2013-11-14,46011632,38670637,84682269
7110,RPAD3,2013-12-31,2014-03-20,46011632,38670637,84682269
7111,RPAD3,2014-03-31,2014-05-14,46011632,38670637,84682269
7112,RPAD3,2014-06-30,2014-09-25,46011632,38670637,84682269
7113,RPAD3,2014-09-30,2014-11-14,46011632,38670637,84682269
7114,RPAD3,2014-12-31,2015-03-20,46011632,38670637,84682269
7115,RPAD3,2015-03-31,2015-05-14,46011632,38670637,84682269
7116,RPAD3,2015-06-30,2015-08-13,46011632,38670637,84682269
7117,RPAD3,2015-09-30,2015-11-12,46011632,38670637,84682269
7118,RPAD3,2015-12-31,2016-03-18,46011632,38670637,84682269
7119,RPAD3,2016-03-31,2016-05-13,46011632,38670637,84682269
7120,RPAD3,2016-06-30,2016-08-11,46011632,38670637,84682269
7121,RPAD3,2016-09-30,2016-11-10,46011632,38670637,84682269
7122,RPAD3,2016-12-31,2017-03-17,46011632,38670637,84682269
7123,RPAD3,2017-03-31,2017-05-12,46011632,38670637,84682269
7124,RPAD3,2017-06-30,2017-08-14,46011632,38670637,84682269
7125,RPAD3,2017-09-30,2017-11-10,46011632,38670637,84682269
7126,RPAD3,2017-12-31,2018-03-16,46011632,38670637,84682269
7127,RPAD3,2018-03-31,2018-05-11,46011632,38670637,84682269
7128,RPAD3,2018-06-30,2018-08-10,46011632,38670637,84682269
7129,RPAD3,2018-09-30,2018-11-09,46011632,38670637,84682269
7130,RPAD3,2018-12-31,2019-03-15,46011632,38670637,84682269
7131,RPAD3,2019-03-31,2019-05-10,46011632,38670637,84682269
7132,RPAD3,2019-06-30,2019-08-09,46011632,38670637,84682269
7133,RPAD3,2019-09-30,2019-11-08,46011632,38670637,84682269
7134,RPAD3,2019-12-31,2020-03-19,46011632,38670637,84682269
7135,RPAD3,2020-03-31,2020-05-12,46011632,38670637,84682269
7136,RPAD3,2020-06-30,2020-08-12,46011632,38670637,84682269
7137,RPAD3,2020-09-30,2020-11-11,46011632,38670637,84682269
7138,RPAD3,2020-12-31,2021-02-26,46011632,38670637,84682269
7139,RPAD5,2010-12-31,2012-09-04,46011632,38670637,84682269
7140,RPAD5,2011-03-31,2011-05-16,46011632,38670637,84682269
7141,RPAD5,2011-06-30,2011-08-12,46011632,38670637,84682269
7142,RPAD5,2011-09-30,2011-11-11,46011632,38670637,84682269
7143,RPAD5,2011-12-31,2012-03-09,46011632,38670637,84682269
7144,RPAD5,2012-03-31,2012-05-14,46011632,38670637,84682269
7145,RPAD5,2012-06-30,2012-08-14,46011632,38670637,84682269
7146,RPAD5,2012-09-30,2012-11-14,46011632,38670637,84682269
7147,RPAD5,2012-12-31,2013-03-14,46011632,38670637,84682269
7148,RPAD5,2013-03-31,2013-05-16,46011632,38670637,84682269
7149,RPAD5,2013-06-30,2013-08-14,46011632,38670637,84682269
7150,RPAD5,2013-09-30,2013-11-14,46011632,38670637,84682269
7151,RPAD5,2013-12-31,2014-03-20,46011632,38670637,84682269
7152,RPAD5,2014-03-31,2014-05-14,46011632,38670637,84682269
7153,RPAD5,2014-06-30,2014-09-25,46011632,38670637,84682269
7154,RPAD5,2014-09-30,2014-11-14,46011632,38670637,84682269
7155,RPAD5,2014-12-31,2015-03-20,46011632,38670637,84682269
7156,RPAD5,2015-03-31,2015-05-14,46011632,38670637,84682269
7157,RPAD5,2015-06-30,2015-08-13,46011632,38670637,84682269
7158,RPAD5,2015-09-30,2015-11-12,46011632,38670637,84682269
7159,RPAD5,2015-12-31,2016-03-18,46011632,38670637,84682269
7160,RPAD5,2016-03-31,2016-05-13,46011632,38670637,84682269
7161,RPAD5,2016-06-30,2016-08-11,46011632,38670637,84682269
7162,RPAD5,2016-09-30,2016-11-10,46011632,38670637,84682269
7163,RPAD5,2016-12-31,2017-03-17,46011632,38670637,84682269
7164,RPAD5,2017-03-31,2017-05-12,46011632,38670637,84682269
7165,RPAD5,2017-06-30,2017-08-14,46011632,38670637,84682269
7166,RPAD5,2017-09-30,2017-11-10,46011632,38670637,84682269
7167,RPAD5,2017-12-31,2018-03-16,46011632,38670637,84682269
7168,RPAD5,2018-03-31,2018-05-11,46011632,38670637,84682269
7169,RPAD5,2018-06-30,2018-08-10,46011632,38670637,84682269
7170,RPAD5,2018-09-30,2018-11-09,46011632,38670637,84682269
7171,RPAD5,2018-12-31,2019-03-15,46011632,38670637,84682269
7172,RPAD5,2019-03-31,2019-05-10,46011632,38670637,84682269
7173,RPAD5,2019-06-30,2019-08-09,46011632,38670637,84682269
7174,RPAD5,2019-09-30,2019-11-08,46011632,38670637,84682269
7175,RPAD5,2019-12-31,2020-03-19,46011632,38670637,84682269
7176,RPAD5,2020-03-31,2020-05-12,46011632,38670637,84682269
7177,RPAD5,2020-06-30,2020-08-12,46011632,38670637,84682269
7178,RPAD5,2020-09-30,2020-11-11,46011632,38670637,84682269
7179,RPAD5,2020-12-31,2021-02-26,46011632,38670637,84682269
7180,RPAD6,2010-12-31,2012-09-04,46011632,38670637,84682269
7181,RPAD6,2011-03-31,2011-05-16,46011632,38670637,84682269
7182,RPAD6,2011-06-30,2011-08-12,46011632,38670637,84682269
7183,RPAD6,2011-09-30,2011-11-11,46011632,38670637,84682269
7184,RPAD6,2011-12-31,2012-03-09,46011632,38670637,84682269
7185,RPAD6,2012-03-31,2012-05-14,46011632,38670637,84682269
7186,RPAD6,2012-06-30,2012-08-14,46011632,38670637,84682269
7187,RPAD6,2012-09-30,2012-11-14,46011632,38670637,84682269
7188,RPAD6,2012-12-31,2013-03-14,46011632,38670637,84682269
7189,RPAD6,2013-03-31,2013-05-16,46011632,38670637,84682269
7190,RPAD6,2013-06-30,2013-08-14,46011632,38670637,84682269
7191,RPAD6,2013-09-30,2013-11-14,46011632,38670637,84682269
7192,RPAD6,2013-12-31,2014-03-20,46011632,38670637,84682269
7193,RPAD6,2014-03-31,2014-05-14,46011632,38670637,84682269
7194,RPAD6,2014-06-30,2014-09-25,46011632,38670637,84682269
7195,RPAD6,2014-09-30,2014-11-14,46011632,38670637,84682269
7196,RPAD6,2014-12-31,2015-03-20,46011632,38670637,84682269
7197,RPAD6,2015-03-31,2015-05-14,46011632,38670637,84682269
7198,RPAD6,2015-06-30,2015-08-13,46011632,38670637,84682269
7199,RPAD6,2015-09-30,2015-11-12,46011632,38670637,84682269
7200,RPAD6,2015-12-31,2016-03-18,46011632,38670637,84682269
7201,RPAD6,2016-03-31,2016-05-13,46011632,38670637,84682269
7202,RPAD6,2016-06-30,2016-08-11,46011632,38670637,84682269
7203,RPAD6,2016-09-30,2016-11-10,46011632,38670637,84682269
7204,RPAD6,2016-12-31,2017-03-17,46011632,38670637,84682269
7205,RPAD6,2017-03-31,2017-05-12,46011632,38670637,84682269
7206,RPAD6,2017-06-30,2017-08-14,46011632,38670637,84682269
7207,RPAD6,2017-09-30,2017-11-10,46011632,38670637,84682269
7208,RPAD6,2017-12-31,2018-03-16,46011632,38670637,84682269
7209,RPAD6,2018-03-31,2018-05-11,46011632,38670637,84682269
7210,RPAD6,2018-06-30,2018-08-10,46011632,38670637,84682269
7211,RPAD6,2018-09-30,2018-11-09,46011632,38670637,84682269
7212,RPAD6,2018-12-31,2019-03-15,46011632,38670637,84682269
7213,RPAD6,2019-03-31,2019-05-10,46011632,38670637,84682269
7214,RPAD6,2019-06-30,2019-08-09,46011632,38670637,84682269
7215,RPAD6,2019-09-30,2019-11-08,46011632,38670637,84682269
7216,RPAD6,2019-12-31,2020-03-19,46011632,38670637,84682269
7217,RPAD6,2020-03-31,2020-05-12,46011632,38670637,84682269
7218,RPAD6,2020-06-30,2020-08-12,46011632,38670637,84682269
7219,RPAD6,2020-09-30,2020-11-11,46011632,38670637,84682269
7220,RPAD6,2020-12-31,2021-02-26,46011632,38670637,84682269
7221,RPMG3,2010-12-31,2011-06-07,757290,143802,901092
7222,RPMG3,2011-03-31,2011-07-31,757290,143802,901092
7223,RPMG3,2011-06-30,2011-09-30,757290,143802,901092
7224,RPMG3,2011-09-30,2011-11-15,780863,150588,931451
7225,RPMG3,2011-12-31,2012-04-19,780863,150588,931451
7226,RPMG3,2012-03-31,2012-07-04,780863,150588,931451
7227,RPMG3,2012-06-30,2012-09-26,780863,150588,931451
7228,RPMG3,2012-09-30,2012-11-27,780863,150588,931451
7229,RPMG3,2012-12-31,2013-09-09,780863,150588,931451
7230,RPMG3,2013-03-31,2017-03-01,780863,150588,931451
7231,RPMG3,2013-06-30,2017-03-01,780863,150588,931451
7232,RPMG3,2013-09-30,2017-03-01,780863,150588,931451
7233,RPMG3,2013-12-31,2017-03-01,780863,150588,931451
7234,RPMG3,2014-03-31,2017-03-01,991541,150588,1142129
7235,RPMG3,2014-06-30,2017-03-01,991541,150588,1142129
7236,RPMG3,2014-09-30,2017-03-01,991541,150588,1142129
7237,RPMG3,2014-12-31,2017-03-01,1353832,0,1353832
7238,RPMG3,2015-03-31,2017-03-09,1353832,0,1353832
7239,RPMG3,2015-06-30,2017-03-09,1353832,0,1353832
7240,RPMG3,2015-09-30,2017-03-09,1353832,0,1353832
7241,RPMG3,2015-12-31,2017-08-18,1353833,0,1353833
7242,RPMG3,2016-03-31,2016-05-27,67692,0,67692
7243,RPMG3,2016-06-30,2016-08-15,67692,0,67692
7244,RPMG3,2016-09-30,2017-01-16,67692,0,67692
7245,RPMG3,2016-12-31,2017-04-24,67692,0,67692
7246,RPMG3,2017-03-31,2017-08-21,67692,0,67692
7247,RPMG3,2017-06-30,2018-02-26,67692,0,67692
7248,RPMG3,2017-09-30,2018-03-08,67692,0,67692
7249,RPMG3,2017-12-31,2018-09-17,67691629,0,67691629
7250,RPMG3,2018-03-31,2018-10-30,67691629,0,67691629
7251,RPMG3,2018-06-30,2019-03-04,67691629,0,67691629
7252,RPMG3,2018-09-30,2019-03-11,67691629,0,67691629
7253,RPMG3,2018-12-31,2019-06-28,67692,0,67692
7254,RPMG3,2019-03-31,2019-07-19,67692,0,67692
7255,RPMG3,2019-06-30,2019-08-19,67692,0,67692
7256,RPMG3,2019-09-30,2019-11-27,67691629,0,67691629
7257,RPMG3,2019-12-31,2020-05-29,67692,0,67692
7258,RPMG3,2020-03-31,2020-06-29,67692,0,67692
7259,RPMG3,2020-06-30,2020-08-31,67692,0,67692
7260,RPMG3,2020-09-30,2020-11-16,67692,0,67692
7261,ALPA3,2010-12-31,2011-03-30,181524,171932,353456
7262,ALPA3,2011-03-31,2011-05-13,181524,171932,353456
7263,ALPA3,2011-06-30,2011-08-12,181524,171932,353456
7264,ALPA3,2011-09-30,2011-11-11,181524,171932,353456
7265,ALPA3,2011-12-31,2012-12-10,181524,171932,353456
7266,ALPA3,2012-03-31,2012-05-04,181524,171932,353456
7267,ALPA3,2012-06-30,2012-08-06,199676,189125,388801
7268,ALPA3,2012-09-30,2012-11-09,199676,189125,388801
7269,ALPA3,2012-12-31,2014-08-08,199676,189125,388801
7270,ALPA3,2013-03-31,2013-05-10,199676,189125,388801
7271,ALPA3,2013-06-30,2013-08-16,219644,208038,427682
7272,ALPA3,2013-09-30,2013-11-08,219644,208038,427682
7273,ALPA3,2013-12-31,2014-08-08,219644,208038,427682
7274,ALPA3,2014-03-31,2014-05-09,219644,208038,427682
7275,ALPA3,2014-06-30,2014-08-20,241609,228841,470450
7276,ALPA3,2014-09-30,2014-11-07,241609,228841,470450
7277,ALPA3,2014-12-31,2015-03-11,241609,228841,470450
7278,ALPA3,2015-03-31,2015-05-08,241609,228841,470450
7279,ALPA3,2015-06-30,2015-08-07,241609,228841,470450
7280,ALPA3,2015-09-30,2015-11-06,241609,228841,470450
7281,ALPA3,2015-12-31,2016-03-04,241609,228841,470450
7282,ALPA3,2016-03-31,2016-05-06,241609,228841,470450
7283,ALPA3,2016-06-30,2016-08-09,241609,228841,470450
7284,ALPA3,2016-09-30,2016-11-04,241609,228841,470450
7285,ALPA3,2016-12-31,2017-03-22,241609,228841,470450
7286,ALPA3,2017-03-31,2017-05-05,241609,228841,470450
7287,ALPA3,2017-06-30,2017-08-04,241609,228841,470450
7288,ALPA3,2017-09-30,2017-11-13,241609,228841,470450
7289,ALPA3,2017-12-31,2018-02-09,241609,228841,470450
7290,ALPA3,2018-03-31,2018-05-14,241608551,228841226,470449777
7291,ALPA3,2018-06-30,2018-09-27,241608551,228841226,470449777
7292,ALPA3,2018-09-30,2018-11-09,241608551,228841226,470449777
7293,ALPA3,2018-12-31,2019-02-15,241608551,228841226,470449777
7294,ALPA3,2019-03-31,2019-05-13,302010689,286051533,588062222
7295,ALPA3,2019-06-30,2019-08-09,302010689,286051533,588062222
7296,ALPA3,2019-09-30,2019-11-08,302010689,286051533,588062222
7297,ALPA3,2019-12-31,2020-02-07,302010689,286051533,588062222
7298,ALPA3,2020-03-31,2020-05-05,302010689,286051533,588062222
7299,ALPA3,2020-06-30,2020-08-04,302010689,286051533,588062222
7300,ALPA3,2020-09-30,2020-11-04,302010689,286051533,588062222
7301,ALPA3,2020-12-31,2021-02-12,302010689,286051533,588062222
7302,ALPA4,2010-12-31,2011-03-30,181524,171932,353456
7303,ALPA4,2011-03-31,2011-05-13,181524,171932,353456
7304,ALPA4,2011-06-30,2011-08-12,181524,171932,353456
7305,ALPA4,2011-09-30,2011-11-11,181524,171932,353456
7306,ALPA4,2011-12-31,2012-12-10,181524,171932,353456
7307,ALPA4,2012-03-31,2012-05-04,181524,171932,353456
7308,ALPA4,2012-06-30,2012-08-06,199676,189125,388801
7309,ALPA4,2012-09-30,2012-11-09,199676,189125,388801
7310,ALPA4,2012-12-31,2014-08-08,199676,189125,388801
7311,ALPA4,2013-03-31,2013-05-10,199676,189125,388801
7312,ALPA4,2013-06-30,2013-08-16,219644,208038,427682
7313,ALPA4,2013-09-30,2013-11-08,219644,208038,427682
7314,ALPA4,2013-12-31,2014-08-08,219644,208038,427682
7315,ALPA4,2014-03-31,2014-05-09,219644,208038,427682
7316,ALPA4,2014-06-30,2014-08-20,241609,228841,470450
7317,ALPA4,2014-09-30,2014-11-07,241609,228841,470450
7318,ALPA4,2014-12-31,2015-03-11,241609,228841,470450
7319,ALPA4,2015-03-31,2015-05-08,241609,228841,470450
7320,ALPA4,2015-06-30,2015-08-07,241609,228841,470450
7321,ALPA4,2015-09-30,2015-11-06,241609,228841,470450
7322,ALPA4,2015-12-31,2016-03-04,241609,228841,470450
7323,ALPA4,2016-03-31,2016-05-06,241609,228841,470450
7324,ALPA4,2016-06-30,2016-08-09,241609,228841,470450
7325,ALPA4,2016-09-30,2016-11-04,241609,228841,470450
7326,ALPA4,2016-12-31,2017-03-22,241609,228841,470450
7327,ALPA4,2017-03-31,2017-05-05,241609,228841,470450
7328,ALPA4,2017-06-30,2017-08-04,241609,228841,470450
7329,ALPA4,2017-09-30,2017-11-13,241609,228841,470450
7330,ALPA4,2017-12-31,2018-02-09,241609,228841,470450
7331,ALPA4,2018-03-31,2018-05-14,241608551,228841226,470449777
7332,ALPA4,2018-06-30,2018-09-27,241608551,228841226,470449777
7333,ALPA4,2018-09-30,2018-11-09,241608551,228841226,470449777
7334,ALPA4,2018-12-31,2019-02-15,241608551,228841226,470449777
7335,ALPA4,2019-03-31,2019-05-13,302010689,286051533,588062222
7336,ALPA4,2019-06-30,2019-08-09,302010689,286051533,588062222
7337,ALPA4,2019-09-30,2019-11-08,302010689,286051533,588062222
7338,ALPA4,2019-12-31,2020-02-07,302010689,286051533,588062222
7339,ALPA4,2020-03-31,2020-05-05,302010689,286051533,588062222
7340,ALPA4,2020-06-30,2020-08-04,302010689,286051533,588062222
7341,ALPA4,2020-09-30,2020-11-04,302010689,286051533,588062222
7342,ALPA4,2020-12-31,2021-02-12,302010689,286051533,588062222
7343,SLED3,2010-12-31,2011-03-24,9622,18974,28596
7344,SLED3,2011-03-31,2011-05-13,9622,18974,28596
7345,SLED3,2011-06-30,2011-08-12,9622,18974,28596
7346,SLED3,2011-09-30,2011-11-10,9622,18974,28596
7347,SLED3,2011-12-31,2012-03-22,9622,18974,28596
7348,SLED3,2012-03-31,2012-05-15,9622,18974,28596
7349,SLED3,2012-06-30,2012-08-14,9622,18974,28596
7350,SLED3,2012-09-30,2012-11-13,9622,18974,28596
7351,SLED3,2012-12-31,2013-03-21,9622,18974,28596
7352,SLED3,2013-03-31,2013-05-14,9622,18974,28596
7353,SLED3,2013-06-30,2013-08-14,9622,18974,28596
7354,SLED3,2013-09-30,2013-11-13,9622,18974,28596
7355,SLED3,2013-12-31,2014-03-20,9622,18974,28596
7356,SLED3,2014-03-31,2014-05-07,9622,18974,28596
7357,SLED3,2014-06-30,2014-08-14,9622,18974,28596
7358,SLED3,2014-09-30,2014-11-13,9622,18974,28596
7359,SLED3,2014-12-31,2015-03-19,9622,18974,28596
7360,SLED3,2015-03-31,2015-05-14,9622,18974,28596
7361,SLED3,2015-06-30,2015-08-14,9622,18974,28596
7362,SLED3,2015-09-30,2015-11-12,9622,18974,28596
7363,SLED3,2015-12-31,2016-03-29,9622,18974,28596
7364,SLED3,2016-03-31,2016-05-12,9622,18974,28596
7365,SLED3,2016-06-30,2016-08-12,9622,17080,26702
7366,SLED3,2016-09-30,2016-11-14,9622,17080,26702
7367,SLED3,2016-12-31,2017-03-28,9622,17080,26702
7368,SLED3,2017-03-31,2017-05-15,9622,17080,26702
7369,SLED3,2017-06-30,2017-08-14,9622,17080,26702
7370,SLED3,2017-09-30,2017-11-14,9622,17080,26702
7371,SLED3,2017-12-31,2018-03-14,9622,17080,26702
7372,SLED3,2018-03-31,2018-05-15,9622,17080,26702
7373,SLED3,2018-06-30,2018-08-14,9622,17080,26702
7374,SLED3,2018-09-30,2018-11-12,9622,17080,26702
7375,SLED3,2018-12-31,2019-03-28,9622,17080,26702
7376,SLED3,2019-03-31,2019-05-15,9622,17080,26702
7377,SLED3,2019-06-30,2019-08-14,9622,17080,26702
7378,SLED3,2019-09-30,2019-11-13,9622,17080,26702
7379,SLED3,2019-12-31,2020-03-30,9622,17080,26702
7380,SLED3,2020-03-31,2020-06-15,18621,20325,38946
7381,SLED3,2020-06-30,2020-08-21,18621,20325,38946
7382,SLED3,2020-09-30,2020-11-13,22481,35766,58247
7383,SLED4,2010-12-31,2011-03-24,9622,18974,28596
7384,SLED4,2011-03-31,2011-05-13,9622,18974,28596
7385,SLED4,2011-06-30,2011-08-12,9622,18974,28596
7386,SLED4,2011-09-30,2011-11-10,9622,18974,28596
7387,SLED4,2011-12-31,2012-03-22,9622,18974,28596
7388,SLED4,2012-03-31,2012-05-15,9622,18974,28596
7389,SLED4,2012-06-30,2012-08-14,9622,18974,28596
7390,SLED4,2012-09-30,2012-11-13,9622,18974,28596
7391,SLED4,2012-12-31,2013-03-21,9622,18974,28596
7392,SLED4,2013-03-31,2013-05-14,9622,18974,28596
7393,SLED4,2013-06-30,2013-08-14,9622,18974,28596
7394,SLED4,2013-09-30,2013-11-13,9622,18974,28596
7395,SLED4,2013-12-31,2014-03-20,9622,18974,28596
7396,SLED4,2014-03-31,2014-05-07,9622,18974,28596
7397,SLED4,2014-06-30,2014-08-14,9622,18974,28596
7398,SLED4,2014-09-30,2014-11-13,9622,18974,28596
7399,SLED4,2014-12-31,2015-03-19,9622,18974,28596
7400,SLED4,2015-03-31,2015-05-14,9622,18974,28596
7401,SLED4,2015-06-30,2015-08-14,9622,18974,28596
7402,SLED4,2015-09-30,2015-11-12,9622,18974,28596
7403,SLED4,2015-12-31,2016-03-29,9622,18974,28596
7404,SLED4,2016-03-31,2016-05-12,9622,18974,28596
7405,SLED4,2016-06-30,2016-08-12,9622,17080,26702
7406,SLED4,2016-09-30,2016-11-14,9622,17080,26702
7407,SLED4,2016-12-31,2017-03-28,9622,17080,26702
7408,SLED4,2017-03-31,2017-05-15,9622,17080,26702
7409,SLED4,2017-06-30,2017-08-14,9622,17080,26702
7410,SLED4,2017-09-30,2017-11-14,9622,17080,26702
7411,SLED4,2017-12-31,2018-03-14,9622,17080,26702
7412,SLED4,2018-03-31,2018-05-15,9622,17080,26702
7413,SLED4,2018-06-30,2018-08-14,9622,17080,26702
7414,SLED4,2018-09-30,2018-11-12,9622,17080,26702
7415,SLED4,2018-12-31,2019-03-28,9622,17080,26702
7416,SLED4,2019-03-31,2019-05-15,9622,17080,26702
7417,SLED4,2019-06-30,2019-08-14,9622,17080,26702
7418,SLED4,2019-09-30,2019-11-13,9622,17080,26702
7419,SLED4,2019-12-31,2020-03-30,9622,17080,26702
7420,SLED4,2020-03-31,2020-06-15,18621,20325,38946
7421,SLED4,2020-06-30,2020-08-21,18621,20325,38946
7422,SLED4,2020-09-30,2020-11-13,22481,35766,58247
7423,SOND3,2010-12-31,2011-04-05,856,1712,2568
7424,SOND3,2011-03-31,2013-05-17,856,1712,2568
7425,SOND3,2011-06-30,2013-05-17,856,1712,2568
7426,SOND3,2011-09-30,2013-05-17,856,1712,2568
7427,SOND3,2011-12-31,2013-05-17,856,1712,2568
7428,SOND3,2012-03-31,2013-05-20,856,1712,2568
7429,SOND3,2012-06-30,2013-05-20,856,1712,2568
7430,SOND3,2012-09-30,2013-05-20,856,1712,2568
7431,SOND3,2012-12-31,2013-05-21,856,1712,2568
7432,SOND3,2013-03-31,2013-11-29,856,1712,2568
7433,SOND3,2013-06-30,2013-11-29,856,1601,2457
7434,SOND3,2013-09-30,2013-11-13,856,1601,2457
7435,SOND3,2013-12-31,2014-03-27,856,1601,2457
7436,SOND3,2014-03-31,2014-05-21,856,1575,2431
7437,SOND3,2014-06-30,2014-08-14,856,1575,2431
7438,SOND3,2014-09-30,2014-11-12,856,1575,2431
7439,SOND3,2014-12-31,2015-03-30,856,1575,2431
7440,SOND3,2015-03-31,2015-05-14,856,1575,2431
7441,SOND3,2015-06-30,2015-08-14,856,1575,2431
7442,SOND3,2015-09-30,2015-11-12,856,1575,2431
7443,SOND3,2015-12-31,2016-03-29,856,1575,2431
7444,SOND3,2016-03-31,2016-05-12,856,1575,2431
7445,SOND3,2016-06-30,2016-08-11,856,1575,2431
7446,SOND3,2016-09-30,2016-11-11,856,1575,2431
7447,SOND3,2016-12-31,2017-03-29,856,1575,2431
7448,SOND3,2017-03-31,2017-05-15,856,1575,2431
7449,SOND3,2017-06-30,2017-08-14,856,1575,2431
7450,SOND3,2017-09-30,2017-11-14,856,1575,2431
7451,SOND3,2017-12-31,2018-03-23,856,1575,2431
7452,SOND3,2018-03-31,2018-05-15,856,1575,2431
7453,SOND3,2018-06-30,2018-08-14,856,1575,2431
7454,SOND3,2018-09-30,2018-11-14,856,1575,2431
7455,SOND3,2018-12-31,2019-03-26,856,1575,2431
7456,SOND3,2019-03-31,2019-05-15,856,1575,2431
7457,SOND3,2019-06-30,2019-08-15,856,1602,2458
7458,SOND3,2019-09-30,2019-11-21,856,1575,2431
7459,SOND3,2019-12-31,2020-03-27,856,1575,2431
7460,SOND3,2020-03-31,2020-05-29,856,1575,2431
7461,SOND3,2020-06-30,2020-08-28,856,1575,2431
7462,SOND3,2020-09-30,2020-11-13,856,1575,2431
7463,SOND3,2020-12-31,2021-03-25,856,1575,2431
7464,SOND5,2010-12-31,2011-04-05,856,1712,2568
7465,SOND5,2011-03-31,2013-05-17,856,1712,2568
7466,SOND5,2011-06-30,2013-05-17,856,1712,2568
7467,SOND5,2011-09-30,2013-05-17,856,1712,2568
7468,SOND5,2011-12-31,2013-05-17,856,1712,2568
7469,SOND5,2012-03-31,2013-05-20,856,1712,2568
7470,SOND5,2012-06-30,2013-05-20,856,1712,2568
7471,SOND5,2012-09-30,2013-05-20,856,1712,2568
7472,SOND5,2012-12-31,2013-05-21,856,1712,2568
7473,SOND5,2013-03-31,2013-11-29,856,1712,2568
7474,SOND5,2013-06-30,2013-11-29,856,1601,2457
7475,SOND5,2013-09-30,2013-11-13,856,1601,2457
7476,SOND5,2013-12-31,2014-03-27,856,1601,2457
7477,SOND5,2014-03-31,2014-05-21,856,1575,2431
7478,SOND5,2014-06-30,2014-08-14,856,1575,2431
7479,SOND5,2014-09-30,2014-11-12,856,1575,2431
7480,SOND5,2014-12-31,2015-03-30,856,1575,2431
7481,SOND5,2015-03-31,2015-05-14,856,1575,2431
7482,SOND5,2015-06-30,2015-08-14,856,1575,2431
7483,SOND5,2015-09-30,2015-11-12,856,1575,2431
7484,SOND5,2015-12-31,2016-03-29,856,1575,2431
7485,SOND5,2016-03-31,2016-05-12,856,1575,2431
7486,SOND5,2016-06-30,2016-08-11,856,1575,2431
7487,SOND5,2016-09-30,2016-11-11,856,1575,2431
7488,SOND5,2016-12-31,2017-03-29,856,1575,2431
7489,SOND5,2017-03-31,2017-05-15,856,1575,2431
7490,SOND5,2017-06-30,2017-08-14,856,1575,2431
7491,SOND5,2017-09-30,2017-11-14,856,1575,2431
7492,SOND5,2017-12-31,2018-03-23,856,1575,2431
7493,SOND5,2018-03-31,2018-05-15,856,1575,2431
7494,SOND5,2018-06-30,2018-08-14,856,1575,2431
7495,SOND5,2018-09-30,2018-11-14,856,1575,2431
7496,SOND5,2018-12-31,2019-03-26,856,1575,2431
7497,SOND5,2019-03-31,2019-05-15,856,1575,2431
7498,SOND5,2019-06-30,2019-08-15,856,1602,2458
7499,SOND5,2019-09-30,2019-11-21,856,1575,2431
7500,SOND5,2019-12-31,2020-03-27,856,1575,2431
7501,SOND5,2020-03-31,2020-05-29,856,1575,2431
7502,SOND5,2020-06-30,2020-08-28,856,1575,2431
7503,SOND5,2020-09-30,2020-11-13,856,1575,2431
7504,SOND5,2020-12-31,2021-03-25,856,1575,2431
7505,SOND6,2010-12-31,2011-04-05,856,1712,2568
7506,SOND6,2011-03-31,2013-05-17,856,1712,2568
7507,SOND6,2011-06-30,2013-05-17,856,1712,2568
7508,SOND6,2011-09-30,2013-05-17,856,1712,2568
7509,SOND6,2011-12-31,2013-05-17,856,1712,2568
7510,SOND6,2012-03-31,2013-05-20,856,1712,2568
7511,SOND6,2012-06-30,2013-05-20,856,1712,2568
7512,SOND6,2012-09-30,2013-05-20,856,1712,2568
7513,SOND6,2012-12-31,2013-05-21,856,1712,2568
7514,SOND6,2013-03-31,2013-11-29,856,1712,2568
7515,SOND6,2013-06-30,2013-11-29,856,1601,2457
7516,SOND6,2013-09-30,2013-11-13,856,1601,2457
7517,SOND6,2013-12-31,2014-03-27,856,1601,2457
7518,SOND6,2014-03-31,2014-05-21,856,1575,2431
7519,SOND6,2014-06-30,2014-08-14,856,1575,2431
7520,SOND6,2014-09-30,2014-11-12,856,1575,2431
7521,SOND6,2014-12-31,2015-03-30,856,1575,2431
7522,SOND6,2015-03-31,2015-05-14,856,1575,2431
7523,SOND6,2015-06-30,2015-08-14,856,1575,2431
7524,SOND6,2015-09-30,2015-11-12,856,1575,2431
7525,SOND6,2015-12-31,2016-03-29,856,1575,2431
7526,SOND6,2016-03-31,2016-05-12,856,1575,2431
7527,SOND6,2016-06-30,2016-08-11,856,1575,2431
7528,SOND6,2016-09-30,2016-11-11,856,1575,2431
7529,SOND6,2016-12-31,2017-03-29,856,1575,2431
7530,SOND6,2017-03-31,2017-05-15,856,1575,2431
7531,SOND6,2017-06-30,2017-08-14,856,1575,2431
7532,SOND6,2017-09-30,2017-11-14,856,1575,2431
7533,SOND6,2017-12-31,2018-03-23,856,1575,2431
7534,SOND6,2018-03-31,2018-05-15,856,1575,2431
7535,SOND6,2018-06-30,2018-08-14,856,1575,2431
7536,SOND6,2018-09-30,2018-11-14,856,1575,2431
7537,SOND6,2018-12-31,2019-03-26,856,1575,2431
7538,SOND6,2019-03-31,2019-05-15,856,1575,2431
7539,SOND6,2019-06-30,2019-08-15,856,1602,2458
7540,SOND6,2019-09-30,2019-11-21,856,1575,2431
7541,SOND6,2019-12-31,2020-03-27,856,1575,2431
7542,SOND6,2020-03-31,2020-05-29,856,1575,2431
7543,SOND6,2020-06-30,2020-08-28,856,1575,2431
7544,SOND6,2020-09-30,2020-11-13,856,1575,2431
7545,SOND6,2020-12-31,2021-03-25,856,1575,2431
7546,SPRI3,2010-12-31,2011-04-19,9445,3202,12647
7547,SPRI3,2011-03-31,2011-05-17,9445,3202,12647
7548,SPRI3,2011-06-30,2011-08-16,94450,32021,126471
7549,SPRI3,2011-09-30,2011-11-17,94450,32021,126471
7550,SPRI3,2011-12-31,2012-04-02,94450230,32020800,126471030
7551,SPRI3,2012-03-31,2012-08-24,94450,32021,126471
7552,SPRI3,2012-06-30,2012-08-24,94450,32021,126471
7553,SPRI3,2012-09-30,2012-11-14,94450,32021,126471
7554,SPRI3,2012-12-31,2013-03-27,94450230,32020800,126471030
7555,SPRI3,2013-03-31,2013-07-17,94450,32021,126471
7556,SPRI3,2013-06-30,2013-08-15,94450,32021,126471
7557,SPRI3,2013-09-30,2013-11-14,94450,32021,126471
7558,SPRI3,2013-12-31,2014-04-02,94450230,32020800,126471030
7559,SPRI3,2014-03-31,2014-05-16,94450,32021,126471
7560,SPRI3,2014-06-30,2014-08-15,94450,32021,126471
7561,SPRI3,2014-09-30,2014-11-14,94450,32021,126471
7562,SPRI3,2014-12-31,2015-03-31,94450230,32020800,126471030
7563,SPRI3,2015-03-31,2015-06-03,94450,32021,126471
7564,SPRI3,2015-06-30,2015-08-14,94450,32021,126471
7565,SPRI3,2015-09-30,2015-11-16,94450,32021,126471
7566,SPRI3,2015-12-31,2016-03-31,94450230,32020800,126471030
7567,SPRI3,2016-03-31,2016-05-16,94450230,32020800,126471030
7568,SPRI3,2016-06-30,2016-08-23,1889004,640415,2529419
7569,SPRI3,2016-09-30,2017-06-02,1889004,640415,2529419
7570,SPRI3,2016-12-31,2017-04-25,1889004,640415,2529419
7571,SPRI3,2017-03-31,2018-03-28,1889004,640415,2529419
7572,SPRI3,2017-06-30,2018-03-28,1889004,640415,2529419
7573,SPRI3,2017-09-30,2018-03-28,1889004,640415,2529419
7574,SPRI3,2017-12-31,2018-04-03,1889004,640415,2529419
7575,SPRI3,2018-03-31,2018-05-15,1889004,640415,2529419
7576,SPRI3,2018-06-30,2018-08-14,1889004,640415,2529419
7577,SPRI3,2018-09-30,2018-11-09,1889004,640415,2529419
7578,SPRI3,2018-12-31,2019-03-29,1889004,640415,2529419
7579,SPRI3,2019-03-31,2019-05-15,1889004,640415,2529419
7580,SPRI3,2019-06-30,2019-08-14,1889004,640415,2529419
7581,SPRI3,2019-09-30,2019-11-14,1889004,640415,2529419
7582,SPRI3,2019-12-31,2020-03-30,1889004,640415,2529419
7583,SPRI3,2020-03-31,2020-06-29,1889004,640415,2529419
7584,SPRI3,2020-06-30,2020-08-18,1889004,640415,2529419
7585,SPRI5,2010-12-31,2011-04-19,9445,3202,12647
7586,SPRI5,2011-03-31,2011-05-17,9445,3202,12647
7587,SPRI5,2011-06-30,2011-08-16,94450,32021,126471
7588,SPRI5,2011-09-30,2011-11-17,94450,32021,126471
7589,SPRI5,2011-12-31,2012-04-02,94450230,32020800,126471030
7590,SPRI5,2012-03-31,2012-08-24,94450,32021,126471
7591,SPRI5,2012-06-30,2012-08-24,94450,32021,126471
7592,SPRI5,2012-09-30,2012-11-14,94450,32021,126471
7593,SPRI5,2012-12-31,2013-03-27,94450230,32020800,126471030
7594,SPRI5,2013-03-31,2013-07-17,94450,32021,126471
7595,SPRI5,2013-06-30,2013-08-15,94450,32021,126471
7596,SPRI5,2013-09-30,2013-11-14,94450,32021,126471
7597,SPRI5,2013-12-31,2014-04-02,94450230,32020800,126471030
7598,SPRI5,2014-03-31,2014-05-16,94450,32021,126471
7599,SPRI5,2014-06-30,2014-08-15,94450,32021,126471
7600,SPRI5,2014-09-30,2014-11-14,94450,32021,126471
7601,SPRI5,2014-12-31,2015-03-31,94450230,32020800,126471030
7602,SPRI5,2015-03-31,2015-06-03,94450,32021,126471
7603,SPRI5,2015-06-30,2015-08-14,94450,32021,126471
7604,SPRI5,2015-09-30,2015-11-16,94450,32021,126471
7605,SPRI5,2015-12-31,2016-03-31,94450230,32020800,126471030
7606,SPRI5,2016-03-31,2016-05-16,94450230,32020800,126471030
7607,SPRI5,2016-06-30,2016-08-23,1889004,640415,2529419
7608,SPRI5,2016-09-30,2017-06-02,1889004,640415,2529419
7609,SPRI5,2016-12-31,2017-04-25,1889004,640415,2529419
7610,SPRI5,2017-03-31,2018-03-28,1889004,640415,2529419
7611,SPRI5,2017-06-30,2018-03-28,1889004,640415,2529419
7612,SPRI5,2017-09-30,2018-03-28,1889004,640415,2529419
7613,SPRI5,2017-12-31,2018-04-03,1889004,640415,2529419
7614,SPRI5,2018-03-31,2018-05-15,1889004,640415,2529419
7615,SPRI5,2018-06-30,2018-08-14,1889004,640415,2529419
7616,SPRI5,2018-09-30,2018-11-09,1889004,640415,2529419
7617,SPRI5,2018-12-31,2019-03-29,1889004,640415,2529419
7618,SPRI5,2019-03-31,2019-05-15,1889004,640415,2529419
7619,SPRI5,2019-06-30,2019-08-14,1889004,640415,2529419
7620,SPRI5,2019-09-30,2019-11-14,1889004,640415,2529419
7621,SPRI5,2019-12-31,2020-03-30,1889004,640415,2529419
7622,SPRI5,2020-03-31,2020-06-29,1889004,640415,2529419
7623,SPRI5,2020-06-30,2020-08-18,1889004,640415,2529419
7624,SPRI6,2010-12-31,2011-04-19,9445,3202,12647
7625,SPRI6,2011-03-31,2011-05-17,9445,3202,12647
7626,SPRI6,2011-06-30,2011-08-16,94450,32021,126471
7627,SPRI6,2011-09-30,2011-11-17,94450,32021,126471
7628,SPRI6,2011-12-31,2012-04-02,94450230,32020800,126471030
7629,SPRI6,2012-03-31,2012-08-24,94450,32021,126471
7630,SPRI6,2012-06-30,2012-08-24,94450,32021,126471
7631,SPRI6,2012-09-30,2012-11-14,94450,32021,126471
7632,SPRI6,2012-12-31,2013-03-27,94450230,32020800,126471030
7633,SPRI6,2013-03-31,2013-07-17,94450,32021,126471
7634,SPRI6,2013-06-30,2013-08-15,94450,32021,126471
7635,SPRI6,2013-09-30,2013-11-14,94450,32021,126471
7636,SPRI6,2013-12-31,2014-04-02,94450230,32020800,126471030
7637,SPRI6,2014-03-31,2014-05-16,94450,32021,126471
7638,SPRI6,2014-06-30,2014-08-15,94450,32021,126471
7639,SPRI6,2014-09-30,2014-11-14,94450,32021,126471
7640,SPRI6,2014-12-31,2015-03-31,94450230,32020800,126471030
7641,SPRI6,2015-03-31,2015-06-03,94450,32021,126471
7642,SPRI6,2015-06-30,2015-08-14,94450,32021,126471
7643,SPRI6,2015-09-30,2015-11-16,94450,32021,126471
7644,SPRI6,2015-12-31,2016-03-31,94450230,32020800,126471030
7645,SPRI6,2016-03-31,2016-05-16,94450230,32020800,126471030
7646,SPRI6,2016-06-30,2016-08-23,1889004,640415,2529419
7647,SPRI6,2016-09-30,2017-06-02,1889004,640415,2529419
7648,SPRI6,2016-12-31,2017-04-25,1889004,640415,2529419
7649,SPRI6,2017-03-31,2018-03-28,1889004,640415,2529419
7650,SPRI6,2017-06-30,2018-03-28,1889004,640415,2529419
7651,SPRI6,2017-09-30,2018-03-28,1889004,640415,2529419
7652,SPRI6,2017-12-31,2018-04-03,1889004,640415,2529419
7653,SPRI6,2018-03-31,2018-05-15,1889004,640415,2529419
7654,SPRI6,2018-06-30,2018-08-14,1889004,640415,2529419
7655,SPRI6,2018-09-30,2018-11-09,1889004,640415,2529419
7656,SPRI6,2018-12-31,2019-03-29,1889004,640415,2529419
7657,SPRI6,2019-03-31,2019-05-15,1889004,640415,2529419
7658,SPRI6,2019-06-30,2019-08-14,1889004,640415,2529419
7659,SPRI6,2019-09-30,2019-11-14,1889004,640415,2529419
7660,SPRI6,2019-12-31,2020-03-30,1889004,640415,2529419
7661,SPRI6,2020-03-31,2020-06-29,1889004,640415,2529419
7662,SPRI6,2020-06-30,2020-08-18,1889004,640415,2529419
7663,WLMM3,2010-12-31,2011-04-20,3314244,3968690,7282934
7664,WLMM3,2011-03-31,2011-08-23,3314244,3968690,7282934
7665,WLMM3,2011-06-30,2011-08-23,3314244,3968690,7282934
7666,WLMM3,2011-09-30,2011-12-08,3314244,3968690,7282934
7667,WLMM3,2011-12-31,2012-03-26,3314244,3968690,7282934
7668,WLMM3,2012-03-31,2012-05-15,3314244,3968690,7282934
7669,WLMM3,2012-06-30,2012-08-27,3314244,3968690,7282934
7670,WLMM3,2012-09-30,2012-11-14,3314244,3968690,7282934
7671,WLMM3,2012-12-31,2013-03-26,3314244,3968690,7282934
7672,WLMM3,2013-03-31,2013-06-14,3314244,3968690,7282934
7673,WLMM3,2013-06-30,2013-09-10,3314244,3968690,7282934
7674,WLMM3,2013-09-30,2013-11-26,3314244,3968690,7282934
7675,WLMM3,2013-12-31,2014-03-28,3314244,3968690,7282934
7676,WLMM3,2014-03-31,2014-05-23,3314244,3968690,7282934
7677,WLMM3,2014-06-30,2014-09-13,3314244,3968690,7282934
7678,WLMM3,2014-09-30,2014-11-24,3314244,3968690,7282934
7679,WLMM3,2014-12-31,2015-03-27,3314244,3968690,7282934
7680,WLMM3,2015-03-31,2015-11-18,3314244,3968690,7282934
7681,WLMM3,2015-06-30,2015-11-18,3314244,3968690,7282934
7682,WLMM3,2015-09-30,2015-12-03,16571220,19843450,36414670
7683,WLMM3,2015-12-31,2016-03-29,16571220,19843450,36414670
7684,WLMM3,2016-03-31,2016-05-17,16571220,19843450,36414670
7685,WLMM3,2016-06-30,2016-08-24,16571220,19843450,36414670
7686,WLMM3,2016-09-30,2016-11-21,16571220,19843450,36414670
7687,WLMM3,2016-12-31,2017-03-27,16571220,19843450,36414670
7688,WLMM3,2017-03-31,2017-05-25,16571220,19843450,36414670
7689,WLMM3,2017-06-30,2017-08-11,16571220,19843450,36414670
7690,WLMM3,2017-09-30,2017-11-14,16571220,19843450,36414670
7691,WLMM3,2017-12-31,2018-04-07,16571220,19843450,36414670
7692,WLMM3,2018-03-31,2018-06-18,16571220,19843450,36414670
7693,WLMM3,2018-06-30,2018-08-24,16571220,19843450,36414670
7694,WLMM3,2018-09-30,2019-01-18,16571220,19843450,36414670
7695,WLMM3,2018-12-31,2019-03-28,16571220,19843450,36414670
7696,WLMM3,2019-03-31,2019-05-15,16571220,19843450,36414670
7697,WLMM3,2019-06-30,2019-08-14,16571220,19843450,36414670
7698,WLMM3,2019-09-30,2019-11-14,16571220,19843450,36414670
7699,WLMM3,2019-12-31,2020-03-27,16571220,19843450,36414670
7700,WLMM3,2020-03-31,2020-05-29,16571220,19843450,36414670
7701,WLMM3,2020-06-30,2020-08-14,16571220,19843450,36414670
7702,WLMM3,2020-09-30,2020-11-13,16571220,19843450,36414670
7703,WLMM3,2020-12-31,2021-03-25,16571220,19843450,36414670
7704,WLMM4,2010-12-31,2011-04-20,3314244,3968690,7282934
7705,WLMM4,2011-03-31,2011-08-23,3314244,3968690,7282934
7706,WLMM4,2011-06-30,2011-08-23,3314244,3968690,7282934
7707,WLMM4,2011-09-30,2011-12-08,3314244,3968690,7282934
7708,WLMM4,2011-12-31,2012-03-26,3314244,3968690,7282934
7709,WLMM4,2012-03-31,2012-05-15,3314244,3968690,7282934
7710,WLMM4,2012-06-30,2012-08-27,3314244,3968690,7282934
7711,WLMM4,2012-09-30,2012-11-14,3314244,3968690,7282934
7712,WLMM4,2012-12-31,2013-03-26,3314244,3968690,7282934
7713,WLMM4,2013-03-31,2013-06-14,3314244,3968690,7282934
7714,WLMM4,2013-06-30,2013-09-10,3314244,3968690,7282934
7715,WLMM4,2013-09-30,2013-11-26,3314244,3968690,7282934
7716,WLMM4,2013-12-31,2014-03-28,3314244,3968690,7282934
7717,WLMM4,2014-03-31,2014-05-23,3314244,3968690,7282934
7718,WLMM4,2014-06-30,2014-09-13,3314244,3968690,7282934
7719,WLMM4,2014-09-30,2014-11-24,3314244,3968690,7282934
7720,WLMM4,2014-12-31,2015-03-27,3314244,3968690,7282934
7721,WLMM4,2015-03-31,2015-11-18,3314244,3968690,7282934
7722,WLMM4,2015-06-30,2015-11-18,3314244,3968690,7282934
7723,WLMM4,2015-09-30,2015-12-03,16571220,19843450,36414670
7724,WLMM4,2015-12-31,2016-03-29,16571220,19843450,36414670
7725,WLMM4,2016-03-31,2016-05-17,16571220,19843450,36414670
7726,WLMM4,2016-06-30,2016-08-24,16571220,19843450,36414670
7727,WLMM4,2016-09-30,2016-11-21,16571220,19843450,36414670
7728,WLMM4,2016-12-31,2017-03-27,16571220,19843450,36414670
7729,WLMM4,2017-03-31,2017-05-25,16571220,19843450,36414670
7730,WLMM4,2017-06-30,2017-08-11,16571220,19843450,36414670
7731,WLMM4,2017-09-30,2017-11-14,16571220,19843450,36414670
7732,WLMM4,2017-12-31,2018-04-07,16571220,19843450,36414670
7733,WLMM4,2018-03-31,2018-06-18,16571220,19843450,36414670
7734,WLMM4,2018-06-30,2018-08-24,16571220,19843450,36414670
7735,WLMM4,2018-09-30,2019-01-18,16571220,19843450,36414670
7736,WLMM4,2018-12-31,2019-03-28,16571220,19843450,36414670
7737,WLMM4,2019-03-31,2019-05-15,16571220,19843450,36414670
7738,WLMM4,2019-06-30,2019-08-14,16571220,19843450,36414670
7739,WLMM4,2019-09-30,2019-11-14,16571220,19843450,36414670
7740,WLMM4,2019-12-31,2020-03-27,16571220,19843450,36414670
7741,WLMM4,2020-03-31,2020-05-29,16571220,19843450,36414670
7742,WLMM4,2020-06-30,2020-08-14,16571220,19843450,36414670
7743,WLMM4,2020-09-30,2020-11-13,16571220,19843450,36414670
7744,WLMM4,2020-12-31,2021-03-25,16571220,19843450,36414670
7745,TCNO3,2010-12-31,2011-04-13,32000000,64000000,96000000
7746,TCNO3,2011-03-31,2011-05-16,32000,64000,96000
7747,TCNO3,2011-06-30,2011-08-15,32000,64000,96000
7748,TCNO3,2011-09-30,2011-11-12,32000,64000,96000
7749,TCNO3,2011-12-31,2012-04-09,32000000,64000000,96000000
7750,TCNO3,2012-03-31,2013-03-28,35305,64000,99305
7751,TCNO3,2012-06-30,2013-04-10,35305,64000,99305
7752,TCNO3,2012-09-30,2013-04-16,35305,64000,99305
7753,TCNO3,2012-12-31,2014-04-07,35305,64000,99305
7754,TCNO3,2013-03-31,2014-04-04,35305,64000,99305
7755,TCNO3,2013-06-30,2014-04-04,35305,64000,99305
7756,TCNO3,2013-09-30,2014-04-04,35305,64000,99305
7757,TCNO3,2013-12-31,2014-04-07,35305,64000,99305
7758,TCNO3,2014-03-31,2014-06-24,35305,64000,99305
7759,TCNO3,2014-06-30,2014-08-14,35305,64000,99305
7760,TCNO3,2014-09-30,2014-11-14,35305,64000,99305
7761,TCNO3,2014-12-31,2015-03-31,35305,64000,99305
7762,TCNO3,2015-03-31,2015-05-15,35305,64000,99305
7763,TCNO3,2015-06-30,2015-08-14,35305,64000,99305
7764,TCNO3,2015-09-30,2015-11-13,35305,64000,99305
7765,TCNO3,2015-12-31,2016-03-31,35305,64000,99305
7766,TCNO3,2016-03-31,2016-05-13,2353,4267,6620
7767,TCNO3,2016-06-30,2016-08-12,2353,4267,6620
7768,TCNO3,2016-09-30,2016-11-14,2353,4267,6620
7769,TCNO3,2016-12-31,2017-04-12,2353,4267,6620
7770,TCNO3,2017-03-31,2017-05-23,2353,4267,6620
7771,TCNO3,2017-06-30,2017-08-17,2353,4267,6620
7772,TCNO3,2017-09-30,2017-11-14,2353,4267,6620
7773,TCNO3,2017-12-31,2018-03-31,2353,4267,6620
7774,TCNO3,2018-03-31,2018-05-14,2353,4267,6620
7775,TCNO3,2018-06-30,2018-08-14,2353,4267,6620
7776,TCNO3,2018-09-30,2018-11-14,2353,4267,6620
7777,TCNO3,2018-12-31,2019-03-30,2353,4267,6620
7778,TCNO3,2019-03-31,2019-05-15,2353,4267,6620
7779,TCNO3,2019-06-30,2019-08-14,2353,4267,6620
7780,TCNO3,2019-09-30,2019-11-14,2353,4267,6620
7781,TCNO3,2019-12-31,2020-06-01,2353,4267,6620
7782,TCNO3,2020-03-31,2020-07-01,2353,4267,6620
7783,TCNO3,2020-06-30,2020-09-24,2353,4267,6620
7784,TCNO3,2020-09-30,2020-11-16,2353,4267,6620
7785,TCNO4,2010-12-31,2011-04-13,32000000,64000000,96000000
7786,TCNO4,2011-03-31,2011-05-16,32000,64000,96000
7787,TCNO4,2011-06-30,2011-08-15,32000,64000,96000
7788,TCNO4,2011-09-30,2011-11-12,32000,64000,96000
7789,TCNO4,2011-12-31,2012-04-09,32000000,64000000,96000000
7790,TCNO4,2012-03-31,2013-03-28,35305,64000,99305
7791,TCNO4,2012-06-30,2013-04-10,35305,64000,99305
7792,TCNO4,2012-09-30,2013-04-16,35305,64000,99305
7793,TCNO4,2012-12-31,2014-04-07,35305,64000,99305
7794,TCNO4,2013-03-31,2014-04-04,35305,64000,99305
7795,TCNO4,2013-06-30,2014-04-04,35305,64000,99305
7796,TCNO4,2013-09-30,2014-04-04,35305,64000,99305
7797,TCNO4,2013-12-31,2014-04-07,35305,64000,99305
7798,TCNO4,2014-03-31,2014-06-24,35305,64000,99305
7799,TCNO4,2014-06-30,2014-08-14,35305,64000,99305
7800,TCNO4,2014-09-30,2014-11-14,35305,64000,99305
7801,TCNO4,2014-12-31,2015-03-31,35305,64000,99305
7802,TCNO4,2015-03-31,2015-05-15,35305,64000,99305
7803,TCNO4,2015-06-30,2015-08-14,35305,64000,99305
7804,TCNO4,2015-09-30,2015-11-13,35305,64000,99305
7805,TCNO4,2015-12-31,2016-03-31,35305,64000,99305
7806,TCNO4,2016-03-31,2016-05-13,2353,4267,6620
7807,TCNO4,2016-06-30,2016-08-12,2353,4267,6620
7808,TCNO4,2016-09-30,2016-11-14,2353,4267,6620
7809,TCNO4,2016-12-31,2017-04-12,2353,4267,6620
7810,TCNO4,2017-03-31,2017-05-23,2353,4267,6620
7811,TCNO4,2017-06-30,2017-08-17,2353,4267,6620
7812,TCNO4,2017-09-30,2017-11-14,2353,4267,6620
7813,TCNO4,2017-12-31,2018-03-31,2353,4267,6620
7814,TCNO4,2018-03-31,2018-05-14,2353,4267,6620
7815,TCNO4,2018-06-30,2018-08-14,2353,4267,6620
7816,TCNO4,2018-09-30,2018-11-14,2353,4267,6620
7817,TCNO4,2018-12-31,2019-03-30,2353,4267,6620
7818,TCNO4,2019-03-31,2019-05-15,2353,4267,6620
7819,TCNO4,2019-06-30,2019-08-14,2353,4267,6620
7820,TCNO4,2019-09-30,2019-11-14,2353,4267,6620
7821,TCNO4,2019-12-31,2020-06-01,2353,4267,6620
7822,TCNO4,2020-03-31,2020-07-01,2353,4267,6620
7823,TCNO4,2020-06-30,2020-09-24,2353,4267,6620
7824,TCNO4,2020-09-30,2020-11-16,2353,4267,6620
7825,TEKA3,2010-12-31,2011-04-12,12786,25573,38359
7826,TEKA3,2011-03-31,2011-05-13,12786,25573,38359
7827,TEKA3,2011-06-30,2011-08-12,12786,25573,38359
7828,TEKA3,2011-09-30,2011-11-14,12786,25573,38359
7829,TEKA3,2011-12-31,2012-04-27,12786,25573,38359
7830,TEKA3,2012-03-31,2012-05-02,12786,25573,38359
7831,TEKA3,2012-06-30,2012-08-17,16791,33524,50315
7832,TEKA3,2012-09-30,2012-11-16,16791,33524,50315
7833,TEKA3,2012-12-31,2013-03-28,16791,33524,50315
7834,TEKA3,2013-03-31,2013-05-16,16791,33524,50315
7835,TEKA3,2013-06-30,2013-08-15,16791,33524,50315
7836,TEKA3,2013-09-30,2013-11-14,16791,33524,50315
7837,TEKA3,2013-12-31,2014-03-31,16791,33524,50315
7838,TEKA3,2014-03-31,2014-05-16,16791,33524,50315
7839,TEKA3,2014-06-30,2014-08-15,16791,33524,50315
7840,TEKA3,2014-09-30,2014-11-17,16791,33524,50315
7841,TEKA3,2014-12-31,2015-03-30,16791,33524,50315
7842,TEKA3,2015-03-31,2015-05-15,16791,33524,50315
7843,TEKA3,2015-06-30,2015-08-14,16791,33524,50315
7844,TEKA3,2015-09-30,2015-11-13,16791,33524,50315
7845,TEKA3,2015-12-31,2016-04-05,168,335,503
7846,TEKA3,2016-03-31,2016-05-13,168,335,503
7847,TEKA3,2016-06-30,2016-08-12,168,335,503
7848,TEKA3,2016-09-30,2016-11-14,168,335,503
7849,TEKA3,2016-12-31,2017-03-29,168,335,503
7850,TEKA3,2017-03-31,2017-05-12,168,335,503
7851,TEKA3,2017-06-30,2017-08-14,168,335,503
7852,TEKA3,2017-09-30,2017-11-14,168,335,503
7853,TEKA3,2017-12-31,2018-06-22,168,335,503
7854,TEKA3,2018-03-31,2018-08-14,168,335,503
7855,TEKA3,2018-06-30,2018-08-14,168,335,503
7856,TEKA3,2018-09-30,2018-11-14,168,335,503
7857,TEKA3,2018-12-31,2019-03-27,168,335,503
7858,TEKA3,2019-03-31,2019-05-15,168,335,503
7859,TEKA3,2019-06-30,2019-08-13,168,335,503
7860,TEKA3,2019-09-30,2019-11-14,168,335,503
7861,TEKA3,2019-12-31,2020-03-30,168,335,503
7862,TEKA3,2020-03-31,2020-06-29,168,335,503
7863,TEKA3,2020-06-30,2020-08-28,168,335,503
7864,TEKA3,2020-09-30,2020-11-16,168,335,503
7865,TEKA4,2010-12-31,2011-04-12,12786,25573,38359
7866,TEKA4,2011-03-31,2011-05-13,12786,25573,38359
7867,TEKA4,2011-06-30,2011-08-12,12786,25573,38359
7868,TEKA4,2011-09-30,2011-11-14,12786,25573,38359
7869,TEKA4,2011-12-31,2012-04-27,12786,25573,38359
7870,TEKA4,2012-03-31,2012-05-02,12786,25573,38359
7871,TEKA4,2012-06-30,2012-08-17,16791,33524,50315
7872,TEKA4,2012-09-30,2012-11-16,16791,33524,50315
7873,TEKA4,2012-12-31,2013-03-28,16791,33524,50315
7874,TEKA4,2013-03-31,2013-05-16,16791,33524,50315
7875,TEKA4,2013-06-30,2013-08-15,16791,33524,50315
7876,TEKA4,2013-09-30,2013-11-14,16791,33524,50315
7877,TEKA4,2013-12-31,2014-03-31,16791,33524,50315
7878,TEKA4,2014-03-31,2014-05-16,16791,33524,50315
7879,TEKA4,2014-06-30,2014-08-15,16791,33524,50315
7880,TEKA4,2014-09-30,2014-11-17,16791,33524,50315
7881,TEKA4,2014-12-31,2015-03-30,16791,33524,50315
7882,TEKA4,2015-03-31,2015-05-15,16791,33524,50315
7883,TEKA4,2015-06-30,2015-08-14,16791,33524,50315
7884,TEKA4,2015-09-30,2015-11-13,16791,33524,50315
7885,TEKA4,2015-12-31,2016-04-05,168,335,503
7886,TEKA4,2016-03-31,2016-05-13,168,335,503
7887,TEKA4,2016-06-30,2016-08-12,168,335,503
7888,TEKA4,2016-09-30,2016-11-14,168,335,503
7889,TEKA4,2016-12-31,2017-03-29,168,335,503
7890,TEKA4,2017-03-31,2017-05-12,168,335,503
7891,TEKA4,2017-06-30,2017-08-14,168,335,503
7892,TEKA4,2017-09-30,2017-11-14,168,335,503
7893,TEKA4,2017-12-31,2018-06-22,168,335,503
7894,TEKA4,2018-03-31,2018-08-14,168,335,503
7895,TEKA4,2018-06-30,2018-08-14,168,335,503
7896,TEKA4,2018-09-30,2018-11-14,168,335,503
7897,TEKA4,2018-12-31,2019-03-27,168,335,503
7898,TEKA4,2019-03-31,2019-05-15,168,335,503
7899,TEKA4,2019-06-30,2019-08-13,168,335,503
7900,TEKA4,2019-09-30,2019-11-14,168,335,503
7901,TEKA4,2019-12-31,2020-03-30,168,335,503
7902,TEKA4,2020-03-31,2020-06-29,168,335,503
7903,TEKA4,2020-06-30,2020-08-28,168,335,503
7904,TEKA4,2020-09-30,2020-11-16,168,335,503
7905,TKNO3,2010-12-31,2011-03-29,1419,1216,2635
7906,TKNO3,2011-03-31,2011-05-16,1419,1216,2635
7907,TKNO3,2011-06-30,2011-08-15,1450,1244,2694
7908,TKNO3,2011-09-30,2011-11-11,1450,1244,2694
7909,TKNO3,2011-12-31,2012-03-27,1450,1244,2694
7910,TKNO3,2012-03-31,2012-05-14,1450,1244,2694
7911,TKNO3,2012-06-30,2012-08-13,1492,1279,2771
7912,TKNO3,2012-09-30,2012-11-14,1492,1279,2771
7913,TKNO3,2012-12-31,2013-03-25,1279,1492,2771
7914,TKNO3,2013-03-31,2013-05-14,1279,1492,2771
7915,TKNO3,2013-06-30,2013-08-14,1319,1538,2857
7916,TKNO3,2013-09-30,2013-11-13,1538,1319,2857
7917,TKNO3,2013-12-31,2014-03-27,1538,1319,2857
7918,TKNO3,2014-03-31,2014-05-15,1538,1319,2857
7919,TKNO3,2014-06-30,2014-08-14,1587,1361,2948
7920,TKNO3,2014-09-30,2014-11-14,1587,1361,2948
7921,TKNO3,2014-12-31,2015-03-27,1587,1361,2948
7922,TKNO3,2015-03-31,2015-05-14,1587,1361,2948
7923,TKNO3,2015-06-30,2015-08-13,1587,1361,2948
7924,TKNO3,2015-09-30,2015-11-13,1587,1361,2948
7925,TKNO3,2015-12-31,2016-03-29,1587,1361,2948
7926,TKNO3,2016-03-31,2016-05-13,1361,1587,2948
7927,TKNO3,2016-06-30,2016-08-24,1361,1587,2948
7928,TKNO3,2016-09-30,2016-11-11,1361,1587,2948
7929,TKNO3,2016-12-31,2017-03-28,1361,1587,2948
7930,TKNO3,2017-03-31,2017-05-12,1361,1587,2948
7931,TKNO3,2017-06-30,2017-08-14,1361,1587,2948
7932,TKNO3,2017-09-30,2017-11-14,1361,1587,2948
7933,TKNO3,2017-12-31,2018-03-23,1361,1587,2948
7934,TKNO3,2018-03-31,2018-05-15,1361,1587,2948
7935,TKNO3,2018-06-30,2018-08-14,1361,1587,2948
7936,TKNO3,2018-09-30,2018-11-14,1361,1587,2948
7937,TKNO3,2018-12-31,2019-03-28,1361,1587,2948
7938,TKNO3,2019-03-31,2019-05-15,1361,1587,2948
7939,TKNO3,2019-06-30,2019-08-14,1361,1587,2948
7940,TKNO3,2019-09-30,2019-11-14,1361,1587,2948
7941,TKNO3,2019-12-31,2020-03-26,1361,1587,2948
7942,TKNO3,2020-03-31,2020-06-08,1361,1587,2948
7943,TKNO3,2020-06-30,2020-08-24,1361,1587,2948
7944,TKNO3,2020-09-30,2020-11-13,1361,1587,2948
7945,TKNO3,2020-12-31,2021-03-26,1361,1587,2948
7946,TKNO4,2010-12-31,2011-03-29,1419,1216,2635
7947,TKNO4,2011-03-31,2011-05-16,1419,1216,2635
7948,TKNO4,2011-06-30,2011-08-15,1450,1244,2694
7949,TKNO4,2011-09-30,2011-11-11,1450,1244,2694
7950,TKNO4,2011-12-31,2012-03-27,1450,1244,2694
7951,TKNO4,2012-03-31,2012-05-14,1450,1244,2694
7952,TKNO4,2012-06-30,2012-08-13,1492,1279,2771
7953,TKNO4,2012-09-30,2012-11-14,1492,1279,2771
7954,TKNO4,2012-12-31,2013-03-25,1279,1492,2771
7955,TKNO4,2013-03-31,2013-05-14,1279,1492,2771
7956,TKNO4,2013-06-30,2013-08-14,1319,1538,2857
7957,TKNO4,2013-09-30,2013-11-13,1538,1319,2857
7958,TKNO4,2013-12-31,2014-03-27,1538,1319,2857
7959,TKNO4,2014-03-31,2014-05-15,1538,1319,2857
7960,TKNO4,2014-06-30,2014-08-14,1587,1361,2948
7961,TKNO4,2014-09-30,2014-11-14,1587,1361,2948
7962,TKNO4,2014-12-31,2015-03-27,1587,1361,2948
7963,TKNO4,2015-03-31,2015-05-14,1587,1361,2948
7964,TKNO4,2015-06-30,2015-08-13,1587,1361,2948
7965,TKNO4,2015-09-30,2015-11-13,1587,1361,2948
7966,TKNO4,2015-12-31,2016-03-29,1587,1361,2948
7967,TKNO4,2016-03-31,2016-05-13,1361,1587,2948
7968,TKNO4,2016-06-30,2016-08-24,1361,1587,2948
7969,TKNO4,2016-09-30,2016-11-11,1361,1587,2948
7970,TKNO4,2016-12-31,2017-03-28,1361,1587,2948
7971,TKNO4,2017-03-31,2017-05-12,1361,1587,2948
7972,TKNO4,2017-06-30,2017-08-14,1361,1587,2948
7973,TKNO4,2017-09-30,2017-11-14,1361,1587,2948
7974,TKNO4,2017-12-31,2018-03-23,1361,1587,2948
7975,TKNO4,2018-03-31,2018-05-15,1361,1587,2948
7976,TKNO4,2018-06-30,2018-08-14,1361,1587,2948
7977,TKNO4,2018-09-30,2018-11-14,1361,1587,2948
7978,TKNO4,2018-12-31,2019-03-28,1361,1587,2948
7979,TKNO4,2019-03-31,2019-05-15,1361,1587,2948
7980,TKNO4,2019-06-30,2019-08-14,1361,1587,2948
7981,TKNO4,2019-09-30,2019-11-14,1361,1587,2948
7982,TKNO4,2019-12-31,2020-03-26,1361,1587,2948
7983,TKNO4,2020-03-31,2020-06-08,1361,1587,2948
7984,TKNO4,2020-06-30,2020-08-24,1361,1587,2948
7985,TKNO4,2020-09-30,2020-11-13,1361,1587,2948
7986,TKNO4,2020-12-31,2021-03-26,1361,1587,2948
7987,TELB3,2010-12-31,2011-03-14,886919131950,210029997060,1096949129010
7988,TELB3,2011-03-31,2011-05-13,88695913,21002999,109698912
7989,TELB3,2011-06-30,2011-08-15,88695913,21002999,109698912
7990,TELB3,2011-09-30,2011-11-11,88695913,21002999,109698912
7991,TELB3,2011-12-31,2012-07-27,88695913,21002999,109698912
7992,TELB3,2012-03-31,2012-07-27,88695913,21002999,109698912
7993,TELB3,2012-06-30,2012-08-14,88695913,21002999,109698912
7994,TELB3,2012-09-30,2012-11-13,97439719,21002999,118442718
7995,TELB3,2012-12-31,2013-03-11,97439719,21002999,118442718
7996,TELB3,2013-03-31,2013-05-15,97439719,21002999,118442718
7997,TELB3,2013-06-30,2013-08-23,97439719,21002999,118442718
7998,TELB3,2013-09-30,2013-11-26,97439719,21002999,118442718
7999,TELB3,2013-12-31,2014-04-01,97439719,21002999,118442718
8000,TELB3,2014-03-31,2015-02-19,97439719,21002999,118442718
8001,TELB3,2014-06-30,2015-02-26,97437783,21002999,118440782
8002,TELB3,2014-09-30,2015-03-09,97437783,21002999,118440782
8003,TELB3,2014-12-31,2015-03-24,97437783,21002999,118440782
8004,TELB3,2015-03-31,2015-05-15,97437783,21002999,118440782
8005,TELB3,2015-06-30,2015-08-06,97437783,21002999,118440782
8006,TELB3,2015-09-30,2015-11-12,97437783,21002999,118440782
8007,TELB3,2015-12-31,2016-03-22,97437783,21002999,118440782
8008,TELB3,2016-03-31,2016-05-13,97437783,21002999,118440782
8009,TELB3,2016-06-30,2016-08-15,97437783,21002999,118440782
8010,TELB3,2016-09-30,2016-11-14,9743971,2100299,11844270
8011,TELB3,2016-12-31,2017-03-10,9743971,2100299,11844270
8012,TELB3,2017-03-31,2017-05-15,9743971,2100299,11844270
8013,TELB3,2017-06-30,2017-08-11,9743971,2100299,11844270
8014,TELB3,2017-09-30,2017-11-10,9743971,2100299,11844270
8015,TELB3,2017-12-31,2018-03-23,39272779,10332711,49605490
8016,TELB3,2018-03-31,2018-05-15,39272779,10332711,49605490
8017,TELB3,2018-06-30,2018-08-13,39272779,10332711,49605490
8018,TELB3,2018-09-30,2018-11-14,39272779,10332711,49605490
8019,TELB3,2018-12-31,2019-03-15,39272779,10332711,49605490
8020,TELB3,2019-03-31,2019-05-13,39272779,10332711,49605490
8021,TELB3,2019-06-30,2019-08-27,39272779,10332711,49605490
8022,TELB3,2019-09-30,2019-11-11,39272779,10332711,49605490
8023,TELB3,2019-12-31,2020-03-13,39272779,10332711,49605490
8024,TELB3,2020-03-31,2020-06-03,39272779,10332711,49605490
8025,TELB3,2020-06-30,2020-08-14,49457271,18407491,67864762
8026,TELB3,2020-09-30,2020-11-06,49457271,18407491,67864762
8027,TELB3,2020-12-31,2021-03-18,49457271,18407491,67864762
8028,TELB4,2010-12-31,2011-03-14,886919131950,210029997060,1096949129010
8029,TELB4,2011-03-31,2011-05-13,88695913,21002999,109698912
8030,TELB4,2011-06-30,2011-08-15,88695913,21002999,109698912
8031,TELB4,2011-09-30,2011-11-11,88695913,21002999,109698912
8032,TELB4,2011-12-31,2012-07-27,88695913,21002999,109698912
8033,TELB4,2012-03-31,2012-07-27,88695913,21002999,109698912
8034,TELB4,2012-06-30,2012-08-14,88695913,21002999,109698912
8035,TELB4,2012-09-30,2012-11-13,97439719,21002999,118442718
8036,TELB4,2012-12-31,2013-03-11,97439719,21002999,118442718
8037,TELB4,2013-03-31,2013-05-15,97439719,21002999,118442718
8038,TELB4,2013-06-30,2013-08-23,97439719,21002999,118442718
8039,TELB4,2013-09-30,2013-11-26,97439719,21002999,118442718
8040,TELB4,2013-12-31,2014-04-01,97439719,21002999,118442718
8041,TELB4,2014-03-31,2015-02-19,97439719,21002999,118442718
8042,TELB4,2014-06-30,2015-02-26,97437783,21002999,118440782
8043,TELB4,2014-09-30,2015-03-09,97437783,21002999,118440782
8044,TELB4,2014-12-31,2015-03-24,97437783,21002999,118440782
8045,TELB4,2015-03-31,2015-05-15,97437783,21002999,118440782
8046,TELB4,2015-06-30,2015-08-06,97437783,21002999,118440782
8047,TELB4,2015-09-30,2015-11-12,97437783,21002999,118440782
8048,TELB4,2015-12-31,2016-03-22,97437783,21002999,118440782
8049,TELB4,2016-03-31,2016-05-13,97437783,21002999,118440782
8050,TELB4,2016-06-30,2016-08-15,97437783,21002999,118440782
8051,TELB4,2016-09-30,2016-11-14,9743971,2100299,11844270
8052,TELB4,2016-12-31,2017-03-10,9743971,2100299,11844270
8053,TELB4,2017-03-31,2017-05-15,9743971,2100299,11844270
8054,TELB4,2017-06-30,2017-08-11,9743971,2100299,11844270
8055,TELB4,2017-09-30,2017-11-10,9743971,2100299,11844270
8056,TELB4,2017-12-31,2018-03-23,39272779,10332711,49605490
8057,TELB4,2018-03-31,2018-05-15,39272779,10332711,49605490
8058,TELB4,2018-06-30,2018-08-13,39272779,10332711,49605490
8059,TELB4,2018-09-30,2018-11-14,39272779,10332711,49605490
8060,TELB4,2018-12-31,2019-03-15,39272779,10332711,49605490
8061,TELB4,2019-03-31,2019-05-13,39272779,10332711,49605490
8062,TELB4,2019-06-30,2019-08-27,39272779,10332711,49605490
8063,TELB4,2019-09-30,2019-11-11,39272779,10332711,49605490
8064,TELB4,2019-12-31,2020-03-13,39272779,10332711,49605490
8065,TELB4,2020-03-31,2020-06-03,39272779,10332711,49605490
8066,TELB4,2020-06-30,2020-08-14,49457271,18407491,67864762
8067,TELB4,2020-09-30,2020-11-06,49457271,18407491,67864762
8068,TELB4,2020-12-31,2021-03-18,49457271,18407491,67864762
8069,OIBR3,2010-12-31,2011-03-30,203423,399597,603020
8070,OIBR3,2011-03-31,2011-05-10,203423,399597,603020
8071,OIBR3,2011-06-30,2011-08-15,203423,399597,603020
8072,OIBR3,2011-09-30,2011-10-27,203423,399597,603020
8073,OIBR3,2011-12-31,2012-04-03,203423,399597,603020
8074,OIBR3,2012-03-31,2013-05-15,203423,399597,603020
8075,OIBR3,2012-06-30,2013-05-15,599009,1198078,1797087
8076,OIBR3,2012-09-30,2013-05-15,599009,1198078,1797087
8077,OIBR3,2012-12-31,2013-04-30,599009,1198078,1797087
8078,OIBR3,2013-03-31,2013-04-30,599009,1198078,1797087
8079,OIBR3,2013-06-30,2013-08-14,599009,1198078,1797087
8080,OIBR3,2013-09-30,2013-11-13,599009,1198078,1797087
8081,OIBR3,2013-12-31,2014-02-19,599009,1198078,1797087
8082,OIBR3,2014-03-31,2014-05-15,599009,1198078,1797087
8083,OIBR3,2014-06-30,2014-08-06,2861553,5723167,8584720
8084,OIBR3,2014-09-30,2014-11-13,2861553,5723167,8584720
8085,OIBR3,2014-12-31,2015-03-27,286155,572317,858472
8086,OIBR3,2015-03-31,2015-05-07,286155,572317,858472
8087,OIBR3,2015-06-30,2015-08-13,286155,572317,858472
8088,OIBR3,2015-09-30,2015-11-12,286155,572317,858472
8089,OIBR3,2015-12-31,2016-03-24,668034,157727,825761
8090,OIBR3,2016-03-31,2017-05-10,668034,157727,825761
8091,OIBR3,2016-06-30,2016-08-11,668034,157727,825761
8092,OIBR3,2016-09-30,2016-11-09,668034,157727,825761
8093,OIBR3,2016-12-31,2017-03-22,668034,157727,825761
8094,OIBR3,2017-03-31,2017-05-10,668034,157727,825761
8095,OIBR3,2017-06-30,2017-08-09,668034,157727,825761
8096,OIBR3,2017-09-30,2017-11-13,668034,157727,825761
8097,OIBR3,2017-12-31,2018-04-12,668034,157727,825761
8098,OIBR3,2018-03-31,2018-05-29,668034,157727,825761
8099,OIBR3,2018-06-30,2018-08-13,668034,157727,825761
8100,OIBR3,2018-09-30,2018-11-14,2182333,157727,2340060
8101,OIBR3,2018-12-31,2019-03-26,2298247,157727,2455974
8102,OIBR3,2019-03-31,2019-05-14,5796478,157727,5954205
8103,OIBR3,2019-06-30,2019-08-14,5796478,157727,5954205
8104,OIBR3,2019-09-30,2019-12-02,5796478,157727,5954205
8105,OIBR3,2019-12-31,2020-03-25,5796478,157727,5954205
8106,OIBR3,2020-03-31,2020-06-16,5796478,157727,5954205
8107,OIBR3,2020-06-30,2020-08-14,5796478,157727,5954205
8108,OIBR3,2020-09-30,2020-11-12,5796478,157727,5954205
8109,OIBR4,2010-12-31,2011-03-30,203423,399597,603020
8110,OIBR4,2011-03-31,2011-05-10,203423,399597,603020
8111,OIBR4,2011-06-30,2011-08-15,203423,399597,603020
8112,OIBR4,2011-09-30,2011-10-27,203423,399597,603020
8113,OIBR4,2011-12-31,2012-04-03,203423,399597,603020
8114,OIBR4,2012-03-31,2013-05-15,203423,399597,603020
8115,OIBR4,2012-06-30,2013-05-15,599009,1198078,1797087
8116,OIBR4,2012-09-30,2013-05-15,599009,1198078,1797087
8117,OIBR4,2012-12-31,2013-04-30,599009,1198078,1797087
8118,OIBR4,2013-03-31,2013-04-30,599009,1198078,1797087
8119,OIBR4,2013-06-30,2013-08-14,599009,1198078,1797087
8120,OIBR4,2013-09-30,2013-11-13,599009,1198078,1797087
8121,OIBR4,2013-12-31,2014-02-19,599009,1198078,1797087
8122,OIBR4,2014-03-31,2014-05-15,599009,1198078,1797087
8123,OIBR4,2014-06-30,2014-08-06,2861553,5723167,8584720
8124,OIBR4,2014-09-30,2014-11-13,2861553,5723167,8584720
8125,OIBR4,2014-12-31,2015-03-27,286155,572317,858472
8126,OIBR4,2015-03-31,2015-05-07,286155,572317,858472
8127,OIBR4,2015-06-30,2015-08-13,286155,572317,858472
8128,OIBR4,2015-09-30,2015-11-12,286155,572317,858472
8129,OIBR4,2015-12-31,2016-03-24,668034,157727,825761
8130,OIBR4,2016-03-31,2017-05-10,668034,157727,825761
8131,OIBR4,2016-06-30,2016-08-11,668034,157727,825761
8132,OIBR4,2016-09-30,2016-11-09,668034,157727,825761
8133,OIBR4,2016-12-31,2017-03-22,668034,157727,825761
8134,OIBR4,2017-03-31,2017-05-10,668034,157727,825761
8135,OIBR4,2017-06-30,2017-08-09,668034,157727,825761
8136,OIBR4,2017-09-30,2017-11-13,668034,157727,825761
8137,OIBR4,2017-12-31,2018-04-12,668034,157727,825761
8138,OIBR4,2018-03-31,2018-05-29,668034,157727,825761
8139,OIBR4,2018-06-30,2018-08-13,668034,157727,825761
8140,OIBR4,2018-09-30,2018-11-14,2182333,157727,2340060
8141,OIBR4,2018-12-31,2019-03-26,2298247,157727,2455974
8142,OIBR4,2019-03-31,2019-05-14,5796478,157727,5954205
8143,OIBR4,2019-06-30,2019-08-14,5796478,157727,5954205
8144,OIBR4,2019-09-30,2019-12-02,5796478,157727,5954205
8145,OIBR4,2019-12-31,2020-03-25,5796478,157727,5954205
8146,OIBR4,2020-03-31,2020-06-16,5796478,157727,5954205
8147,OIBR4,2020-06-30,2020-08-14,5796478,157727,5954205
8148,OIBR4,2020-09-30,2020-11-12,5796478,157727,5954205
8149,CRPG3,2010-12-31,2011-03-28,812672,1508828,2321500
8150,CRPG3,2011-03-31,2011-05-13,812672,1508828,2321500
8151,CRPG3,2011-06-30,2011-08-15,812671,1508829,2321500
8152,CRPG3,2011-09-30,2011-11-16,812672,1508828,2321500
8153,CRPG3,2011-12-31,2012-03-28,812672,1508828,2321500
8154,CRPG3,2012-03-31,2012-06-19,812671840,1508827930,2321499770
8155,CRPG3,2012-06-30,2012-08-15,812671840,1508827930,2321499770
8156,CRPG3,2012-09-30,2012-11-13,812671840,1508827930,2321499770
8157,CRPG3,2012-12-31,2013-03-26,812672,1508828,2321500
8158,CRPG3,2013-03-31,2013-05-28,812672,1508828,2321500
8159,CRPG3,2013-06-30,2013-12-02,812672,1508828,2321500
8160,CRPG3,2013-09-30,2013-11-13,812672,1508828,2321500
8161,CRPG3,2013-12-31,2014-03-14,812671840,1508827930,2321499770
8162,CRPG3,2014-03-31,2014-05-14,812672,1508828,2321500
8163,CRPG3,2014-06-30,2014-08-13,812672,1508828,2321500
8164,CRPG3,2014-09-30,2014-11-13,812672,1508828,2321500
8165,CRPG3,2014-12-31,2015-03-24,812671900,1508827900,2321499800
8166,CRPG3,2015-03-31,2015-05-15,8126719,15088279,23214998
8167,CRPG3,2015-06-30,2015-08-12,8126719,15088279,23214998
8168,CRPG3,2015-09-30,2015-11-13,8126719,15088279,23214998
8169,CRPG3,2015-12-31,2016-03-24,8126718,15088280,23214998
8170,CRPG3,2016-03-31,2016-05-13,8126719,15088279,23214998
8171,CRPG3,2016-06-30,2016-08-11,8126719,15088279,23214998
8172,CRPG3,2016-09-30,2016-11-11,8126719,15088279,23214998
8173,CRPG3,2016-12-31,2017-03-22,8126718,15088280,23214998
8174,CRPG3,2017-03-31,2017-05-11,8126719,15088279,23214998
8175,CRPG3,2017-06-30,2017-08-15,8126719,15088279,23214998
8176,CRPG3,2017-09-30,2017-11-14,8126719,15088279,23214998
8177,CRPG3,2017-12-31,2018-03-26,8126718,15088280,23214998
8178,CRPG3,2018-03-31,2018-05-10,8126719,15088279,23214998
8179,CRPG3,2018-06-30,2018-08-10,8126719,15088279,23214998
8180,CRPG3,2018-09-30,2018-11-08,8126719,15088279,23214998
8181,CRPG3,2018-12-31,2019-02-27,8126718,15088280,23214998
8182,CRPG3,2019-03-31,2019-05-14,8126719,15088279,23214998
8183,CRPG3,2019-06-30,2019-08-13,10158398,18860349,29018747
8184,CRPG3,2019-09-30,2019-11-13,10158398,18860349,29018747
8185,CRPG3,2019-12-31,2020-03-27,10158398,18860349,29018747
8186,CRPG3,2020-03-31,2020-06-26,10158398,18860349,29018747
8187,CRPG3,2020-06-30,2020-08-13,10158398,18860349,29018747
8188,CRPG3,2020-09-30,2020-11-12,10158398,18860349,29018747
8189,CRPG3,2020-12-31,2021-03-11,10158398,18860349,29018747
8190,CRPG5,2010-12-31,2011-03-28,812672,1508828,2321500
8191,CRPG5,2011-03-31,2011-05-13,812672,1508828,2321500
8192,CRPG5,2011-06-30,2011-08-15,812671,1508829,2321500
8193,CRPG5,2011-09-30,2011-11-16,812672,1508828,2321500
8194,CRPG5,2011-12-31,2012-03-28,812672,1508828,2321500
8195,CRPG5,2012-03-31,2012-06-19,812671840,1508827930,2321499770
8196,CRPG5,2012-06-30,2012-08-15,812671840,1508827930,2321499770
8197,CRPG5,2012-09-30,2012-11-13,812671840,1508827930,2321499770
8198,CRPG5,2012-12-31,2013-03-26,812672,1508828,2321500
8199,CRPG5,2013-03-31,2013-05-28,812672,1508828,2321500
8200,CRPG5,2013-06-30,2013-12-02,812672,1508828,2321500
8201,CRPG5,2013-09-30,2013-11-13,812672,1508828,2321500
8202,CRPG5,2013-12-31,2014-03-14,812671840,1508827930,2321499770
8203,CRPG5,2014-03-31,2014-05-14,812672,1508828,2321500
8204,CRPG5,2014-06-30,2014-08-13,812672,1508828,2321500
8205,CRPG5,2014-09-30,2014-11-13,812672,1508828,2321500
8206,CRPG5,2014-12-31,2015-03-24,812671900,1508827900,2321499800
8207,CRPG5,2015-03-31,2015-05-15,8126719,15088279,23214998
8208,CRPG5,2015-06-30,2015-08-12,8126719,15088279,23214998
8209,CRPG5,2015-09-30,2015-11-13,8126719,15088279,23214998
8210,CRPG5,2015-12-31,2016-03-24,8126718,15088280,23214998
8211,CRPG5,2016-03-31,2016-05-13,8126719,15088279,23214998
8212,CRPG5,2016-06-30,2016-08-11,8126719,15088279,23214998
8213,CRPG5,2016-09-30,2016-11-11,8126719,15088279,23214998
8214,CRPG5,2016-12-31,2017-03-22,8126718,15088280,23214998
8215,CRPG5,2017-03-31,2017-05-11,8126719,15088279,23214998
8216,CRPG5,2017-06-30,2017-08-15,8126719,15088279,23214998
8217,CRPG5,2017-09-30,2017-11-14,8126719,15088279,23214998
8218,CRPG5,2017-12-31,2018-03-26,8126718,15088280,23214998
8219,CRPG5,2018-03-31,2018-05-10,8126719,15088279,23214998
8220,CRPG5,2018-06-30,2018-08-10,8126719,15088279,23214998
8221,CRPG5,2018-09-30,2018-11-08,8126719,15088279,23214998
8222,CRPG5,2018-12-31,2019-02-27,8126718,15088280,23214998
8223,CRPG5,2019-03-31,2019-05-14,8126719,15088279,23214998
8224,CRPG5,2019-06-30,2019-08-13,10158398,18860349,29018747
8225,CRPG5,2019-09-30,2019-11-13,10158398,18860349,29018747
8226,CRPG5,2019-12-31,2020-03-27,10158398,18860349,29018747
8227,CRPG5,2020-03-31,2020-06-26,10158398,18860349,29018747
8228,CRPG5,2020-06-30,2020-08-13,10158398,18860349,29018747
8229,CRPG5,2020-09-30,2020-11-12,10158398,18860349,29018747
8230,CRPG5,2020-12-31,2021-03-11,10158398,18860349,29018747
8231,CRPG6,2010-12-31,2011-03-28,812672,1508828,2321500
8232,CRPG6,2011-03-31,2011-05-13,812672,1508828,2321500
8233,CRPG6,2011-06-30,2011-08-15,812671,1508829,2321500
8234,CRPG6,2011-09-30,2011-11-16,812672,1508828,2321500
8235,CRPG6,2011-12-31,2012-03-28,812672,1508828,2321500
8236,CRPG6,2012-03-31,2012-06-19,812671840,1508827930,2321499770
8237,CRPG6,2012-06-30,2012-08-15,812671840,1508827930,2321499770
8238,CRPG6,2012-09-30,2012-11-13,812671840,1508827930,2321499770
8239,CRPG6,2012-12-31,2013-03-26,812672,1508828,2321500
8240,CRPG6,2013-03-31,2013-05-28,812672,1508828,2321500
8241,CRPG6,2013-06-30,2013-12-02,812672,1508828,2321500
8242,CRPG6,2013-09-30,2013-11-13,812672,1508828,2321500
8243,CRPG6,2013-12-31,2014-03-14,812671840,1508827930,2321499770
8244,CRPG6,2014-03-31,2014-05-14,812672,1508828,2321500
8245,CRPG6,2014-06-30,2014-08-13,812672,1508828,2321500
8246,CRPG6,2014-09-30,2014-11-13,812672,1508828,2321500
8247,CRPG6,2014-12-31,2015-03-24,812671900,1508827900,2321499800
8248,CRPG6,2015-03-31,2015-05-15,8126719,15088279,23214998
8249,CRPG6,2015-06-30,2015-08-12,8126719,15088279,23214998
8250,CRPG6,2015-09-30,2015-11-13,8126719,15088279,23214998
8251,CRPG6,2015-12-31,2016-03-24,8126718,15088280,23214998
8252,CRPG6,2016-03-31,2016-05-13,8126719,15088279,23214998
8253,CRPG6,2016-06-30,2016-08-11,8126719,15088279,23214998
8254,CRPG6,2016-09-30,2016-11-11,8126719,15088279,23214998
8255,CRPG6,2016-12-31,2017-03-22,8126718,15088280,23214998
8256,CRPG6,2017-03-31,2017-05-11,8126719,15088279,23214998
8257,CRPG6,2017-06-30,2017-08-15,8126719,15088279,23214998
8258,CRPG6,2017-09-30,2017-11-14,8126719,15088279,23214998
8259,CRPG6,2017-12-31,2018-03-26,8126718,15088280,23214998
8260,CRPG6,2018-03-31,2018-05-10,8126719,15088279,23214998
8261,CRPG6,2018-06-30,2018-08-10,8126719,15088279,23214998
8262,CRPG6,2018-09-30,2018-11-08,8126719,15088279,23214998
8263,CRPG6,2018-12-31,2019-02-27,8126718,15088280,23214998
8264,CRPG6,2019-03-31,2019-05-14,8126719,15088279,23214998
8265,CRPG6,2019-06-30,2019-08-13,10158398,18860349,29018747
8266,CRPG6,2019-09-30,2019-11-13,10158398,18860349,29018747
8267,CRPG6,2019-12-31,2020-03-27,10158398,18860349,29018747
8268,CRPG6,2020-03-31,2020-06-26,10158398,18860349,29018747
8269,CRPG6,2020-06-30,2020-08-13,10158398,18860349,29018747
8270,CRPG6,2020-09-30,2020-11-12,10158398,18860349,29018747
8271,CRPG6,2020-12-31,2021-03-11,10158398,18860349,29018747
8272,UNIP3,2010-12-31,2011-03-24,278499,556999,835498
8273,UNIP3,2011-03-31,2011-05-13,278499,556999,835498
8274,UNIP3,2011-06-30,2011-08-11,278499,556999,835498
8275,UNIP3,2011-09-30,2011-11-10,278499,556999,835498
8276,UNIP3,2011-12-31,2012-03-15,278499,556999,835498
8277,UNIP3,2012-03-31,2012-05-15,278499,556999,835498
8278,UNIP3,2012-06-30,2012-08-14,278499,556999,835498
8279,UNIP3,2012-09-30,2012-11-12,278499,556999,835498
8280,UNIP3,2012-12-31,2013-03-13,278499,556999,835498
8281,UNIP3,2013-03-31,2013-05-14,278499,556999,835498
8282,UNIP3,2013-06-30,2013-08-09,278499,556999,835498
8283,UNIP3,2013-09-30,2013-11-12,278501,557001,835502
8284,UNIP3,2013-12-31,2014-03-27,278501,557001,835502
8285,UNIP3,2014-03-31,2014-05-15,278501,557001,835502
8286,UNIP3,2014-06-30,2014-08-13,278501,557001,835502
8287,UNIP3,2014-09-30,2014-11-06,278501,557001,835502
8288,UNIP3,2014-12-31,2015-03-11,27850,55700,83550
8289,UNIP3,2015-03-31,2015-05-13,27850,55700,83550
8290,UNIP3,2015-06-30,2015-08-12,27850,55700,83550
8291,UNIP3,2015-09-30,2015-11-11,27850,55700,83550
8292,UNIP3,2015-12-31,2016-03-28,27850,55700,83550
8293,UNIP3,2016-03-31,2016-05-11,27850,55700,83550
8294,UNIP3,2016-06-30,2016-08-10,27850,55700,83550
8295,UNIP3,2016-09-30,2016-11-07,27850,55700,83550
8296,UNIP3,2016-12-31,2017-05-05,27850,55700,83550
8297,UNIP3,2017-03-31,2017-05-15,27850,55700,83550
8298,UNIP3,2017-06-30,2017-08-15,27850,55700,83550
8299,UNIP3,2017-09-30,2017-11-14,27850,55700,83550
8300,UNIP3,2017-12-31,2018-03-14,27850,55700,83550
8301,UNIP3,2018-03-31,2018-05-14,27850,55700,83550
8302,UNIP3,2018-06-30,2018-08-14,27850,55700,83550
8303,UNIP3,2018-09-30,2018-11-09,27850,55700,83550
8304,UNIP3,2018-12-31,2019-03-14,30382,60764,91146
8305,UNIP3,2019-03-31,2019-05-13,30216,56938,87154
8306,UNIP3,2019-06-30,2019-08-13,35252,66428,101680
8307,UNIP3,2019-09-30,2019-11-13,35252,66428,101680
8308,UNIP3,2019-12-31,2020-03-13,35252,66428,101680
8309,UNIP3,2020-03-31,2020-05-13,34462,63356,97818
8310,UNIP3,2020-06-30,2020-08-12,34462,63356,97818
8311,UNIP3,2020-09-30,2020-11-11,33703,61914,95617
8312,UNIP3,2020-12-31,2021-03-17,33007,61425,94432
8313,UNIP5,2010-12-31,2011-03-24,278499,556999,835498
8314,UNIP5,2011-03-31,2011-05-13,278499,556999,835498
8315,UNIP5,2011-06-30,2011-08-11,278499,556999,835498
8316,UNIP5,2011-09-30,2011-11-10,278499,556999,835498
8317,UNIP5,2011-12-31,2012-03-15,278499,556999,835498
8318,UNIP5,2012-03-31,2012-05-15,278499,556999,835498
8319,UNIP5,2012-06-30,2012-08-14,278499,556999,835498
8320,UNIP5,2012-09-30,2012-11-12,278499,556999,835498
8321,UNIP5,2012-12-31,2013-03-13,278499,556999,835498
8322,UNIP5,2013-03-31,2013-05-14,278499,556999,835498
8323,UNIP5,2013-06-30,2013-08-09,278499,556999,835498
8324,UNIP5,2013-09-30,2013-11-12,278501,557001,835502
8325,UNIP5,2013-12-31,2014-03-27,278501,557001,835502
8326,UNIP5,2014-03-31,2014-05-15,278501,557001,835502
8327,UNIP5,2014-06-30,2014-08-13,278501,557001,835502
8328,UNIP5,2014-09-30,2014-11-06,278501,557001,835502
8329,UNIP5,2014-12-31,2015-03-11,27850,55700,83550
8330,UNIP5,2015-03-31,2015-05-13,27850,55700,83550
8331,UNIP5,2015-06-30,2015-08-12,27850,55700,83550
8332,UNIP5,2015-09-30,2015-11-11,27850,55700,83550
8333,UNIP5,2015-12-31,2016-03-28,27850,55700,83550
8334,UNIP5,2016-03-31,2016-05-11,27850,55700,83550
8335,UNIP5,2016-06-30,2016-08-10,27850,55700,83550
8336,UNIP5,2016-09-30,2016-11-07,27850,55700,83550
8337,UNIP5,2016-12-31,2017-05-05,27850,55700,83550
8338,UNIP5,2017-03-31,2017-05-15,27850,55700,83550
8339,UNIP5,2017-06-30,2017-08-15,27850,55700,83550
8340,UNIP5,2017-09-30,2017-11-14,27850,55700,83550
8341,UNIP5,2017-12-31,2018-03-14,27850,55700,83550
8342,UNIP5,2018-03-31,2018-05-14,27850,55700,83550
8343,UNIP5,2018-06-30,2018-08-14,27850,55700,83550
8344,UNIP5,2018-09-30,2018-11-09,27850,55700,83550
8345,UNIP5,2018-12-31,2019-03-14,30382,60764,91146
8346,UNIP5,2019-03-31,2019-05-13,30216,56938,87154
8347,UNIP5,2019-06-30,2019-08-13,35252,66428,101680
8348,UNIP5,2019-09-30,2019-11-13,35252,66428,101680
8349,UNIP5,2019-12-31,2020-03-13,35252,66428,101680
8350,UNIP5,2020-03-31,2020-05-13,34462,63356,97818
8351,UNIP5,2020-06-30,2020-08-12,34462,63356,97818
8352,UNIP5,2020-09-30,2020-11-11,33703,61914,95617
8353,UNIP5,2020-12-31,2021-03-17,33007,61425,94432
8354,UNIP6,2010-12-31,2011-03-24,278499,556999,835498
8355,UNIP6,2011-03-31,2011-05-13,278499,556999,835498
8356,UNIP6,2011-06-30,2011-08-11,278499,556999,835498
8357,UNIP6,2011-09-30,2011-11-10,278499,556999,835498
8358,UNIP6,2011-12-31,2012-03-15,278499,556999,835498
8359,UNIP6,2012-03-31,2012-05-15,278499,556999,835498
8360,UNIP6,2012-06-30,2012-08-14,278499,556999,835498
8361,UNIP6,2012-09-30,2012-11-12,278499,556999,835498
8362,UNIP6,2012-12-31,2013-03-13,278499,556999,835498
8363,UNIP6,2013-03-31,2013-05-14,278499,556999,835498
8364,UNIP6,2013-06-30,2013-08-09,278499,556999,835498
8365,UNIP6,2013-09-30,2013-11-12,278501,557001,835502
8366,UNIP6,2013-12-31,2014-03-27,278501,557001,835502
8367,UNIP6,2014-03-31,2014-05-15,278501,557001,835502
8368,UNIP6,2014-06-30,2014-08-13,278501,557001,835502
8369,UNIP6,2014-09-30,2014-11-06,278501,557001,835502
8370,UNIP6,2014-12-31,2015-03-11,27850,55700,83550
8371,UNIP6,2015-03-31,2015-05-13,27850,55700,83550
8372,UNIP6,2015-06-30,2015-08-12,27850,55700,83550
8373,UNIP6,2015-09-30,2015-11-11,27850,55700,83550
8374,UNIP6,2015-12-31,2016-03-28,27850,55700,83550
8375,UNIP6,2016-03-31,2016-05-11,27850,55700,83550
8376,UNIP6,2016-06-30,2016-08-10,27850,55700,83550
8377,UNIP6,2016-09-30,2016-11-07,27850,55700,83550
8378,UNIP6,2016-12-31,2017-05-05,27850,55700,83550
8379,UNIP6,2017-03-31,2017-05-15,27850,55700,83550
8380,UNIP6,2017-06-30,2017-08-15,27850,55700,83550
8381,UNIP6,2017-09-30,2017-11-14,27850,55700,83550
8382,UNIP6,2017-12-31,2018-03-14,27850,55700,83550
8383,UNIP6,2018-03-31,2018-05-14,27850,55700,83550
8384,UNIP6,2018-06-30,2018-08-14,27850,55700,83550
8385,UNIP6,2018-09-30,2018-11-09,27850,55700,83550
8386,UNIP6,2018-12-31,2019-03-14,30382,60764,91146
8387,UNIP6,2019-03-31,2019-05-13,30216,56938,87154
8388,UNIP6,2019-06-30,2019-08-13,35252,66428,101680
8389,UNIP6,2019-09-30,2019-11-13,35252,66428,101680
8390,UNIP6,2019-12-31,2020-03-13,35252,66428,101680
8391,UNIP6,2020-03-31,2020-05-13,34462,63356,97818
8392,UNIP6,2020-06-30,2020-08-12,34462,63356,97818
8393,UNIP6,2020-09-30,2020-11-11,33703,61914,95617
8394,UNIP6,2020-12-31,2021-03-17,33007,61425,94432
8395,VULC3,2010-12-31,2011-03-02,70000000,0,70000000
8396,VULC3,2011-03-31,2011-05-16,280000,0,280000
8397,VULC3,2011-06-30,2011-08-16,280000,0,280000
8398,VULC3,2011-09-30,2011-11-29,280000,0,280000
8399,VULC3,2011-12-31,2012-04-03,280000000,0,280000000
8400,VULC3,2012-03-31,2012-05-17,280000,0,280000
8401,VULC3,2012-06-30,2012-08-22,280000,0,280000
8402,VULC3,2012-09-30,2012-11-22,280000,0,280000
8403,VULC3,2012-12-31,2013-07-10,280000,0,280000
8404,VULC3,2013-03-31,2013-05-13,280000,0,280000
8405,VULC3,2013-06-30,2013-08-12,280000,0,280000
8406,VULC3,2013-09-30,2013-11-04,332285,0,332285
8407,VULC3,2013-12-31,2014-03-20,740921,0,740921
8408,VULC3,2014-03-31,2014-05-14,740921,0,740921
8409,VULC3,2014-06-30,2014-08-12,740921,0,740921
8410,VULC3,2014-09-30,2014-11-11,740921,0,740921
8411,VULC3,2014-12-31,2015-03-13,740921,0,740921
8412,VULC3,2015-03-31,2015-05-08,740921,0,740921
8413,VULC3,2015-06-30,2015-08-12,740921,0,740921
8414,VULC3,2015-09-30,2015-11-09,740921,0,740921
8415,VULC3,2015-12-31,2017-10-02,740921,0,740921
8416,VULC3,2016-03-31,2016-05-05,185230,0,185230
8417,VULC3,2016-06-30,2016-08-09,185230,0,185230
8418,VULC3,2016-09-30,2016-11-09,185230,0,185230
8419,VULC3,2016-12-31,2017-10-02,185230,0,185230
8420,VULC3,2017-03-31,2017-05-04,185230,0,185230
8421,VULC3,2017-06-30,2017-10-02,185230,0,185230
8422,VULC3,2017-09-30,2017-11-14,185230,0,185230
8423,VULC3,2017-12-31,2018-03-08,245756,0,245756
8424,VULC3,2018-03-31,2018-05-08,245756,0,245756
8425,VULC3,2018-06-30,2018-08-13,245756,0,245756
8426,VULC3,2018-09-30,2018-11-05,245756,0,245756
8427,VULC3,2018-12-31,2019-03-11,245756,0,245756
8428,VULC3,2019-03-31,2019-05-06,245756,0,245756
8429,VULC3,2019-06-30,2019-08-05,245756,0,245756
8430,VULC3,2019-09-30,2019-11-04,245756,0,245756
8431,VULC3,2019-12-31,2020-03-02,245756,0,245756
8432,VULC3,2020-03-31,2020-06-08,245756,0,245756
8433,VULC3,2020-06-30,2020-08-10,245756,0,245756
8434,VULC3,2020-09-30,2020-11-09,245756,0,245756
8435,VULC3,2020-12-31,2021-03-09,245756,0,245756
8436,MYPK3,2010-12-31,2011-02-23,94863,0,94863
8437,MYPK3,2011-03-31,2011-05-10,94863,0,94863
8438,MYPK3,2011-06-30,2011-08-10,94863,0,94863
8439,MYPK3,2011-09-30,2011-11-09,94863,0,94863
8440,MYPK3,2011-12-31,2012-02-27,94863,0,94863
8441,MYPK3,2012-03-31,2012-05-15,94863,0,94863
8442,MYPK3,2012-06-30,2012-08-14,94863,0,94863
8443,MYPK3,2012-09-30,2012-11-08,94863,0,94863
8444,MYPK3,2012-12-31,2013-02-28,94863,0,94863
8445,MYPK3,2013-03-31,2013-05-15,94863,0,94863
8446,MYPK3,2013-06-30,2013-08-14,94863,0,94863
8447,MYPK3,2013-09-30,2013-11-07,94863,0,94863
8448,MYPK3,2013-12-31,2014-04-11,94863,0,94863
8449,MYPK3,2014-03-31,2014-05-15,94863,0,94863
8450,MYPK3,2014-06-30,2014-08-06,94863,0,94863
8451,MYPK3,2014-09-30,2014-11-05,94863,0,94863
8452,MYPK3,2014-12-31,2015-02-25,94863,0,94863
8453,MYPK3,2015-03-31,2015-05-07,94863,0,94863
8454,MYPK3,2015-06-30,2015-08-06,94863,0,94863
8455,MYPK3,2015-09-30,2015-11-05,94863,0,94863
8456,MYPK3,2015-12-31,2016-02-25,94863,0,94863
8457,MYPK3,2016-03-31,2016-05-05,94863,0,94863
8458,MYPK3,2016-06-30,2016-08-04,94863,0,94863
8459,MYPK3,2016-09-30,2016-11-10,94863,0,94863
8460,MYPK3,2016-12-31,2017-03-27,94863,0,94863
8461,MYPK3,2017-03-31,2017-05-11,138511,0,138511
8462,MYPK3,2017-06-30,2017-08-10,138519,0,138519
8463,MYPK3,2017-09-30,2017-11-09,139167,0,139167
8464,MYPK3,2017-12-31,2018-02-20,140328,0,140328
8465,MYPK3,2018-03-31,2018-05-10,150575,0,150575
8466,MYPK3,2018-06-30,2018-08-09,150575,0,150575
8467,MYPK3,2018-09-30,2018-11-08,150575,0,150575
8468,MYPK3,2018-12-31,2019-03-11,150575,0,150575
8469,MYPK3,2019-03-31,2019-05-08,150575,0,150575
8470,MYPK3,2019-06-30,2019-08-06,153720,0,153720
8471,MYPK3,2019-09-30,2019-11-06,153720,0,153720
8472,MYPK3,2019-12-31,2020-03-05,153720,0,153720
8473,MYPK3,2020-03-31,2020-05-14,153720,0,153720
8474,MYPK3,2020-06-30,2020-08-13,153720,0,153720
8475,MYPK3,2020-09-30,2020-11-03,153720,0,153720
8476,MYPK3,2020-12-31,2021-03-03,153720,0,153720
8477,AZEV3,2010-12-31,2011-03-31,9000,18000,27000
8478,AZEV3,2011-03-31,2011-08-31,9000,18000,27000
8479,AZEV3,2011-06-30,2011-08-31,9000000,18000000,27000000
8480,AZEV3,2011-09-30,2011-11-29,9000000,18000000,27000000
8481,AZEV3,2011-12-31,2012-03-30,9000000,18000000,27000000
8482,AZEV3,2012-03-31,2012-05-30,9000000,18000000,27000000
8483,AZEV3,2012-06-30,2012-08-30,9000000,18000000,27000000
8484,AZEV3,2012-09-30,2012-11-30,9000000,18000000,27000000
8485,AZEV3,2012-12-31,2013-03-28,9000000,18000000,27000000
8486,AZEV3,2013-03-31,2013-05-29,9000000,18000000,27000000
8487,AZEV3,2013-06-30,2013-08-28,9000000,18000000,27000000
8488,AZEV3,2013-09-30,2013-11-27,9000000,18000000,27000000
8489,AZEV3,2013-12-31,2014-03-28,9000000,18000000,27000000
8490,AZEV3,2014-03-31,2014-05-30,9000000,18000000,27000000
8491,AZEV3,2014-06-30,2014-08-14,9000000,18000000,27000000
8492,AZEV3,2014-09-30,2014-11-14,9000000,18000000,27000000
8493,AZEV3,2014-12-31,2015-03-30,9000000,18000000,27000000
8494,AZEV3,2015-03-31,2015-05-15,9000000,18000000,27000000
8495,AZEV3,2015-06-30,2015-08-14,9000000,18000000,27000000
8496,AZEV3,2015-09-30,2015-11-13,9000000,18000000,27000000
8497,AZEV3,2015-12-31,2016-03-28,9000000,18000000,27000000
8498,AZEV3,2016-03-31,2016-05-13,9000000,18000000,27000000
8499,AZEV3,2016-06-30,2016-08-15,9000000,18000000,27000000
8500,AZEV3,2016-09-30,2016-11-14,9000000,18000000,27000000
8501,AZEV3,2016-12-31,2017-03-31,9000000,18000000,27000000
8502,AZEV3,2017-03-31,2017-05-15,9000000,18000000,27000000
8503,AZEV3,2017-06-30,2017-08-14,9000000,18000000,27000000
8504,AZEV3,2017-09-30,2017-11-14,9000000,18000000,27000000
8505,AZEV3,2017-12-31,2018-03-29,9000000,18000000,27000000
8506,AZEV3,2018-03-31,2018-11-26,9000000,18000000,27000000
8507,AZEV3,2018-06-30,2019-03-01,9000000,18000000,27000000
8508,AZEV3,2018-09-30,2019-09-06,9000000,18000000,27000000
8509,AZEV3,2018-12-31,2019-09-06,9000000,18000000,27000000
8510,AZEV3,2019-03-31,2020-02-17,9000000,18000000,27000000
8511,AZEV3,2019-06-30,2020-06-26,1800000,3600000,5400000
8512,AZEV3,2019-09-30,2020-06-26,1800000,3600000,5400000
8513,AZEV3,2019-12-31,2020-06-25,1800000,3600000,5400000
8514,AZEV3,2020-03-31,2020-08-18,1800000,3600000,5400000
8515,AZEV3,2020-06-30,2020-08-31,1800000,3600000,5400000
8516,AZEV3,2020-09-30,2020-11-16,1800000,3600000,5400000
8517,AZEV4,2010-12-31,2011-03-31,9000,18000,27000
8518,AZEV4,2011-03-31,2011-08-31,9000,18000,27000
8519,AZEV4,2011-06-30,2011-08-31,9000000,18000000,27000000
8520,AZEV4,2011-09-30,2011-11-29,9000000,18000000,27000000
8521,AZEV4,2011-12-31,2012-03-30,9000000,18000000,27000000
8522,AZEV4,2012-03-31,2012-05-30,9000000,18000000,27000000
8523,AZEV4,2012-06-30,2012-08-30,9000000,18000000,27000000
8524,AZEV4,2012-09-30,2012-11-30,9000000,18000000,27000000
8525,AZEV4,2012-12-31,2013-03-28,9000000,18000000,27000000
8526,AZEV4,2013-03-31,2013-05-29,9000000,18000000,27000000
8527,AZEV4,2013-06-30,2013-08-28,9000000,18000000,27000000
8528,AZEV4,2013-09-30,2013-11-27,9000000,18000000,27000000
8529,AZEV4,2013-12-31,2014-03-28,9000000,18000000,27000000
8530,AZEV4,2014-03-31,2014-05-30,9000000,18000000,27000000
8531,AZEV4,2014-06-30,2014-08-14,9000000,18000000,27000000
8532,AZEV4,2014-09-30,2014-11-14,9000000,18000000,27000000
8533,AZEV4,2014-12-31,2015-03-30,9000000,18000000,27000000
8534,AZEV4,2015-03-31,2015-05-15,9000000,18000000,27000000
8535,AZEV4,2015-06-30,2015-08-14,9000000,18000000,27000000
8536,AZEV4,2015-09-30,2015-11-13,9000000,18000000,27000000
8537,AZEV4,2015-12-31,2016-03-28,9000000,18000000,27000000
8538,AZEV4,2016-03-31,2016-05-13,9000000,18000000,27000000
8539,AZEV4,2016-06-30,2016-08-15,9000000,18000000,27000000
8540,AZEV4,2016-09-30,2016-11-14,9000000,18000000,27000000
8541,AZEV4,2016-12-31,2017-03-31,9000000,18000000,27000000
8542,AZEV4,2017-03-31,2017-05-15,9000000,18000000,27000000
8543,AZEV4,2017-06-30,2017-08-14,9000000,18000000,27000000
8544,AZEV4,2017-09-30,2017-11-14,9000000,18000000,27000000
8545,AZEV4,2017-12-31,2018-03-29,9000000,18000000,27000000
8546,AZEV4,2018-03-31,2018-11-26,9000000,18000000,27000000
8547,AZEV4,2018-06-30,2019-03-01,9000000,18000000,27000000
8548,AZEV4,2018-09-30,2019-09-06,9000000,18000000,27000000
8549,AZEV4,2018-12-31,2019-09-06,9000000,18000000,27000000
8550,AZEV4,2019-03-31,2020-02-17,9000000,18000000,27000000
8551,AZEV4,2019-06-30,2020-06-26,1800000,3600000,5400000
8552,AZEV4,2019-09-30,2020-06-26,1800000,3600000,5400000
8553,AZEV4,2019-12-31,2020-06-25,1800000,3600000,5400000
8554,AZEV4,2020-03-31,2020-08-18,1800000,3600000,5400000
8555,AZEV4,2020-06-30,2020-08-31,1800000,3600000,5400000
8556,AZEV4,2020-09-30,2020-11-16,1800000,3600000,5400000
8557,MWET3,2010-12-31,2011-03-30,1715,3430,5145
8558,MWET3,2011-03-31,2011-05-13,1715,3430,5145
8559,MWET3,2011-06-30,2011-08-08,6860,13720,20580
8560,MWET3,2011-09-30,2011-11-01,6860,13720,20580
8561,MWET3,2011-12-31,2012-03-26,6860,13720,20580
8562,MWET3,2012-03-31,2012-05-15,6860,13720,20580
8563,MWET3,2012-06-30,2012-08-14,6860,13720,20580
8564,MWET3,2012-09-30,2012-11-14,6860,13720,20580
8565,MWET3,2012-12-31,2013-03-25,6860,13720,20580
8566,MWET3,2013-03-31,2013-04-23,6860,13720,20580
8567,MWET3,2013-06-30,2013-08-14,6860,13720,20580
8568,MWET3,2013-09-30,2013-11-11,6860,13720,20580
8569,MWET3,2013-12-31,2014-03-27,6860,13720,20580
8570,MWET3,2014-03-31,2014-05-14,6860,13720,20580
8571,MWET3,2014-06-30,2014-08-15,6860,13720,20580
8572,MWET3,2014-09-30,2014-11-14,6860,13720,20580
8573,MWET3,2014-12-31,2015-03-26,6860,13720,20580
8574,MWET3,2015-03-31,2015-05-15,6860,13720,20580
8575,MWET3,2015-06-30,2015-08-13,6860,13720,20580
8576,MWET3,2015-09-30,2015-11-12,686,1372,2058
8577,MWET3,2015-12-31,2016-04-15,686,1372,2058
8578,MWET3,2016-03-31,2016-05-16,686,1372,2058
8579,MWET3,2016-06-30,2016-08-11,686,1372,2058
8580,MWET3,2016-09-30,2016-11-11,686,1372,2058
8581,MWET3,2016-12-31,2017-03-23,686,1372,2058
8582,MWET3,2017-03-31,2017-05-11,686,1372,2058
8583,MWET3,2017-06-30,2017-08-14,686,1372,2058
8584,MWET3,2017-09-30,2017-11-14,686,1372,2058
8585,MWET3,2017-12-31,2018-03-28,686,1372,2058
8586,MWET3,2018-03-31,2018-05-15,686,1372,2058
8587,MWET3,2018-06-30,2018-08-14,686,1372,2058
8588,MWET3,2018-09-30,2018-11-14,686,1372,2058
8589,MWET3,2018-12-31,2019-03-25,686,1372,2058
8590,MWET3,2019-03-31,2019-05-14,686,1372,2058
8591,MWET3,2019-06-30,2019-08-14,686,1372,2058
8592,MWET3,2019-09-30,2019-11-13,686,1372,2058
8593,MWET3,2019-12-31,2020-03-26,686,1372,2058
8594,MWET3,2020-03-31,2020-06-17,686,1372,2058
8595,MWET3,2020-06-30,2020-08-27,686,1372,2058
8596,MWET3,2020-09-30,2020-11-16,686,1372,2058
8597,MWET3,2020-12-31,2021-03-18,686,1372,2058
8598,MWET4,2010-12-31,2011-03-30,1715,3430,5145
8599,MWET4,2011-03-31,2011-05-13,1715,3430,5145
8600,MWET4,2011-06-30,2011-08-08,6860,13720,20580
8601,MWET4,2011-09-30,2011-11-01,6860,13720,20580
8602,MWET4,2011-12-31,2012-03-26,6860,13720,20580
8603,MWET4,2012-03-31,2012-05-15,6860,13720,20580
8604,MWET4,2012-06-30,2012-08-14,6860,13720,20580
8605,MWET4,2012-09-30,2012-11-14,6860,13720,20580
8606,MWET4,2012-12-31,2013-03-25,6860,13720,20580
8607,MWET4,2013-03-31,2013-04-23,6860,13720,20580
8608,MWET4,2013-06-30,2013-08-14,6860,13720,20580
8609,MWET4,2013-09-30,2013-11-11,6860,13720,20580
8610,MWET4,2013-12-31,2014-03-27,6860,13720,20580
8611,MWET4,2014-03-31,2014-05-14,6860,13720,20580
8612,MWET4,2014-06-30,2014-08-15,6860,13720,20580
8613,MWET4,2014-09-30,2014-11-14,6860,13720,20580
8614,MWET4,2014-12-31,2015-03-26,6860,13720,20580
8615,MWET4,2015-03-31,2015-05-15,6860,13720,20580
8616,MWET4,2015-06-30,2015-08-13,6860,13720,20580
8617,MWET4,2015-09-30,2015-11-12,686,1372,2058
8618,MWET4,2015-12-31,2016-04-15,686,1372,2058
8619,MWET4,2016-03-31,2016-05-16,686,1372,2058
8620,MWET4,2016-06-30,2016-08-11,686,1372,2058
8621,MWET4,2016-09-30,2016-11-11,686,1372,2058
8622,MWET4,2016-12-31,2017-03-23,686,1372,2058
8623,MWET4,2017-03-31,2017-05-11,686,1372,2058
8624,MWET4,2017-06-30,2017-08-14,686,1372,2058
8625,MWET4,2017-09-30,2017-11-14,686,1372,2058
8626,MWET4,2017-12-31,2018-03-28,686,1372,2058
8627,MWET4,2018-03-31,2018-05-15,686,1372,2058
8628,MWET4,2018-06-30,2018-08-14,686,1372,2058
8629,MWET4,2018-09-30,2018-11-14,686,1372,2058
8630,MWET4,2018-12-31,2019-03-25,686,1372,2058
8631,MWET4,2019-03-31,2019-05-14,686,1372,2058
8632,MWET4,2019-06-30,2019-08-14,686,1372,2058
8633,MWET4,2019-09-30,2019-11-13,686,1372,2058
8634,MWET4,2019-12-31,2020-03-26,686,1372,2058
8635,MWET4,2020-03-31,2020-06-17,686,1372,2058
8636,MWET4,2020-06-30,2020-08-27,686,1372,2058
8637,MWET4,2020-09-30,2020-11-16,686,1372,2058
8638,MWET4,2020-12-31,2021-03-18,686,1372,2058
8639,BOBR3,2010-12-31,2011-03-29,20000,34065,54065
8640,BOBR3,2011-03-31,2011-05-26,20000,34065,54065
8641,BOBR3,2011-06-30,2011-08-15,20000,34065,54065
8642,BOBR3,2011-09-30,2012-01-13,20000,34065,54065
8643,BOBR3,2011-12-31,2012-03-30,20000,34065,54065
8644,BOBR3,2012-03-31,2012-05-15,20000,34065,54065
8645,BOBR3,2012-06-30,2012-08-15,20000,34065,54065
8646,BOBR3,2012-09-30,2012-11-14,20000,34065,54065
8647,BOBR3,2012-12-31,2013-03-27,20000,34065,54065
8648,BOBR3,2013-03-31,2013-05-20,20000,34065,54065
8649,BOBR3,2013-06-30,2013-08-16,20000,34065,54065
8650,BOBR3,2013-09-30,2013-11-13,20000,34065,54065
8651,BOBR3,2013-12-31,2014-04-04,20000,34065,54065
8652,BOBR3,2014-03-31,2014-05-16,20000,34065,54065
8653,BOBR3,2014-06-30,2014-08-15,20000,34065,54065
8654,BOBR3,2014-09-30,2014-11-17,20000,34065,54065
8655,BOBR3,2014-12-31,2015-03-30,20000,34065,54065
8656,BOBR3,2015-03-31,2015-05-15,20000,34065,54065
8657,BOBR3,2015-06-30,2015-08-14,20000,34065,54065
8658,BOBR3,2015-09-30,2015-11-13,20000,34065,54065
8659,BOBR3,2015-12-31,2016-03-29,20000,34065,54065
8660,BOBR3,2016-03-31,2016-04-26,20000,34065,54065
8661,BOBR3,2016-06-30,2016-08-11,20000,34065,54065
8662,BOBR3,2016-09-30,2016-11-07,20000,34065,54065
8663,BOBR3,2016-12-31,2017-03-26,20000,34065,54065
8664,BOBR3,2017-03-31,2017-05-16,20000,34065,54065
8665,BOBR3,2017-06-30,2017-08-11,20000,34065,54065
8666,BOBR3,2017-09-30,2017-11-14,20000,34065,54065
8667,BOBR3,2017-12-31,2018-05-09,20000,34065,54065
8668,BOBR3,2018-03-31,2018-05-15,20000,34065,54065
8669,BOBR3,2018-06-30,2018-08-10,20000,34065,54065
8670,BOBR3,2018-09-30,2018-11-14,20000,34065,54065
8671,BOBR3,2018-12-31,2019-03-26,20000,34065,54065
8672,BOBR3,2019-03-31,2019-05-10,20000,34065,54065
8673,BOBR3,2019-06-30,2019-08-08,20000,34065,54065
8674,BOBR3,2019-09-30,2019-11-19,137615,122895,260510
8675,BOBR3,2019-12-31,2020-03-27,137615,122894,260509
8676,BOBR3,2020-03-31,2020-06-12,137615,122894,260509
8677,BOBR3,2020-06-30,2020-08-14,137615,122894,260509
8678,BOBR3,2020-09-30,2020-11-13,137615,122894,260509
8679,BOBR4,2010-12-31,2011-03-29,20000,34065,54065
8680,BOBR4,2011-03-31,2011-05-26,20000,34065,54065
8681,BOBR4,2011-06-30,2011-08-15,20000,34065,54065
8682,BOBR4,2011-09-30,2012-01-13,20000,34065,54065
8683,BOBR4,2011-12-31,2012-03-30,20000,34065,54065
8684,BOBR4,2012-03-31,2012-05-15,20000,34065,54065
8685,BOBR4,2012-06-30,2012-08-15,20000,34065,54065
8686,BOBR4,2012-09-30,2012-11-14,20000,34065,54065
8687,BOBR4,2012-12-31,2013-03-27,20000,34065,54065
8688,BOBR4,2013-03-31,2013-05-20,20000,34065,54065
8689,BOBR4,2013-06-30,2013-08-16,20000,34065,54065
8690,BOBR4,2013-09-30,2013-11-13,20000,34065,54065
8691,BOBR4,2013-12-31,2014-04-04,20000,34065,54065
8692,BOBR4,2014-03-31,2014-05-16,20000,34065,54065
8693,BOBR4,2014-06-30,2014-08-15,20000,34065,54065
8694,BOBR4,2014-09-30,2014-11-17,20000,34065,54065
8695,BOBR4,2014-12-31,2015-03-30,20000,34065,54065
8696,BOBR4,2015-03-31,2015-05-15,20000,34065,54065
8697,BOBR4,2015-06-30,2015-08-14,20000,34065,54065
8698,BOBR4,2015-09-30,2015-11-13,20000,34065,54065
8699,BOBR4,2015-12-31,2016-03-29,20000,34065,54065
8700,BOBR4,2016-03-31,2016-04-26,20000,34065,54065
8701,BOBR4,2016-06-30,2016-08-11,20000,34065,54065
8702,BOBR4,2016-09-30,2016-11-07,20000,34065,54065
8703,BOBR4,2016-12-31,2017-03-26,20000,34065,54065
8704,BOBR4,2017-03-31,2017-05-16,20000,34065,54065
8705,BOBR4,2017-06-30,2017-08-11,20000,34065,54065
8706,BOBR4,2017-09-30,2017-11-14,20000,34065,54065
8707,BOBR4,2017-12-31,2018-05-09,20000,34065,54065
8708,BOBR4,2018-03-31,2018-05-15,20000,34065,54065
8709,BOBR4,2018-06-30,2018-08-10,20000,34065,54065
8710,BOBR4,2018-09-30,2018-11-14,20000,34065,54065
8711,BOBR4,2018-12-31,2019-03-26,20000,34065,54065
8712,BOBR4,2019-03-31,2019-05-10,20000,34065,54065
8713,BOBR4,2019-06-30,2019-08-08,20000,34065,54065
8714,BOBR4,2019-09-30,2019-11-19,137615,122895,260510
8715,BOBR4,2019-12-31,2020-03-27,137615,122894,260509
8716,BOBR4,2020-03-31,2020-06-12,137615,122894,260509
8717,BOBR4,2020-06-30,2020-08-14,137615,122894,260509
8718,BOBR4,2020-09-30,2020-11-13,137615,122894,260509
8719,JBDU3,2010-12-31,2011-03-29,193573,387132,580705
8720,JBDU3,2011-03-31,2011-05-13,193573,387132,580705
8721,JBDU3,2011-06-30,2011-08-15,193573,387132,580705
8722,JBDU3,2011-09-30,2011-11-09,193573,387132,580705
8723,JBDU3,2011-12-31,2012-03-19,309716,619412,929128
8724,JBDU3,2012-03-31,2012-05-16,309716,619412,929128
8725,JBDU3,2012-06-30,2012-08-14,309716,619412,929128
8726,JBDU3,2012-09-30,2012-10-18,309716,619412,929128
8727,JBDU3,2012-12-31,2013-02-15,464575,929117,1393692
8728,JBDU3,2013-03-31,2013-05-15,464575,929117,1393692
8729,JBDU3,2013-06-30,2013-08-14,4646,9291,13937
8730,JBDU3,2013-09-30,2013-11-12,9291,18582,27873
8731,JBDU3,2013-12-31,2014-02-13,9291,18582,27873
8732,JBDU3,2014-03-31,2014-07-25,9292,18582,27874
8733,JBDU3,2014-06-30,2014-08-13,9292,18582,27874
8734,JBDU3,2014-09-30,2014-11-13,18583,37165,55748
8735,JBDU3,2014-12-31,2015-03-30,186,371,557
8736,JBDU3,2015-03-31,2015-05-15,186,371,557
8737,JBDU3,2015-06-30,2015-08-14,186,371,557
8738,JBDU3,2015-09-30,2015-11-13,186,371,557
8739,JBDU3,2015-12-31,2016-05-05,186,371,557
8740,JBDU3,2016-03-31,2016-11-09,185830,371647,557477
8741,JBDU3,2016-06-30,2017-02-22,185830,371647,557477
8742,JBDU3,2016-09-30,2017-04-11,371660,743294,1114954
8743,JBDU3,2016-12-31,2017-06-07,371660,743294,1114954
8744,JBDU3,2017-03-31,2017-10-25,371660,743294,1114954
8745,JBDU3,2017-06-30,2017-12-24,371660,743294,1114954
8746,JBDU3,2017-09-30,2018-02-21,371660,743294,1114954
8747,JBDU3,2017-12-31,2018-04-05,1356559,2713023,4069582
8748,JBDU3,2018-03-31,2018-08-21,1356559,2713023,4069582
8749,JBDU3,2018-06-30,2019-02-19,1356559,2713023,4069582
8750,JBDU3,2018-09-30,2019-04-18,45218,90435,135653
8751,JBDU3,2018-12-31,2019-07-18,45218,90435,135653
8752,JBDU3,2019-03-31,2019-12-27,1673066,3346095,5019161
8753,JBDU3,2019-06-30,2020-02-12,1673066,3346095,5019161
8754,JBDU3,2019-09-30,2020-03-18,1673066,3346095,5019161
8755,JBDU3,2019-12-31,2020-07-07,1673066,3346095,5019161
8756,JBDU3,2020-03-31,2020-09-24,1673066,3346095,5019161
8757,JBDU3,2020-06-30,2020-11-12,1673066,3346095,5019161
8758,JBDU3,2020-09-30,2021-01-15,1673066,3346095,5019161
8759,JBDU4,2010-12-31,2011-03-29,193573,387132,580705
8760,JBDU4,2011-03-31,2011-05-13,193573,387132,580705
8761,JBDU4,2011-06-30,2011-08-15,193573,387132,580705
8762,JBDU4,2011-09-30,2011-11-09,193573,387132,580705
8763,JBDU4,2011-12-31,2012-03-19,309716,619412,929128
8764,JBDU4,2012-03-31,2012-05-16,309716,619412,929128
8765,JBDU4,2012-06-30,2012-08-14,309716,619412,929128
8766,JBDU4,2012-09-30,2012-10-18,309716,619412,929128
8767,JBDU4,2012-12-31,2013-02-15,464575,929117,1393692
8768,JBDU4,2013-03-31,2013-05-15,464575,929117,1393692
8769,JBDU4,2013-06-30,2013-08-14,4646,9291,13937
8770,JBDU4,2013-09-30,2013-11-12,9291,18582,27873
8771,JBDU4,2013-12-31,2014-02-13,9291,18582,27873
8772,JBDU4,2014-03-31,2014-07-25,9292,18582,27874
8773,JBDU4,2014-06-30,2014-08-13,9292,18582,27874
8774,JBDU4,2014-09-30,2014-11-13,18583,37165,55748
8775,JBDU4,2014-12-31,2015-03-30,186,371,557
8776,JBDU4,2015-03-31,2015-05-15,186,371,557
8777,JBDU4,2015-06-30,2015-08-14,186,371,557
8778,JBDU4,2015-09-30,2015-11-13,186,371,557
8779,JBDU4,2015-12-31,2016-05-05,186,371,557
8780,JBDU4,2016-03-31,2016-11-09,185830,371647,557477
8781,JBDU4,2016-06-30,2017-02-22,185830,371647,557477
8782,JBDU4,2016-09-30,2017-04-11,371660,743294,1114954
8783,JBDU4,2016-12-31,2017-06-07,371660,743294,1114954
8784,JBDU4,2017-03-31,2017-10-25,371660,743294,1114954
8785,JBDU4,2017-06-30,2017-12-24,371660,743294,1114954
8786,JBDU4,2017-09-30,2018-02-21,371660,743294,1114954
8787,JBDU4,2017-12-31,2018-04-05,1356559,2713023,4069582
8788,JBDU4,2018-03-31,2018-08-21,1356559,2713023,4069582
8789,JBDU4,2018-06-30,2019-02-19,1356559,2713023,4069582
8790,JBDU4,2018-09-30,2019-04-18,45218,90435,135653
8791,JBDU4,2018-12-31,2019-07-18,45218,90435,135653
8792,JBDU4,2019-03-31,2019-12-27,1673066,3346095,5019161
8793,JBDU4,2019-06-30,2020-02-12,1673066,3346095,5019161
8794,JBDU4,2019-09-30,2020-03-18,1673066,3346095,5019161
8795,JBDU4,2019-12-31,2020-07-07,1673066,3346095,5019161
8796,JBDU4,2020-03-31,2020-09-24,1673066,3346095,5019161
8797,JBDU4,2020-06-30,2020-11-12,1673066,3346095,5019161
8798,JBDU4,2020-09-30,2021-01-15,1673066,3346095,5019161
8799,ITEC3,2010-12-31,2011-03-04,11651,0,11651
8800,ITEC3,2011-03-31,2011-05-06,11651126,0,11651126
8801,ITEC3,2011-06-30,2011-08-04,11651126,0,11651126
8802,ITEC3,2011-09-30,2011-11-04,11651126,0,11651126
8803,ITEC3,2011-12-31,2012-02-17,11651,0,11651
8804,ITEC3,2012-03-31,2012-04-25,11651,0,11651
8805,ITEC3,2012-06-30,2012-08-07,11651,0,11651
8806,ITEC3,2012-09-30,2012-10-25,11651,0,11651
8807,ITEC3,2012-12-31,2013-02-22,11651,0,11651
8808,ITEC3,2013-03-31,2013-05-03,11651,0,11651
8809,ITEC3,2013-06-30,2013-08-01,11651,0,11651
8810,ITEC3,2013-09-30,2013-11-05,11651,0,11651
8811,ITEC3,2013-12-31,2014-02-11,11651,0,11651
8812,ITEC3,2014-03-31,2014-04-28,11651,0,11651
8813,ITEC3,2014-06-30,2014-07-29,11199,0,11199
8814,ITEC3,2014-09-30,2014-10-23,11199,0,11199
8815,ITEC3,2014-12-31,2015-01-27,11199,0,11199
8816,ITEC3,2015-03-31,2015-04-30,11199,0,11199
8817,ITEC3,2015-06-30,2015-07-30,11199,0,11199
8818,ITEC3,2015-09-30,2015-10-27,11199,0,11199
8819,ITEC3,2015-12-31,2016-02-05,11199,0,11199
8820,ITEC3,2016-03-31,2016-04-27,11199,0,11199
8821,ITEC3,2016-06-30,2016-07-28,11199,0,11199
8822,ITEC3,2016-09-30,2016-11-03,11199,0,11199
8823,ITEC3,2016-12-31,2017-01-31,11199,0,11199
8824,ITEC3,2017-03-31,2017-04-25,11199,0,11199
8825,ITEC3,2017-06-30,2017-08-09,11072,0,11072
8826,ITEC3,2017-09-30,2017-10-31,11072,0,11072
8827,ITEC3,2017-12-31,2018-02-09,11072,0,11072
8828,ITEC3,2018-03-31,2018-05-08,11072,0,11072
8829,ITEC3,2018-06-30,2018-08-07,11072,0,11072
8830,ITEC3,2018-09-30,2018-11-06,11072,0,11072
8831,ITEC3,2018-12-31,2019-02-12,11072,0,11072
8832,ITEC3,2019-03-31,2019-05-08,11072,0,11072
8833,ITEC3,2019-06-30,2019-08-06,11072,0,11072
8834,RCSL3,2010-12-31,2011-03-29,18430,32849,51279
8835,RCSL3,2011-03-31,2011-05-16,22970,40941,63911
8836,RCSL3,2011-06-30,2011-08-17,22970,40941,63911
8837,RCSL3,2011-09-30,2011-11-11,22970,40941,63911
8838,RCSL3,2011-12-31,2012-03-30,22970,40941,63911
8839,RCSL3,2012-03-31,2012-05-15,22970,40941,63911
8840,RCSL3,2012-06-30,2012-08-15,35128,69701,104829
8841,RCSL3,2012-09-30,2012-11-14,35128,69701,104829
8842,RCSL3,2012-12-31,2013-04-04,78179,155124,233303
8843,RCSL3,2013-03-31,2013-05-08,78179,155124,233303
8844,RCSL3,2013-06-30,2013-08-12,78179,155124,233303
8845,RCSL3,2013-09-30,2013-11-14,78179,155124,233303
8846,RCSL3,2013-12-31,2014-03-31,78179,155124,233303
8847,RCSL3,2014-03-31,2014-05-15,78179,155124,233303
8848,RCSL3,2014-06-30,2014-08-28,78179,155124,233303
8849,RCSL3,2014-09-30,2015-03-03,78179,155124,233303
8850,RCSL3,2014-12-31,2015-06-30,78179,155124,233303
8851,RCSL3,2015-03-31,2015-10-19,78179,155124,233303
8852,RCSL3,2015-06-30,2015-10-19,78179,155124,233303
8853,RCSL3,2015-09-30,2015-11-13,1042,2068,3110
8854,RCSL3,2015-12-31,2016-08-15,1042,2068,3110
8855,RCSL3,2016-03-31,2016-09-01,1042,2068,3110
8856,RCSL3,2016-06-30,2016-09-02,1042,2068,3110
8857,RCSL3,2016-09-30,2016-11-28,12771,25338,38109
8858,RCSL3,2016-12-31,2017-03-31,12771,25338,38109
8859,RCSL3,2017-03-31,2017-07-31,12771,25338,38109
8860,RCSL3,2017-06-30,2017-08-14,12771,25338,38109
8861,RCSL3,2017-09-30,2017-11-10,12771,25338,38109
8862,RCSL3,2017-12-31,2018-03-22,1703,3378,5081
8863,RCSL3,2018-03-31,2018-05-14,1703,3378,5081
8864,RCSL3,2018-06-30,2018-08-14,1703,3378,5081
8865,RCSL3,2018-09-30,2018-10-23,1703,3378,5081
8866,RCSL3,2018-12-31,2019-03-22,1703,3378,5081
8867,RCSL3,2019-03-31,2019-05-13,1703,3378,5081
8868,RCSL3,2019-06-30,2019-08-12,25409,50414,75823
8869,RCSL3,2019-09-30,2019-11-14,25409,50414,75823
8870,RCSL3,2019-12-31,2020-03-24,25409,50414,75823
8871,RCSL3,2020-03-31,2020-05-21,25409,50414,75823
8872,RCSL3,2020-06-30,2020-08-04,25409,50414,75823
8873,RCSL3,2020-09-30,2020-11-05,25409,50414,75823
8874,RCSL3,2020-12-31,2021-03-08,25409,50414,75823
8875,RCSL4,2010-12-31,2011-03-29,18430,32849,51279
8876,RCSL4,2011-03-31,2011-05-16,22970,40941,63911
8877,RCSL4,2011-06-30,2011-08-17,22970,40941,63911
8878,RCSL4,2011-09-30,2011-11-11,22970,40941,63911
8879,RCSL4,2011-12-31,2012-03-30,22970,40941,63911
8880,RCSL4,2012-03-31,2012-05-15,22970,40941,63911
8881,RCSL4,2012-06-30,2012-08-15,35128,69701,104829
8882,RCSL4,2012-09-30,2012-11-14,35128,69701,104829
8883,RCSL4,2012-12-31,2013-04-04,78179,155124,233303
8884,RCSL4,2013-03-31,2013-05-08,78179,155124,233303
8885,RCSL4,2013-06-30,2013-08-12,78179,155124,233303
8886,RCSL4,2013-09-30,2013-11-14,78179,155124,233303
8887,RCSL4,2013-12-31,2014-03-31,78179,155124,233303
8888,RCSL4,2014-03-31,2014-05-15,78179,155124,233303
8889,RCSL4,2014-06-30,2014-08-28,78179,155124,233303
8890,RCSL4,2014-09-30,2015-03-03,78179,155124,233303
8891,RCSL4,2014-12-31,2015-06-30,78179,155124,233303
8892,RCSL4,2015-03-31,2015-10-19,78179,155124,233303
8893,RCSL4,2015-06-30,2015-10-19,78179,155124,233303
8894,RCSL4,2015-09-30,2015-11-13,1042,2068,3110
8895,RCSL4,2015-12-31,2016-08-15,1042,2068,3110
8896,RCSL4,2016-03-31,2016-09-01,1042,2068,3110
8897,RCSL4,2016-06-30,2016-09-02,1042,2068,3110
8898,RCSL4,2016-09-30,2016-11-28,12771,25338,38109
8899,RCSL4,2016-12-31,2017-03-31,12771,25338,38109
8900,RCSL4,2017-03-31,2017-07-31,12771,25338,38109
8901,RCSL4,2017-06-30,2017-08-14,12771,25338,38109
8902,RCSL4,2017-09-30,2017-11-10,12771,25338,38109
8903,RCSL4,2017-12-31,2018-03-22,1703,3378,5081
8904,RCSL4,2018-03-31,2018-05-14,1703,3378,5081
8905,RCSL4,2018-06-30,2018-08-14,1703,3378,5081
8906,RCSL4,2018-09-30,2018-10-23,1703,3378,5081
8907,RCSL4,2018-12-31,2019-03-22,1703,3378,5081
8908,RCSL4,2019-03-31,2019-05-13,1703,3378,5081
8909,RCSL4,2019-06-30,2019-08-12,25409,50414,75823
8910,RCSL4,2019-09-30,2019-11-14,25409,50414,75823
8911,RCSL4,2019-12-31,2020-03-24,25409,50414,75823
8912,RCSL4,2020-03-31,2020-05-21,25409,50414,75823
8913,RCSL4,2020-06-30,2020-08-04,25409,50414,75823
8914,RCSL4,2020-09-30,2020-11-05,25409,50414,75823
8915,RCSL4,2020-12-31,2021-03-08,25409,50414,75823
8916,KLBN11,2010-12-31,2011-02-24,316827563,600855733,917683296
8917,KLBN11,2011-03-31,2011-04-28,316827563,600855733,917683296
8918,KLBN11,2011-06-30,2011-08-01,316827563,600855733,917683296
8919,KLBN11,2011-09-30,2011-10-31,316827563,600855733,917683296
8920,KLBN11,2011-12-31,2012-03-01,316827563,600855733,917683296
8921,KLBN11,2012-03-31,2012-04-26,316827563,600855733,917683296
8922,KLBN11,2012-06-30,2012-07-26,316827563,600855733,917683296
8923,KLBN11,2012-09-30,2012-10-25,316827563,600855733,917683296
8924,KLBN11,2012-12-31,2013-02-22,316827563,600855733,917683296
8925,KLBN11,2013-03-31,2013-04-25,316827563,600855733,917683296
8926,KLBN11,2013-06-30,2013-07-25,316827563,600855733,917683296
8927,KLBN11,2013-09-30,2013-10-28,316827563,600855733,917683296
8928,KLBN11,2013-12-31,2014-02-12,316827563,600855733,917683296
8929,KLBN11,2014-03-31,2014-04-24,1684897850,3044891685,4729789535
8930,KLBN11,2014-06-30,2014-07-30,1768769959,2961019576,4729789535
8931,KLBN11,2014-09-30,2014-10-28,1768769964,2961019601,4729789565
8932,KLBN11,2014-12-31,2015-02-11,1848592200,2881197365,4729789565
8933,KLBN11,2015-03-31,2015-04-27,1848592200,2881197365,4729789565
8934,KLBN11,2015-06-30,2015-07-27,1848592200,2881197365,4729789565
8935,KLBN11,2015-09-30,2015-10-26,1848740115,2881789025,4730529140
8936,KLBN11,2015-12-31,2016-02-03,1849160105,2883468985,4732629090
8937,KLBN11,2016-03-31,2016-09-06,1849269750,2883907565,4733177315
8938,KLBN11,2016-06-30,2016-09-06,1849270515,2883910625,4733181140
8939,KLBN11,2016-09-30,2016-11-09,1849270515,2883910625,4733181140
8940,KLBN11,2016-12-31,2017-02-09,1849270515,2883910625,4733181140
8941,KLBN11,2017-03-31,2017-05-15,1849270515,2883910625,4733181140
8942,KLBN11,2017-06-30,2017-08-09,1849270515,2883910625,4733181140
8943,KLBN11,2017-09-30,2017-12-19,1849270515,2883910625,4733181140
8944,KLBN11,2017-12-31,2018-02-01,1859852065,2926236825,4786088890
8945,KLBN11,2018-03-31,2018-04-26,1984594655,3425207181,5409801836
8946,KLBN11,2018-06-30,2018-10-18,1984594655,3425207181,5409801836
8947,KLBN11,2018-09-30,2018-10-29,1984594655,3425207185,5409801840
8948,KLBN11,2018-12-31,2019-02-07,1984594655,3425207185,5409801840
8949,KLBN11,2019-03-31,2019-05-21,1984594655,3425207185,5409801840
8950,KLBN11,2019-06-30,2019-08-05,1984594655,3425207185,5409801840
8951,KLBN11,2019-09-30,2019-10-28,1984594655,3425207185,5409801840
8952,KLBN11,2019-12-31,2020-02-06,1984594655,3425207185,5409801840
8953,KLBN11,2020-03-31,2020-05-11,1984594655,3425207185,5409801840
8954,KLBN11,2020-06-30,2020-10-28,2012333899,3536164161,5548498060
8955,KLBN11,2020-09-30,2020-10-28,2012333899,3536164161,5548498060
8956,KLBN11,2020-12-31,2021-02-10,2081728595,3536164161,5617892756
8957,KLBN3,2010-12-31,2011-02-24,316827563,600855733,917683296
8958,KLBN3,2011-03-31,2011-04-28,316827563,600855733,917683296
8959,KLBN3,2011-06-30,2011-08-01,316827563,600855733,917683296
8960,KLBN3,2011-09-30,2011-10-31,316827563,600855733,917683296
8961,KLBN3,2011-12-31,2012-03-01,316827563,600855733,917683296
8962,KLBN3,2012-03-31,2012-04-26,316827563,600855733,917683296
8963,KLBN3,2012-06-30,2012-07-26,316827563,600855733,917683296
8964,KLBN3,2012-09-30,2012-10-25,316827563,600855733,917683296
8965,KLBN3,2012-12-31,2013-02-22,316827563,600855733,917683296
8966,KLBN3,2013-03-31,2013-04-25,316827563,600855733,917683296
8967,KLBN3,2013-06-30,2013-07-25,316827563,600855733,917683296
8968,KLBN3,2013-09-30,2013-10-28,316827563,600855733,917683296
8969,KLBN3,2013-12-31,2014-02-12,316827563,600855733,917683296
8970,KLBN3,2014-03-31,2014-04-24,1684897850,3044891685,4729789535
8971,KLBN3,2014-06-30,2014-07-30,1768769959,2961019576,4729789535
8972,KLBN3,2014-09-30,2014-10-28,1768769964,2961019601,4729789565
8973,KLBN3,2014-12-31,2015-02-11,1848592200,2881197365,4729789565
8974,KLBN3,2015-03-31,2015-04-27,1848592200,2881197365,4729789565
8975,KLBN3,2015-06-30,2015-07-27,1848592200,2881197365,4729789565
8976,KLBN3,2015-09-30,2015-10-26,1848740115,2881789025,4730529140
8977,KLBN3,2015-12-31,2016-02-03,1849160105,2883468985,4732629090
8978,KLBN3,2016-03-31,2016-09-06,1849269750,2883907565,4733177315
8979,KLBN3,2016-06-30,2016-09-06,1849270515,2883910625,4733181140
8980,KLBN3,2016-09-30,2016-11-09,1849270515,2883910625,4733181140
8981,KLBN3,2016-12-31,2017-02-09,1849270515,2883910625,4733181140
8982,KLBN3,2017-03-31,2017-05-15,1849270515,2883910625,4733181140
8983,KLBN3,2017-06-30,2017-08-09,1849270515,2883910625,4733181140
8984,KLBN3,2017-09-30,2017-12-19,1849270515,2883910625,4733181140
8985,KLBN3,2017-12-31,2018-02-01,1859852065,2926236825,4786088890
8986,KLBN3,2018-03-31,2018-04-26,1984594655,3425207181,5409801836
8987,KLBN3,2018-06-30,2018-10-18,1984594655,3425207181,5409801836
8988,KLBN3,2018-09-30,2018-10-29,1984594655,3425207185,5409801840
8989,KLBN3,2018-12-31,2019-02-07,1984594655,3425207185,5409801840
8990,KLBN3,2019-03-31,2019-05-21,1984594655,3425207185,5409801840
8991,KLBN3,2019-06-30,2019-08-05,1984594655,3425207185,5409801840
8992,KLBN3,2019-09-30,2019-10-28,1984594655,3425207185,5409801840
8993,KLBN3,2019-12-31,2020-02-06,1984594655,3425207185,5409801840
8994,KLBN3,2020-03-31,2020-05-11,1984594655,3425207185,5409801840
8995,KLBN3,2020-06-30,2020-10-28,2012333899,3536164161,5548498060
8996,KLBN3,2020-09-30,2020-10-28,2012333899,3536164161,5548498060
8997,KLBN3,2020-12-31,2021-02-10,2081728595,3536164161,5617892756
8998,KLBN4,2010-12-31,2011-02-24,316827563,600855733,917683296
8999,KLBN4,2011-03-31,2011-04-28,316827563,600855733,917683296
9000,KLBN4,2011-06-30,2011-08-01,316827563,600855733,917683296
9001,KLBN4,2011-09-30,2011-10-31,316827563,600855733,917683296
9002,KLBN4,2011-12-31,2012-03-01,316827563,600855733,917683296
9003,KLBN4,2012-03-31,2012-04-26,316827563,600855733,917683296
9004,KLBN4,2012-06-30,2012-07-26,316827563,600855733,917683296
9005,KLBN4,2012-09-30,2012-10-25,316827563,600855733,917683296
9006,KLBN4,2012-12-31,2013-02-22,316827563,600855733,917683296
9007,KLBN4,2013-03-31,2013-04-25,316827563,600855733,917683296
9008,KLBN4,2013-06-30,2013-07-25,316827563,600855733,917683296
9009,KLBN4,2013-09-30,2013-10-28,316827563,600855733,917683296
9010,KLBN4,2013-12-31,2014-02-12,316827563,600855733,917683296
9011,KLBN4,2014-03-31,2014-04-24,1684897850,3044891685,4729789535
9012,KLBN4,2014-06-30,2014-07-30,1768769959,2961019576,4729789535
9013,KLBN4,2014-09-30,2014-10-28,1768769964,2961019601,4729789565
9014,KLBN4,2014-12-31,2015-02-11,1848592200,2881197365,4729789565
9015,KLBN4,2015-03-31,2015-04-27,1848592200,2881197365,4729789565
9016,KLBN4,2015-06-30,2015-07-27,1848592200,2881197365,4729789565
9017,KLBN4,2015-09-30,2015-10-26,1848740115,2881789025,4730529140
9018,KLBN4,2015-12-31,2016-02-03,1849160105,2883468985,4732629090
9019,KLBN4,2016-03-31,2016-09-06,1849269750,2883907565,4733177315
9020,KLBN4,2016-06-30,2016-09-06,1849270515,2883910625,4733181140
9021,KLBN4,2016-09-30,2016-11-09,1849270515,2883910625,4733181140
9022,KLBN4,2016-12-31,2017-02-09,1849270515,2883910625,4733181140
9023,KLBN4,2017-03-31,2017-05-15,1849270515,2883910625,4733181140
9024,KLBN4,2017-06-30,2017-08-09,1849270515,2883910625,4733181140
9025,KLBN4,2017-09-30,2017-12-19,1849270515,2883910625,4733181140
9026,KLBN4,2017-12-31,2018-02-01,1859852065,2926236825,4786088890
9027,KLBN4,2018-03-31,2018-04-26,1984594655,3425207181,5409801836
9028,KLBN4,2018-06-30,2018-10-18,1984594655,3425207181,5409801836
9029,KLBN4,2018-09-30,2018-10-29,1984594655,3425207185,5409801840
9030,KLBN4,2018-12-31,2019-02-07,1984594655,3425207185,5409801840
9031,KLBN4,2019-03-31,2019-05-21,1984594655,3425207185,5409801840
9032,KLBN4,2019-06-30,2019-08-05,1984594655,3425207185,5409801840
9033,KLBN4,2019-09-30,2019-10-28,1984594655,3425207185,5409801840
9034,KLBN4,2019-12-31,2020-02-06,1984594655,3425207185,5409801840
9035,KLBN4,2020-03-31,2020-05-11,1984594655,3425207185,5409801840
9036,KLBN4,2020-06-30,2020-10-28,2012333899,3536164161,5548498060
9037,KLBN4,2020-09-30,2020-10-28,2012333899,3536164161,5548498060
9038,KLBN4,2020-12-31,2021-02-10,2081728595,3536164161,5617892756
9039,SNSY3,2010-12-31,2011-03-30,6645,12646,19291
9040,SNSY3,2011-03-31,2011-05-11,6645,12646,19291
9041,SNSY3,2011-06-30,2011-08-09,6645,12646,19291
9042,SNSY3,2011-09-30,2011-11-04,6645,12646,19291
9043,SNSY3,2011-12-31,2012-03-27,6645,12646,19291
9044,SNSY3,2012-03-31,2012-05-09,6645,12646,19291
9045,SNSY3,2012-06-30,2012-08-10,6645,12646,19291
9046,SNSY3,2012-09-30,2012-11-09,6645,12646,19291
9047,SNSY3,2012-12-31,2013-03-28,6645,12646,19291
9048,SNSY3,2013-03-31,2013-05-13,6645,12646,19291
9049,SNSY3,2013-06-30,2013-08-07,6645,12646,19291
9050,SNSY3,2013-09-30,2013-11-11,6645,12646,19291
9051,SNSY3,2013-12-31,2014-03-28,6645,12646,19291
9052,SNSY3,2014-03-31,2014-05-14,6645,12646,19291
9053,SNSY3,2014-06-30,2014-08-05,6645,12646,19291
9054,SNSY3,2014-09-30,2014-11-04,6645,12646,19291
9055,SNSY3,2014-12-31,2015-03-27,6645,12646,19291
9056,SNSY3,2015-03-31,2015-05-12,6645,12646,19291
9057,SNSY3,2015-06-30,2015-08-13,6645,12646,19291
9058,SNSY3,2015-09-30,2015-11-10,6645,12646,19291
9059,SNSY3,2015-12-31,2016-02-26,6645,12646,19291
9060,SNSY3,2016-03-31,2016-05-11,66448,126462,192910
9061,SNSY3,2016-06-30,2016-08-10,66448,126462,192910
9062,SNSY3,2016-09-30,2016-11-09,66448,126462,192910
9063,SNSY3,2016-12-31,2017-02-24,66448,126462,192910
9064,SNSY3,2017-03-31,2017-05-10,66448,126462,192910
9065,SNSY3,2017-06-30,2017-08-10,66448,126462,192910
9066,SNSY3,2017-09-30,2017-11-10,66448,126462,192910
9067,SNSY3,2017-12-31,2018-02-23,66448,126462,192910
9068,SNSY3,2018-03-31,2018-05-14,66448,126462,192910
9069,SNSY3,2018-06-30,2018-08-13,66448,126462,192910
9070,SNSY3,2018-09-30,2018-11-09,66448,126462,192910
9071,SNSY3,2018-12-31,2019-04-16,66448,126462,192910
9072,SNSY3,2019-03-31,2019-05-09,66448,126462,192910
9073,SNSY3,2019-06-30,2019-08-13,66448,126462,192910
9074,SNSY3,2019-09-30,2019-11-13,66448,126462,192910
9075,SNSY3,2019-12-31,2020-03-27,66448,126462,192910
9076,SNSY3,2020-03-31,2020-06-25,66448,126462,192910
9077,SNSY3,2020-06-30,2020-08-14,66448,126462,192910
9078,SNSY3,2020-09-30,2020-11-12,2657920,5058480,7716400
9079,SNSY3,2020-12-31,2021-03-26,2657920,5058480,7716400
9080,SNSY5,2010-12-31,2011-03-30,6645,12646,19291
9081,SNSY5,2011-03-31,2011-05-11,6645,12646,19291
9082,SNSY5,2011-06-30,2011-08-09,6645,12646,19291
9083,SNSY5,2011-09-30,2011-11-04,6645,12646,19291
9084,SNSY5,2011-12-31,2012-03-27,6645,12646,19291
9085,SNSY5,2012-03-31,2012-05-09,6645,12646,19291
9086,SNSY5,2012-06-30,2012-08-10,6645,12646,19291
9087,SNSY5,2012-09-30,2012-11-09,6645,12646,19291
9088,SNSY5,2012-12-31,2013-03-28,6645,12646,19291
9089,SNSY5,2013-03-31,2013-05-13,6645,12646,19291
9090,SNSY5,2013-06-30,2013-08-07,6645,12646,19291
9091,SNSY5,2013-09-30,2013-11-11,6645,12646,19291
9092,SNSY5,2013-12-31,2014-03-28,6645,12646,19291
9093,SNSY5,2014-03-31,2014-05-14,6645,12646,19291
9094,SNSY5,2014-06-30,2014-08-05,6645,12646,19291
9095,SNSY5,2014-09-30,2014-11-04,6645,12646,19291
9096,SNSY5,2014-12-31,2015-03-27,6645,12646,19291
9097,SNSY5,2015-03-31,2015-05-12,6645,12646,19291
9098,SNSY5,2015-06-30,2015-08-13,6645,12646,19291
9099,SNSY5,2015-09-30,2015-11-10,6645,12646,19291
9100,SNSY5,2015-12-31,2016-02-26,6645,12646,19291
9101,SNSY5,2016-03-31,2016-05-11,66448,126462,192910
9102,SNSY5,2016-06-30,2016-08-10,66448,126462,192910
9103,SNSY5,2016-09-30,2016-11-09,66448,126462,192910
9104,SNSY5,2016-12-31,2017-02-24,66448,126462,192910
9105,SNSY5,2017-03-31,2017-05-10,66448,126462,192910
9106,SNSY5,2017-06-30,2017-08-10,66448,126462,192910
9107,SNSY5,2017-09-30,2017-11-10,66448,126462,192910
9108,SNSY5,2017-12-31,2018-02-23,66448,126462,192910
9109,SNSY5,2018-03-31,2018-05-14,66448,126462,192910
9110,SNSY5,2018-06-30,2018-08-13,66448,126462,192910
9111,SNSY5,2018-09-30,2018-11-09,66448,126462,192910
9112,SNSY5,2018-12-31,2019-04-16,66448,126462,192910
9113,SNSY5,2019-03-31,2019-05-09,66448,126462,192910
9114,SNSY5,2019-06-30,2019-08-13,66448,126462,192910
9115,SNSY5,2019-09-30,2019-11-13,66448,126462,192910
9116,SNSY5,2019-12-31,2020-03-27,66448,126462,192910
9117,SNSY5,2020-03-31,2020-06-25,66448,126462,192910
9118,SNSY5,2020-06-30,2020-08-14,66448,126462,192910
9119,SNSY5,2020-09-30,2020-11-12,2657920,5058480,7716400
9120,SNSY5,2020-12-31,2021-03-26,2657920,5058480,7716400
9121,SNSY6,2010-12-31,2011-03-30,6645,12646,19291
9122,SNSY6,2011-03-31,2011-05-11,6645,12646,19291
9123,SNSY6,2011-06-30,2011-08-09,6645,12646,19291
9124,SNSY6,2011-09-30,2011-11-04,6645,12646,19291
9125,SNSY6,2011-12-31,2012-03-27,6645,12646,19291
9126,SNSY6,2012-03-31,2012-05-09,6645,12646,19291
9127,SNSY6,2012-06-30,2012-08-10,6645,12646,19291
9128,SNSY6,2012-09-30,2012-11-09,6645,12646,19291
9129,SNSY6,2012-12-31,2013-03-28,6645,12646,19291
9130,SNSY6,2013-03-31,2013-05-13,6645,12646,19291
9131,SNSY6,2013-06-30,2013-08-07,6645,12646,19291
9132,SNSY6,2013-09-30,2013-11-11,6645,12646,19291
9133,SNSY6,2013-12-31,2014-03-28,6645,12646,19291
9134,SNSY6,2014-03-31,2014-05-14,6645,12646,19291
9135,SNSY6,2014-06-30,2014-08-05,6645,12646,19291
9136,SNSY6,2014-09-30,2014-11-04,6645,12646,19291
9137,SNSY6,2014-12-31,2015-03-27,6645,12646,19291
9138,SNSY6,2015-03-31,2015-05-12,6645,12646,19291
9139,SNSY6,2015-06-30,2015-08-13,6645,12646,19291
9140,SNSY6,2015-09-30,2015-11-10,6645,12646,19291
9141,SNSY6,2015-12-31,2016-02-26,6645,12646,19291
9142,SNSY6,2016-03-31,2016-05-11,66448,126462,192910
9143,SNSY6,2016-06-30,2016-08-10,66448,126462,192910
9144,SNSY6,2016-09-30,2016-11-09,66448,126462,192910
9145,SNSY6,2016-12-31,2017-02-24,66448,126462,192910
9146,SNSY6,2017-03-31,2017-05-10,66448,126462,192910
9147,SNSY6,2017-06-30,2017-08-10,66448,126462,192910
9148,SNSY6,2017-09-30,2017-11-10,66448,126462,192910
9149,SNSY6,2017-12-31,2018-02-23,66448,126462,192910
9150,SNSY6,2018-03-31,2018-05-14,66448,126462,192910
9151,SNSY6,2018-06-30,2018-08-13,66448,126462,192910
9152,SNSY6,2018-09-30,2018-11-09,66448,126462,192910
9153,SNSY6,2018-12-31,2019-04-16,66448,126462,192910
9154,SNSY6,2019-03-31,2019-05-09,66448,126462,192910
9155,SNSY6,2019-06-30,2019-08-13,66448,126462,192910
9156,SNSY6,2019-09-30,2019-11-13,66448,126462,192910
9157,SNSY6,2019-12-31,2020-03-27,66448,126462,192910
9158,SNSY6,2020-03-31,2020-06-25,66448,126462,192910
9159,SNSY6,2020-06-30,2020-08-14,66448,126462,192910
9160,SNSY6,2020-09-30,2020-11-12,2657920,5058480,7716400
9161,SNSY6,2020-12-31,2021-03-26,2657920,5058480,7716400
9162,APTI3,2010-12-31,2011-05-23,62500,123455,185955
9163,APTI3,2011-03-31,2011-05-13,62500,123455,185955
9164,APTI3,2011-06-30,2011-08-12,62500,123455,185955
9165,APTI3,2011-09-30,2011-11-11,62500,123455,185955
9166,APTI3,2011-12-31,2012-03-23,62500,123455,185955
9167,APTI3,2012-03-31,2012-05-15,62500,123455,185955
9168,APTI3,2012-06-30,2012-08-14,62500,123455,185955
9169,APTI3,2012-09-30,2012-11-13,62500,123455,185955
9170,APTI3,2012-12-31,2013-03-26,62500,123455,185955
9171,APTI3,2013-03-31,2013-05-14,62500,123455,185955
9172,APTI3,2013-06-30,2013-08-15,62500,123455,185955
9173,APTI3,2013-09-30,2013-11-27,62500,123455,185955
9174,APTI3,2013-12-31,2014-04-09,62500,123455,185955
9175,APTI3,2014-03-31,2014-05-15,62500,123455,185955
9176,APTI3,2014-06-30,2014-08-14,62500,123455,185955
9177,APTI3,2014-09-30,2014-11-14,62500,123455,185955
9178,APTI3,2014-12-31,2015-03-25,62500,123455,185955
9179,APTI3,2015-03-31,2015-05-13,62500,123455,185955
9180,APTI3,2015-06-30,2015-08-14,62500,123455,185955
9181,APTI3,2015-09-30,2015-11-12,62500,123455,185955
9182,APTI3,2015-12-31,2016-03-30,62500,123455,185955
9183,APTI3,2016-03-31,2016-05-12,62500,123455,185955
9184,APTI3,2016-06-30,2016-08-10,6250,12345,18595
9185,APTI3,2016-09-30,2016-11-10,6250,12345,18595
9186,APTI3,2016-12-31,2017-03-29,6250,12345,18595
9187,APTI3,2017-03-31,2017-05-11,6250,12345,18595
9188,APTI3,2017-06-30,2017-08-14,6250,12345,18595
9189,APTI3,2017-09-30,2017-11-13,6250,12345,18595
9190,APTI3,2017-12-31,2018-03-23,6250,12345,18595
9191,APTI3,2018-03-31,2018-05-11,6250,12345,18595
9192,APTI3,2018-06-30,2018-08-13,6250,12345,18595
9193,APTI3,2018-09-30,2018-11-08,6250,12345,18595
9194,APTI3,2018-12-31,2019-03-29,6250,12345,18595
9195,APTI3,2019-03-31,2019-05-10,6250,12345,18595
9196,APTI3,2019-06-30,2019-08-14,6250,12345,18595
9197,APTI3,2019-09-30,2019-11-14,6250,12345,18595
9198,APTI3,2019-12-31,2020-03-31,6250,12345,18595
9199,APTI3,2020-03-31,2020-06-29,6250,12345,18595
9200,APTI3,2020-06-30,2020-08-31,6250,12345,18595
9201,APTI3,2020-09-30,2020-11-13,6250,12345,18595
9202,APTI4,2010-12-31,2011-05-23,62500,123455,185955
9203,APTI4,2011-03-31,2011-05-13,62500,123455,185955
9204,APTI4,2011-06-30,2011-08-12,62500,123455,185955
9205,APTI4,2011-09-30,2011-11-11,62500,123455,185955
9206,APTI4,2011-12-31,2012-03-23,62500,123455,185955
9207,APTI4,2012-03-31,2012-05-15,62500,123455,185955
9208,APTI4,2012-06-30,2012-08-14,62500,123455,185955
9209,APTI4,2012-09-30,2012-11-13,62500,123455,185955
9210,APTI4,2012-12-31,2013-03-26,62500,123455,185955
9211,APTI4,2013-03-31,2013-05-14,62500,123455,185955
9212,APTI4,2013-06-30,2013-08-15,62500,123455,185955
9213,APTI4,2013-09-30,2013-11-27,62500,123455,185955
9214,APTI4,2013-12-31,2014-04-09,62500,123455,185955
9215,APTI4,2014-03-31,2014-05-15,62500,123455,185955
9216,APTI4,2014-06-30,2014-08-14,62500,123455,185955
9217,APTI4,2014-09-30,2014-11-14,62500,123455,185955
9218,APTI4,2014-12-31,2015-03-25,62500,123455,185955
9219,APTI4,2015-03-31,2015-05-13,62500,123455,185955
9220,APTI4,2015-06-30,2015-08-14,62500,123455,185955
9221,APTI4,2015-09-30,2015-11-12,62500,123455,185955
9222,APTI4,2015-12-31,2016-03-30,62500,123455,185955
9223,APTI4,2016-03-31,2016-05-12,62500,123455,185955
9224,APTI4,2016-06-30,2016-08-10,6250,12345,18595
9225,APTI4,2016-09-30,2016-11-10,6250,12345,18595
9226,APTI4,2016-12-31,2017-03-29,6250,12345,18595
9227,APTI4,2017-03-31,2017-05-11,6250,12345,18595
9228,APTI4,2017-06-30,2017-08-14,6250,12345,18595
9229,APTI4,2017-09-30,2017-11-13,6250,12345,18595
9230,APTI4,2017-12-31,2018-03-23,6250,12345,18595
9231,APTI4,2018-03-31,2018-05-11,6250,12345,18595
9232,APTI4,2018-06-30,2018-08-13,6250,12345,18595
9233,APTI4,2018-09-30,2018-11-08,6250,12345,18595
9234,APTI4,2018-12-31,2019-03-29,6250,12345,18595
9235,APTI4,2019-03-31,2019-05-10,6250,12345,18595
9236,APTI4,2019-06-30,2019-08-14,6250,12345,18595
9237,APTI4,2019-09-30,2019-11-14,6250,12345,18595
9238,APTI4,2019-12-31,2020-03-31,6250,12345,18595
9239,APTI4,2020-03-31,2020-06-29,6250,12345,18595
9240,APTI4,2020-06-30,2020-08-31,6250,12345,18595
9241,APTI4,2020-09-30,2020-11-13,6250,12345,18595
9242,JOPA3,2010-12-31,2011-04-30,10451,131,10582
9243,JOPA3,2011-03-31,2011-06-15,10451,131,10582
9244,JOPA3,2011-06-30,2011-08-15,10451,131,10582
9245,JOPA3,2011-09-30,2011-11-14,10451,131,10582
9246,JOPA3,2011-12-31,2012-04-13,10451,131,10582
9247,JOPA3,2012-03-31,2012-05-15,10451,131,10582
9248,JOPA3,2012-06-30,2012-08-15,10451,131,10582
9249,JOPA3,2012-09-30,2012-11-14,10451,131,10582
9250,JOPA3,2012-12-31,2013-03-26,10451,131,10582
9251,JOPA3,2013-03-31,2013-05-15,10451,131,10582
9252,JOPA3,2013-06-30,2013-08-14,10451,131,10582
9253,JOPA3,2013-09-30,2013-11-14,10451,131,10582
9254,JOPA3,2013-12-31,2014-03-21,10451,131,10582
9255,JOPA3,2014-03-31,2014-05-15,10451,131,10582
9256,JOPA3,2014-06-30,2014-08-14,10451,131,10582
9257,JOPA3,2014-09-30,2014-11-14,10451,131,10582
9258,JOPA3,2014-12-31,2015-03-24,10451,131,10582
9259,JOPA3,2015-03-31,2015-05-15,10451,131,10582
9260,JOPA3,2015-06-30,2015-08-13,10451,131,10582
9261,JOPA3,2015-09-30,2015-11-06,10451,131,10582
9262,JOPA3,2015-12-31,2016-03-24,10451,131,10582
9263,JOPA3,2016-03-31,2016-05-13,10451,131,10582
9264,JOPA3,2016-06-30,2016-08-11,10451,131,10582
9265,JOPA3,2016-09-30,2016-11-14,10451,131,10582
9266,JOPA3,2016-12-31,2017-03-28,10451,131,10582
9267,JOPA3,2017-03-31,2017-05-15,10451,131,10582
9268,JOPA3,2017-06-30,2017-08-14,10451,131,10582
9269,JOPA3,2017-09-30,2017-11-10,10451,131,10582
9270,JOPA3,2017-12-31,2018-03-29,10451,131,10582
9271,JOPA3,2018-03-31,2018-05-11,10451,131,10582
9272,JOPA3,2018-06-30,2018-08-14,10451,131,10582
9273,JOPA3,2018-09-30,2018-11-14,10451,131,10582
9274,JOPA3,2018-12-31,2019-03-22,10451,131,10582
9275,JOPA3,2019-03-31,2019-05-15,10451,131,10582
9276,JOPA3,2019-06-30,2019-08-14,10451,131,10582
9277,JOPA3,2019-09-30,2019-11-14,10451,131,10582
9278,JOPA3,2019-12-31,2020-03-20,10451,131,10582
9279,JOPA3,2020-03-31,2020-05-13,10451,131,10582
9280,JOPA3,2020-06-30,2020-08-10,10451,131,10582
9281,JOPA3,2020-09-30,2020-11-11,10451,131,10582
9282,JOPA3,2020-12-31,2021-03-23,10451,131,10582
9283,JOPA4,2010-12-31,2011-04-30,10451,131,10582
9284,JOPA4,2011-03-31,2011-06-15,10451,131,10582
9285,JOPA4,2011-06-30,2011-08-15,10451,131,10582
9286,JOPA4,2011-09-30,2011-11-14,10451,131,10582
9287,JOPA4,2011-12-31,2012-04-13,10451,131,10582
9288,JOPA4,2012-03-31,2012-05-15,10451,131,10582
9289,JOPA4,2012-06-30,2012-08-15,10451,131,10582
9290,JOPA4,2012-09-30,2012-11-14,10451,131,10582
9291,JOPA4,2012-12-31,2013-03-26,10451,131,10582
9292,JOPA4,2013-03-31,2013-05-15,10451,131,10582
9293,JOPA4,2013-06-30,2013-08-14,10451,131,10582
9294,JOPA4,2013-09-30,2013-11-14,10451,131,10582
9295,JOPA4,2013-12-31,2014-03-21,10451,131,10582
9296,JOPA4,2014-03-31,2014-05-15,10451,131,10582
9297,JOPA4,2014-06-30,2014-08-14,10451,131,10582
9298,JOPA4,2014-09-30,2014-11-14,10451,131,10582
9299,JOPA4,2014-12-31,2015-03-24,10451,131,10582
9300,JOPA4,2015-03-31,2015-05-15,10451,131,10582
9301,JOPA4,2015-06-30,2015-08-13,10451,131,10582
9302,JOPA4,2015-09-30,2015-11-06,10451,131,10582
9303,JOPA4,2015-12-31,2016-03-24,10451,131,10582
9304,JOPA4,2016-03-31,2016-05-13,10451,131,10582
9305,JOPA4,2016-06-30,2016-08-11,10451,131,10582
9306,JOPA4,2016-09-30,2016-11-14,10451,131,10582
9307,JOPA4,2016-12-31,2017-03-28,10451,131,10582
9308,JOPA4,2017-03-31,2017-05-15,10451,131,10582
9309,JOPA4,2017-06-30,2017-08-14,10451,131,10582
9310,JOPA4,2017-09-30,2017-11-10,10451,131,10582
9311,JOPA4,2017-12-31,2018-03-29,10451,131,10582
9312,JOPA4,2018-03-31,2018-05-11,10451,131,10582
9313,JOPA4,2018-06-30,2018-08-14,10451,131,10582
9314,JOPA4,2018-09-30,2018-11-14,10451,131,10582
9315,JOPA4,2018-12-31,2019-03-22,10451,131,10582
9316,JOPA4,2019-03-31,2019-05-15,10451,131,10582
9317,JOPA4,2019-06-30,2019-08-14,10451,131,10582
9318,JOPA4,2019-09-30,2019-11-14,10451,131,10582
9319,JOPA4,2019-12-31,2020-03-20,10451,131,10582
9320,JOPA4,2020-03-31,2020-05-13,10451,131,10582
9321,JOPA4,2020-06-30,2020-08-10,10451,131,10582
9322,JOPA4,2020-09-30,2020-11-11,10451,131,10582
9323,JOPA4,2020-12-31,2021-03-23,10451,131,10582
9324,HAGA3,2010-12-31,2011-03-25,3966667,7933333,11900000
9325,HAGA3,2011-03-31,2011-05-09,3966667,7933333,11900000
9326,HAGA3,2011-06-30,2011-08-11,3966667,7933333,11900000
9327,HAGA3,2011-09-30,2011-11-10,3966667,7933333,11900000
9328,HAGA3,2011-12-31,2012-03-15,3966667,7933333,11900000
9329,HAGA3,2012-03-31,2012-05-15,3966667,7933333,11900000
9330,HAGA3,2012-06-30,2012-08-13,3966667,7933333,11900000
9331,HAGA3,2012-09-30,2012-11-13,3966667,7933333,11900000
9332,HAGA3,2012-12-31,2013-03-26,3966667,7933333,11900000
9333,HAGA3,2013-03-31,2013-05-14,3966667,7933333,11900000
9334,HAGA3,2013-06-30,2013-08-13,3966667,7933333,11900000
9335,HAGA3,2013-09-30,2013-11-14,3966667,7933333,11900000
9336,HAGA3,2013-12-31,2014-03-18,3966667,7933333,11900000
9337,HAGA3,2014-03-31,2014-05-13,3966667,7933333,11900000
9338,HAGA3,2014-06-30,2014-08-13,3966667,7933333,11900000
9339,HAGA3,2014-09-30,2014-11-13,3966667,7933333,11900000
9340,HAGA3,2014-12-31,2015-03-24,3966667,7933333,11900000
9341,HAGA3,2015-03-31,2015-05-14,3966667,7933333,11900000
9342,HAGA3,2015-06-30,2015-08-14,3966667,7933333,11900000
9343,HAGA3,2015-09-30,2015-11-12,3966667,7933333,11900000
9344,HAGA3,2015-12-31,2016-03-28,3966667,7933333,11900000
9345,HAGA3,2016-03-31,2016-05-12,3966667,7933333,11900000
9346,HAGA3,2016-06-30,2016-08-12,3966667,7933333,11900000
9347,HAGA3,2016-09-30,2016-11-11,3966667,7933333,11900000
9348,HAGA3,2016-12-31,2017-03-22,3966667,7933333,11900000
9349,HAGA3,2017-03-31,2017-05-11,3966667,7933333,11900000
9350,HAGA3,2017-06-30,2017-08-14,3966667,7933333,11900000
9351,HAGA3,2017-09-30,2017-11-13,3966667,7933333,11900000
9352,HAGA3,2017-12-31,2018-03-19,3966667,7933333,11900000
9353,HAGA3,2018-03-31,2018-05-10,3966667,7933333,11900000
9354,HAGA3,2018-06-30,2018-08-10,3966667,7933333,11900000
9355,HAGA3,2018-09-30,2018-11-13,3966667,7933333,11900000
9356,HAGA3,2018-12-31,2019-03-22,3966667,7933333,11900000
9357,HAGA3,2019-03-31,2019-05-13,3966667,7933333,11900000
9358,HAGA3,2019-06-30,2019-08-13,3966667,7933333,11900000
9359,HAGA3,2019-09-30,2019-11-11,3966667,7933333,11900000
9360,HAGA3,2019-12-31,2020-03-20,3966667,7933333,11900000
9361,HAGA3,2020-03-31,2020-05-26,3966667,7933333,11900000
9362,HAGA3,2020-06-30,2020-08-20,3966667,7933333,11900000
9363,HAGA3,2020-09-30,2020-11-13,3966667,7933333,11900000
9364,HAGA3,2020-12-31,2021-03-22,3966667,7933333,11900000
9365,HAGA4,2010-12-31,2011-03-25,3966667,7933333,11900000
9366,HAGA4,2011-03-31,2011-05-09,3966667,7933333,11900000
9367,HAGA4,2011-06-30,2011-08-11,3966667,7933333,11900000
9368,HAGA4,2011-09-30,2011-11-10,3966667,7933333,11900000
9369,HAGA4,2011-12-31,2012-03-15,3966667,7933333,11900000
9370,HAGA4,2012-03-31,2012-05-15,3966667,7933333,11900000
9371,HAGA4,2012-06-30,2012-08-13,3966667,7933333,11900000
9372,HAGA4,2012-09-30,2012-11-13,3966667,7933333,11900000
9373,HAGA4,2012-12-31,2013-03-26,3966667,7933333,11900000
9374,HAGA4,2013-03-31,2013-05-14,3966667,7933333,11900000
9375,HAGA4,2013-06-30,2013-08-13,3966667,7933333,11900000
9376,HAGA4,2013-09-30,2013-11-14,3966667,7933333,11900000
9377,HAGA4,2013-12-31,2014-03-18,3966667,7933333,11900000
9378,HAGA4,2014-03-31,2014-05-13,3966667,7933333,11900000
9379,HAGA4,2014-06-30,2014-08-13,3966667,7933333,11900000
9380,HAGA4,2014-09-30,2014-11-13,3966667,7933333,11900000
9381,HAGA4,2014-12-31,2015-03-24,3966667,7933333,11900000
9382,HAGA4,2015-03-31,2015-05-14,3966667,7933333,11900000
9383,HAGA4,2015-06-30,2015-08-14,3966667,7933333,11900000
9384,HAGA4,2015-09-30,2015-11-12,3966667,7933333,11900000
9385,HAGA4,2015-12-31,2016-03-28,3966667,7933333,11900000
9386,HAGA4,2016-03-31,2016-05-12,3966667,7933333,11900000
9387,HAGA4,2016-06-30,2016-08-12,3966667,7933333,11900000
9388,HAGA4,2016-09-30,2016-11-11,3966667,7933333,11900000
9389,HAGA4,2016-12-31,2017-03-22,3966667,7933333,11900000
9390,HAGA4,2017-03-31,2017-05-11,3966667,7933333,11900000
9391,HAGA4,2017-06-30,2017-08-14,3966667,7933333,11900000
9392,HAGA4,2017-09-30,2017-11-13,3966667,7933333,11900000
9393,HAGA4,2017-12-31,2018-03-19,3966667,7933333,11900000
9394,HAGA4,2018-03-31,2018-05-10,3966667,7933333,11900000
9395,HAGA4,2018-06-30,2018-08-10,3966667,7933333,11900000
9396,HAGA4,2018-09-30,2018-11-13,3966667,7933333,11900000
9397,HAGA4,2018-12-31,2019-03-22,3966667,7933333,11900000
9398,HAGA4,2019-03-31,2019-05-13,3966667,7933333,11900000
9399,HAGA4,2019-06-30,2019-08-13,3966667,7933333,11900000
9400,HAGA4,2019-09-30,2019-11-11,3966667,7933333,11900000
9401,HAGA4,2019-12-31,2020-03-20,3966667,7933333,11900000
9402,HAGA4,2020-03-31,2020-05-26,3966667,7933333,11900000
9403,HAGA4,2020-06-30,2020-08-20,3966667,7933333,11900000
9404,HAGA4,2020-09-30,2020-11-13,3966667,7933333,11900000
9405,HAGA4,2020-12-31,2021-03-22,3966667,7933333,11900000
9406,RSUL3,2010-12-31,2011-03-31,343000,240000,583000
9407,RSUL3,2011-03-31,2011-05-13,343000,240000,583000
9408,RSUL3,2011-06-30,2011-08-15,343000,240000,583000
9409,RSUL3,2011-09-30,2011-11-11,343000,240000,583000
9410,RSUL3,2011-12-31,2012-04-27,343000,240000,583000
9411,RSUL3,2012-03-31,2012-05-21,343000,240000,583000
9412,RSUL3,2012-06-30,2012-08-13,343000,240000,583000
9413,RSUL3,2012-09-30,2012-11-14,343000,240000,583000
9414,RSUL3,2012-12-31,2013-04-19,343000,240000,583000
9415,RSUL3,2013-03-31,2013-05-15,343000,240000,583000
9416,RSUL3,2013-06-30,2013-08-15,343000,240000,583000
9417,RSUL3,2013-09-30,2013-11-25,343000,240000,583000
9418,RSUL3,2013-12-31,2014-03-31,343000,240000,583000
9419,RSUL3,2014-03-31,2014-05-15,343000,240000,583000
9420,RSUL3,2014-06-30,2014-08-13,343000,240000,583000
9421,RSUL3,2014-09-30,2014-11-14,343000,240000,583000
9422,RSUL3,2014-12-31,2015-04-17,343000,240000,583000
9423,RSUL3,2015-03-31,2015-05-19,343000,240000,583000
9424,RSUL3,2015-06-30,2015-08-13,343000,240000,583000
9425,RSUL3,2015-09-30,2015-11-13,343000,240000,583000
9426,RSUL3,2015-12-31,2016-03-29,343000,240000,583000
9427,RSUL3,2016-03-31,2016-05-11,343000,240000,583000
9428,RSUL3,2016-06-30,2016-08-12,343000,240000,583000
9429,RSUL3,2016-09-30,2016-11-11,343000,240000,583000
9430,RSUL3,2016-12-31,2017-03-24,343000,240000,583000
9431,RSUL3,2017-03-31,2017-05-11,343000,240000,583000
9432,RSUL3,2017-06-30,2017-08-11,343000,240000,583000
9433,RSUL3,2017-09-30,2017-11-14,343000,240000,583000
9434,RSUL3,2017-12-31,2018-03-26,343000,240000,583000
9435,RSUL3,2018-03-31,2018-05-15,343000,240000,583000
9436,RSUL3,2018-06-30,2018-08-10,343000,240000,583000
9437,RSUL3,2018-09-30,2018-11-13,343000,240000,583000
9438,RSUL3,2018-12-31,2019-02-21,343000,240000,583000
9439,RSUL3,2019-03-31,2019-05-09,343000,240000,583000
9440,RSUL3,2019-06-30,2019-08-14,343000,240000,583000
9441,RSUL3,2019-09-30,2019-11-13,343000,240000,583000
9442,RSUL3,2019-12-31,2020-03-20,343000,240000,583000
9443,RSUL3,2020-03-31,2020-06-02,343000,240000,583000
9444,RSUL3,2020-06-30,2020-08-12,343000,240000,583000
9445,RSUL3,2020-09-30,2020-11-16,343000,240000,583000
9446,RSUL4,2010-12-31,2011-03-31,343000,240000,583000
9447,RSUL4,2011-03-31,2011-05-13,343000,240000,583000
9448,RSUL4,2011-06-30,2011-08-15,343000,240000,583000
9449,RSUL4,2011-09-30,2011-11-11,343000,240000,583000
9450,RSUL4,2011-12-31,2012-04-27,343000,240000,583000
9451,RSUL4,2012-03-31,2012-05-21,343000,240000,583000
9452,RSUL4,2012-06-30,2012-08-13,343000,240000,583000
9453,RSUL4,2012-09-30,2012-11-14,343000,240000,583000
9454,RSUL4,2012-12-31,2013-04-19,343000,240000,583000
9455,RSUL4,2013-03-31,2013-05-15,343000,240000,583000
9456,RSUL4,2013-06-30,2013-08-15,343000,240000,583000
9457,RSUL4,2013-09-30,2013-11-25,343000,240000,583000
9458,RSUL4,2013-12-31,2014-03-31,343000,240000,583000
9459,RSUL4,2014-03-31,2014-05-15,343000,240000,583000
9460,RSUL4,2014-06-30,2014-08-13,343000,240000,583000
9461,RSUL4,2014-09-30,2014-11-14,343000,240000,583000
9462,RSUL4,2014-12-31,2015-04-17,343000,240000,583000
9463,RSUL4,2015-03-31,2015-05-19,343000,240000,583000
9464,RSUL4,2015-06-30,2015-08-13,343000,240000,583000
9465,RSUL4,2015-09-30,2015-11-13,343000,240000,583000
9466,RSUL4,2015-12-31,2016-03-29,343000,240000,583000
9467,RSUL4,2016-03-31,2016-05-11,343000,240000,583000
9468,RSUL4,2016-06-30,2016-08-12,343000,240000,583000
9469,RSUL4,2016-09-30,2016-11-11,343000,240000,583000
9470,RSUL4,2016-12-31,2017-03-24,343000,240000,583000
9471,RSUL4,2017-03-31,2017-05-11,343000,240000,583000
9472,RSUL4,2017-06-30,2017-08-11,343000,240000,583000
9473,RSUL4,2017-09-30,2017-11-14,343000,240000,583000
9474,RSUL4,2017-12-31,2018-03-26,343000,240000,583000
9475,RSUL4,2018-03-31,2018-05-15,343000,240000,583000
9476,RSUL4,2018-06-30,2018-08-10,343000,240000,583000
9477,RSUL4,2018-09-30,2018-11-13,343000,240000,583000
9478,RSUL4,2018-12-31,2019-02-21,343000,240000,583000
9479,RSUL4,2019-03-31,2019-05-09,343000,240000,583000
9480,RSUL4,2019-06-30,2019-08-14,343000,240000,583000
9481,RSUL4,2019-09-30,2019-11-13,343000,240000,583000
9482,RSUL4,2019-12-31,2020-03-20,343000,240000,583000
9483,RSUL4,2020-03-31,2020-06-02,343000,240000,583000
9484,RSUL4,2020-06-30,2020-08-12,343000,240000,583000
9485,RSUL4,2020-09-30,2020-11-16,343000,240000,583000
9486,PPAR3,2010-12-31,2011-03-29,74,0,74
9487,PPAR3,2011-03-31,2011-05-12,74,0,74
9488,PPAR3,2011-06-30,2011-08-12,74,0,74
9489,PPAR3,2011-09-30,2011-11-10,74,0,74
9490,PPAR3,2011-12-31,2012-03-27,74,0,74
9491,PPAR3,2012-03-31,2012-05-15,74,0,74
9492,PPAR3,2012-06-30,2012-08-14,74,0,74
9493,PPAR3,2012-09-30,2012-11-14,74,0,74
9494,PPAR3,2012-12-31,2013-03-28,74,0,74
9495,PPAR3,2013-03-31,2013-05-14,74,0,74
9496,PPAR3,2013-06-30,2013-08-14,74,0,74
9497,PPAR3,2013-09-30,2013-11-11,74,0,74
9498,PPAR3,2013-12-31,2014-03-27,74,0,74
9499,PPAR3,2014-03-31,2014-05-15,74,0,74
9500,PPAR3,2014-06-30,2014-08-14,74,0,74
9501,PPAR3,2014-09-30,2014-11-13,74,0,74
9502,PPAR3,2014-12-31,2015-03-30,74,0,74
9503,PPAR3,2015-03-31,2015-05-12,74,0,74
9504,PPAR3,2015-06-30,2015-08-13,74,0,74
9505,PPAR3,2015-09-30,2015-11-12,74,0,74
9506,PPAR3,2015-12-31,2016-03-24,74,0,74
9507,PPAR3,2016-03-31,2016-05-12,74,0,74
9508,PPAR3,2016-06-30,2016-08-12,74,0,74
9509,PPAR3,2016-09-30,2016-11-10,74,0,74
9510,PPAR3,2016-12-31,2017-03-14,74,0,74
9511,PPAR3,2017-03-31,2017-05-12,74,0,74
9512,PPAR3,2017-06-30,2017-08-10,74,0,74
9513,PPAR3,2017-09-30,2017-11-10,74,0,74
9514,PPAR3,2017-12-31,2018-03-06,34,40,74
9515,PPAR3,2018-03-31,2018-05-14,34,40,74
9516,PPAR3,2018-06-30,2018-08-14,34,40,74
9517,PPAR3,2018-09-30,2018-11-14,34,40,74
9518,PPAR3,2018-12-31,2019-03-01,34,40,74
9519,PPAR3,2019-03-31,2019-05-15,34,40,74
9520,PPAR3,2019-06-30,2019-08-14,34,40,74
9521,PPAR3,2019-09-30,2019-11-14,34,40,74
9522,PPAR3,2019-12-31,2020-03-17,34,40,74
9523,PPAR3,2020-03-31,2020-05-26,34,40,74
9524,PPAR3,2020-06-30,2020-08-14,34,40,74
9525,PPAR3,2020-09-30,2020-11-10,34,40,74
9526,PPAR3,2020-12-31,2021-03-15,34,40,74
9527,PLAS3,2010-12-31,2011-03-04,166430,0,166430
9528,PLAS3,2011-03-31,2011-05-16,166430,0,166430
9529,PLAS3,2011-06-30,2011-07-29,166430,0,166430
9530,PLAS3,2011-09-30,2011-10-28,166430,0,166430
9531,PLAS3,2011-12-31,2012-03-06,166430,0,166430
9532,PLAS3,2012-03-31,2012-05-14,166430,0,166430
9533,PLAS3,2012-06-30,2012-08-07,239854,0,239854
9534,PLAS3,2012-09-30,2012-11-08,239854,0,239854
9535,PLAS3,2012-12-31,2013-03-08,239854,0,239854
9536,PLAS3,2013-03-31,2013-05-08,239854,0,239854
9537,PLAS3,2013-06-30,2013-08-13,242018,0,242018
9538,PLAS3,2013-09-30,2013-10-28,242018,0,242018
9539,PLAS3,2013-12-31,2014-03-31,242018,0,242018
9540,PLAS3,2014-03-31,2014-05-13,242018,0,242018
9541,PLAS3,2014-06-30,2014-07-18,248508,0,248508
9542,PLAS3,2014-09-30,2014-10-28,248508,0,248508
9543,PLAS3,2014-12-31,2015-02-06,248508,0,248508
9544,PLAS3,2015-03-31,2015-04-28,248508,0,248508
9545,PLAS3,2015-06-30,2015-07-29,248508,0,248508
9546,PLAS3,2015-09-30,2015-10-27,4970,0,4970
9547,PLAS3,2015-12-31,2016-03-29,4970,0,4970
9548,PLAS3,2016-03-31,2016-05-11,4970,0,4970
9549,PLAS3,2016-06-30,2016-08-01,4970,0,4970
9550,PLAS3,2016-09-30,2016-11-08,4970,0,4970
9551,PLAS3,2016-12-31,2017-03-09,4970,0,4970
9552,PLAS3,2017-03-31,2017-05-08,4970,0,4970
9553,PLAS3,2017-06-30,2017-08-08,4970,0,4970
9554,PLAS3,2017-09-30,2017-10-31,4970,0,4970
9555,PLAS3,2017-12-31,2018-02-07,4970,0,4970
9556,PLAS3,2018-03-31,2018-04-27,4970,0,4970
9557,PLAS3,2018-06-30,2018-08-13,4970,0,4970
9558,PLAS3,2018-09-30,2018-11-05,4970,0,4970
9559,PLAS3,2018-12-31,2019-03-28,4970,0,4970
9560,PLAS3,2019-03-31,2019-05-15,12425,0,12425
9561,PLAS3,2019-06-30,2019-08-08,12425,0,12425
9562,PLAS3,2019-09-30,2019-11-06,12425,0,12425
9563,PLAS3,2019-12-31,2020-03-04,12425,0,12425
9564,PLAS3,2020-03-31,2020-06-29,12425,0,12425
9565,PLAS3,2020-06-30,2020-08-13,12425,0,12425
9566,PLAS3,2020-09-30,2020-11-11,12425,0,12425
9567,PLAS3,2020-12-31,2021-03-04,12425,0,12425
9568,MNPR3,2010-12-31,2011-06-24,405720000,0,405720000
9569,MNPR3,2011-03-31,2011-10-17,405720000,0,405720000
9570,MNPR3,2011-06-30,2011-10-15,405720000,0,405720000
9571,MNPR3,2011-09-30,2011-11-11,507150000,0,507150000
9572,MNPR3,2011-12-31,2012-03-27,507150000,0,507150000
9573,MNPR3,2012-03-31,2012-05-15,507150000,0,507150000
9574,MNPR3,2012-06-30,2012-08-14,507150000,0,507150000
9575,MNPR3,2012-09-30,2012-11-14,573819104,0,573819104
9576,MNPR3,2012-12-31,2013-03-26,710010000,0,710010000
9577,MNPR3,2013-03-31,2013-05-15,710010000,0,710010000
9578,MNPR3,2013-06-30,2013-08-14,710010000,0,710010000
9579,MNPR3,2013-09-30,2013-11-12,710010000,0,710010000
9580,MNPR3,2013-12-31,2014-02-27,710010000,0,710010000
9581,MNPR3,2014-03-31,2014-05-14,710010,0,710010
9582,MNPR3,2014-06-30,2014-08-12,710010,0,710010
9583,MNPR3,2014-09-30,2014-11-12,710010,0,710010
9584,MNPR3,2014-12-31,2015-03-13,710010,0,710010
9585,MNPR3,2015-03-31,2015-05-14,710010,0,710010
9586,MNPR3,2015-06-30,2015-08-14,710010,0,710010
9587,MNPR3,2015-09-30,2015-11-13,710010,0,710010
9588,MNPR3,2015-12-31,2016-03-10,710010,0,710010
9589,MNPR3,2016-03-31,2016-05-13,710010,0,710010
9590,MNPR3,2016-06-30,2016-08-12,7100,0,7100
9591,MNPR3,2016-09-30,2016-11-14,7100,0,7100
9592,MNPR3,2016-12-31,2017-03-29,7100,0,7100
9593,MNPR3,2017-03-31,2017-05-16,7100,0,7100
9594,MNPR3,2017-06-30,2017-08-16,7100,0,7100
9595,MNPR3,2017-09-30,2017-11-14,7100,0,7100
9596,MNPR3,2017-12-31,2018-03-22,7100,0,7100
9597,MNPR3,2018-03-31,2018-05-16,7100,0,7100
9598,MNPR3,2018-06-30,2018-08-14,7100,0,7100
9599,MNPR3,2018-09-30,2018-11-14,7100,0,7100
9600,MNPR3,2018-12-31,2019-03-29,7100,0,7100
9601,MNPR3,2019-03-31,2019-05-15,7100,0,7100
9602,MNPR3,2019-06-30,2019-08-13,7100,0,7100
9603,MNPR3,2019-09-30,2019-11-14,7100,0,7100
9604,MNPR3,2019-12-31,2020-03-30,7100,0,7100
9605,MNPR3,2020-03-31,2020-06-29,7100,0,7100
9606,MNPR3,2020-06-30,2020-08-31,7100,0,7100
9607,MNPR3,2020-09-30,2020-11-16,7100,0,7100
9608,PTBL3,2010-12-31,2011-03-21,159009,0,159009
9609,PTBL3,2011-03-31,2011-05-13,159009,0,159009
9610,PTBL3,2011-06-30,2011-08-18,159008924,0,159008924
9611,PTBL3,2011-09-30,2011-11-10,159008924,0,159008924
9612,PTBL3,2011-12-31,2012-03-30,159009,0,159009
9613,PTBL3,2012-03-31,2012-05-15,159009,0,159009
9614,PTBL3,2012-06-30,2012-08-14,159009,0,159009
9615,PTBL3,2012-09-30,2012-11-13,159009,0,159009
9616,PTBL3,2012-12-31,2013-03-28,159009,0,159009
9617,PTBL3,2013-03-31,2013-05-15,159009,0,159009
9618,PTBL3,2013-06-30,2013-08-14,159009,0,159009
9619,PTBL3,2013-09-30,2013-11-13,159009,0,159009
9620,PTBL3,2013-12-31,2014-03-25,159009,0,159009
9621,PTBL3,2014-03-31,2014-05-15,159009,0,159009
9622,PTBL3,2014-06-30,2014-08-12,159009,0,159009
9623,PTBL3,2014-09-30,2014-11-20,158489,0,158489
9624,PTBL3,2014-12-31,2015-03-23,158488,0,158488
9625,PTBL3,2015-03-31,2015-05-20,158488,0,158488
9626,PTBL3,2015-06-30,2015-08-07,158489,0,158489
9627,PTBL3,2015-09-30,2015-11-06,158488,0,158488
9628,PTBL3,2015-12-31,2016-03-11,158488,0,158488
9629,PTBL3,2016-03-31,2016-05-13,158488,0,158488
9630,PTBL3,2016-06-30,2016-08-12,158488,0,158488
9631,PTBL3,2016-09-30,2016-11-04,158488,0,158488
9632,PTBL3,2016-12-31,2017-03-21,158489,0,158489
9633,PTBL3,2017-03-31,2017-05-05,158489,0,158489
9634,PTBL3,2017-06-30,2017-08-04,158488,0,158488
9635,PTBL3,2017-09-30,2017-11-10,158488,0,158488
9636,PTBL3,2017-12-31,2018-02-23,158489,0,158489
9637,PTBL3,2018-03-31,2018-05-15,158489,0,158489
9638,PTBL3,2018-06-30,2020-12-16,158489,0,158489
9639,PTBL3,2018-09-30,2018-11-01,158489,0,158489
9640,PTBL3,2018-12-31,2019-02-18,158489,0,158489
9641,PTBL3,2019-03-31,2019-05-10,158489,0,158489
9642,PTBL3,2019-06-30,2019-08-09,158489,0,158489
9643,PTBL3,2019-09-30,2019-11-14,158489,0,158489
9644,PTBL3,2019-12-31,2020-04-14,158489,0,158489
9645,PTBL3,2020-03-31,2020-05-28,158485,0,158485
9646,PTBL3,2020-06-30,2020-08-11,155649,0,155649
9647,PTBL3,2020-09-30,2020-11-23,158489,0,158489
9648,PTBL3,2020-12-31,2021-03-26,158488,0,158488
9649,SCAR3,2010-12-31,2011-03-26,57737,0,57737
9650,SCAR3,2011-03-31,2011-05-09,57419,0,57419
9651,SCAR3,2011-06-30,2011-08-11,57737,0,57737
9652,SCAR3,2011-09-30,2011-11-08,57737,0,57737
9653,SCAR3,2011-12-31,2012-03-19,57737,0,57737
9654,SCAR3,2012-03-31,2012-05-07,57737,0,57737
9655,SCAR3,2012-06-30,2012-08-06,57307,0,57307
9656,SCAR3,2012-09-30,2012-11-05,57737,0,57737
9657,SCAR3,2012-12-31,2013-03-18,57737,0,57737
9658,SCAR3,2013-03-31,2013-05-13,57737,0,57737
9659,SCAR3,2013-06-30,2013-08-06,57737,0,57737
9660,SCAR3,2013-09-30,2013-11-05,57737,0,57737
9661,SCAR3,2013-12-31,2014-03-13,57737,0,57737
9662,SCAR3,2014-03-31,2014-05-13,57737,0,57737
9663,SCAR3,2014-06-30,2014-08-14,57737,0,57737
9664,SCAR3,2014-09-30,2014-11-13,57737,0,57737
9665,SCAR3,2014-12-31,2015-03-05,57737,0,57737
9666,SCAR3,2015-03-31,2015-05-07,57737,0,57737
9667,SCAR3,2015-06-30,2015-08-06,57737,0,57737
9668,SCAR3,2015-09-30,2015-11-12,57737,0,57737
9669,SCAR3,2015-12-31,2016-03-09,57737,0,57737
9670,SCAR3,2016-03-31,2016-05-11,57737,0,57737
9671,SCAR3,2016-06-30,2016-08-09,57737,0,57737
9672,SCAR3,2016-09-30,2016-11-08,57737,0,57737
9673,SCAR3,2016-12-31,2017-03-08,57737,0,57737
9674,SCAR3,2017-03-31,2017-05-10,57737,0,57737
9675,SCAR3,2017-06-30,2017-08-14,57737,0,57737
9676,SCAR3,2017-09-30,2017-11-08,57737,0,57737
9677,SCAR3,2017-12-31,2018-03-08,57737,0,57737
9678,SCAR3,2018-03-31,2018-05-09,57737,0,57737
9679,SCAR3,2018-06-30,2018-08-08,57737,0,57737
9680,SCAR3,2018-09-30,2018-11-07,57737,0,57737
9681,SCAR3,2018-12-31,2019-03-11,57737,0,57737
9682,SCAR3,2019-03-31,2019-05-09,57737,0,57737
9683,SCAR3,2019-06-30,2019-08-12,57737,0,57737
9684,SCAR3,2019-09-30,2019-11-06,57737,0,57737
9685,SCAR3,2019-12-31,2020-03-05,57737,0,57737
9686,SCAR3,2020-03-31,2020-05-07,57737,0,57737
9687,SCAR3,2020-06-30,2020-08-13,57737,0,57737
9688,SCAR3,2020-09-30,2020-11-04,57737,0,57737
9689,SCAR3,2020-12-31,2021-03-04,57737,0,57737
9690,MAPT3,2010-12-31,2011-03-31,4544544,4644403,9188947
9691,MAPT3,2011-03-31,2011-05-12,4544544,4644403,9188947
9692,MAPT3,2011-06-30,2011-08-12,4544544,4644403,9188947
9693,MAPT3,2011-09-30,2011-11-11,4544544,4644403,9188947
9694,MAPT3,2011-12-31,2012-03-29,4544544,4644403,9188947
9695,MAPT3,2012-03-31,2012-05-14,4544544,4644403,9188947
9696,MAPT3,2012-06-30,2012-08-08,4544544,4644403,9188947
9697,MAPT3,2012-09-30,2012-11-13,4544544,4644403,9188947
9698,MAPT3,2012-12-31,2013-03-27,4544544,4644403,9188947
9699,MAPT3,2013-03-31,2013-05-07,4544544,4644403,9188947
9700,MAPT3,2013-06-30,2013-08-13,4544544,4644403,9188947
9701,MAPT3,2013-09-30,2013-11-12,4544544,4644403,9188947
9702,MAPT3,2013-12-31,2014-03-28,4544544,4644403,9188947
9703,MAPT3,2014-03-31,2014-05-13,4544544,4644403,9188947
9704,MAPT3,2014-06-30,2014-08-13,4544544,4644403,9188947
9705,MAPT3,2014-09-30,2014-11-12,4544544,4644403,9188947
9706,MAPT3,2014-12-31,2015-03-30,4544544,4644403,9188947
9707,MAPT3,2015-03-31,2015-05-14,4544544,4644403,9188947
9708,MAPT3,2015-06-30,2015-08-14,4544544,4644403,9188947
9709,MAPT3,2015-09-30,2015-11-12,4544544,4644403,9188947
9710,MAPT3,2015-12-31,2016-03-30,454455,464440,918895
9711,MAPT3,2016-03-31,2016-05-12,454455,464440,918895
9712,MAPT3,2016-06-30,2016-08-12,454455,464440,918895
9713,MAPT3,2016-09-30,2016-11-11,454455,464440,918895
9714,MAPT3,2016-12-31,2017-03-30,454455,464440,918895
9715,MAPT3,2017-03-31,2017-05-12,454455,464440,918895
9716,MAPT3,2017-06-30,2017-08-11,454455,464440,918895
9717,MAPT3,2017-09-30,2017-11-13,454455,464440,918895
9718,MAPT3,2017-12-31,2018-03-28,454455,464440,918895
9719,MAPT3,2018-03-31,2018-05-15,454455,464440,918895
9720,MAPT3,2018-06-30,2018-08-13,454455,464440,918895
9721,MAPT3,2018-09-30,2018-11-13,454455,464440,918895
9722,MAPT3,2018-12-31,2019-03-28,454455,464440,918895
9723,MAPT3,2019-03-31,2019-05-14,454455,464440,918895
9724,MAPT3,2019-06-30,2019-08-13,454455,464440,918895
9725,MAPT3,2019-09-30,2019-11-14,454455,464440,918895
9726,MAPT3,2019-12-31,2020-03-30,454455,464440,918895
9727,MAPT3,2020-03-31,2020-06-26,454455,464440,918895
9728,MAPT3,2020-06-30,2020-08-27,454455,464440,918895
9729,MAPT3,2020-09-30,2020-11-12,454455,464440,918895
9730,MAPT4,2010-12-31,2011-03-31,4544544,4644403,9188947
9731,MAPT4,2011-03-31,2011-05-12,4544544,4644403,9188947
9732,MAPT4,2011-06-30,2011-08-12,4544544,4644403,9188947
9733,MAPT4,2011-09-30,2011-11-11,4544544,4644403,9188947
9734,MAPT4,2011-12-31,2012-03-29,4544544,4644403,9188947
9735,MAPT4,2012-03-31,2012-05-14,4544544,4644403,9188947
9736,MAPT4,2012-06-30,2012-08-08,4544544,4644403,9188947
9737,MAPT4,2012-09-30,2012-11-13,4544544,4644403,9188947
9738,MAPT4,2012-12-31,2013-03-27,4544544,4644403,9188947
9739,MAPT4,2013-03-31,2013-05-07,4544544,4644403,9188947
9740,MAPT4,2013-06-30,2013-08-13,4544544,4644403,9188947
9741,MAPT4,2013-09-30,2013-11-12,4544544,4644403,9188947
9742,MAPT4,2013-12-31,2014-03-28,4544544,4644403,9188947
9743,MAPT4,2014-03-31,2014-05-13,4544544,4644403,9188947
9744,MAPT4,2014-06-30,2014-08-13,4544544,4644403,9188947
9745,MAPT4,2014-09-30,2014-11-12,4544544,4644403,9188947
9746,MAPT4,2014-12-31,2015-03-30,4544544,4644403,9188947
9747,MAPT4,2015-03-31,2015-05-14,4544544,4644403,9188947
9748,MAPT4,2015-06-30,2015-08-14,4544544,4644403,9188947
9749,MAPT4,2015-09-30,2015-11-12,4544544,4644403,9188947
9750,MAPT4,2015-12-31,2016-03-30,454455,464440,918895
9751,MAPT4,2016-03-31,2016-05-12,454455,464440,918895
9752,MAPT4,2016-06-30,2016-08-12,454455,464440,918895
9753,MAPT4,2016-09-30,2016-11-11,454455,464440,918895
9754,MAPT4,2016-12-31,2017-03-30,454455,464440,918895
9755,MAPT4,2017-03-31,2017-05-12,454455,464440,918895
9756,MAPT4,2017-06-30,2017-08-11,454455,464440,918895
9757,MAPT4,2017-09-30,2017-11-13,454455,464440,918895
9758,MAPT4,2017-12-31,2018-03-28,454455,464440,918895
9759,MAPT4,2018-03-31,2018-05-15,454455,464440,918895
9760,MAPT4,2018-06-30,2018-08-13,454455,464440,918895
9761,MAPT4,2018-09-30,2018-11-13,454455,464440,918895
9762,MAPT4,2018-12-31,2019-03-28,454455,464440,918895
9763,MAPT4,2019-03-31,2019-05-14,454455,464440,918895
9764,MAPT4,2019-06-30,2019-08-13,454455,464440,918895
9765,MAPT4,2019-09-30,2019-11-14,454455,464440,918895
9766,MAPT4,2019-12-31,2020-03-30,454455,464440,918895
9767,MAPT4,2020-03-31,2020-06-26,454455,464440,918895
9768,MAPT4,2020-06-30,2020-08-27,454455,464440,918895
9769,MAPT4,2020-09-30,2020-11-12,454455,464440,918895
9770,SUZB3,2010-12-31,2011-03-01,140039,268853,408892
9771,SUZB3,2011-03-31,2011-05-11,140039,268853,408892
9772,SUZB3,2011-06-30,2011-08-10,140039,268853,408892
9773,SUZB3,2011-09-30,2011-10-28,140039,268853,408892
9774,SUZB3,2011-12-31,2012-03-26,140039,268853,408892
9775,SUZB3,2012-03-31,2012-05-10,140039,268853,408892
9776,SUZB3,2012-06-30,2012-08-02,259646,506440,766086
9777,SUZB3,2012-09-30,2012-11-13,371128,736549,1107677
9778,SUZB3,2012-12-31,2013-03-12,371128,736549,1107677
9779,SUZB3,2013-03-31,2013-05-10,371128,736549,1107677
9780,SUZB3,2013-06-30,2013-08-13,371128,736549,1107677
9781,SUZB3,2013-09-30,2013-10-28,371128,736549,1107677
9782,SUZB3,2013-12-31,2014-03-14,371149,736590,1107739
9783,SUZB3,2014-03-31,2014-05-12,371149,736590,1107739
9784,SUZB3,2014-06-30,2014-08-14,371149,736590,1107739
9785,SUZB3,2014-09-30,2014-10-30,371149,736590,1107739
9786,SUZB3,2014-12-31,2015-03-05,371149,736590,1107739
9787,SUZB3,2015-03-31,2015-05-07,371149,736590,1107739
9788,SUZB3,2015-06-30,2015-08-12,371149,736590,1107739
9789,SUZB3,2015-09-30,2015-11-12,371149,736590,1107739
9790,SUZB3,2015-12-31,2016-02-19,371149,736590,1107739
9791,SUZB3,2016-03-31,2016-04-27,371149,736590,1107739
9792,SUZB3,2016-06-30,2016-08-03,371149,736590,1107739
9793,SUZB3,2016-09-30,2016-10-28,371149,736590,1107739
9794,SUZB3,2016-12-31,2017-02-08,371149,736590,1107739
9795,SUZB3,2017-03-31,2017-05-03,371149,736590,1107739
9796,SUZB3,2017-06-30,2017-08-02,371145,734681,1105826
9797,SUZB3,2017-09-30,2017-10-26,371145,734681,1105826
9798,SUZB3,2017-12-31,2018-02-09,1105826,0,1105826
9799,SUZB3,2018-03-31,2018-04-26,1105826,0,1105826
9800,SUZB3,2018-06-30,2018-08-09,1105826,0,1105826
9801,SUZB3,2018-09-30,2018-10-25,1105826,0,1105826
9802,SUZB3,2018-12-31,2019-02-21,1105826,0,1105826
9803,SUZB3,2019-03-31,2019-05-09,1361264,0,1361264
9804,SUZB3,2019-06-30,2019-08-08,1361264,0,1361264
9805,SUZB3,2019-09-30,2019-11-05,1361263584,0,1361263584
9806,SUZB3,2019-12-31,2020-02-12,1361263584,0,1361263584
9807,SUZB3,2020-03-31,2020-05-19,1361263584,0,1361263584
9808,SUZB3,2020-06-30,2020-08-13,1361263584,0,1361263584
9809,SUZB3,2020-09-30,2020-10-29,1361263584,0,1361263584
9810,SUZB3,2020-12-31,2021-02-10,1361263584,0,1361263584
9811,RAPT3,2010-12-31,2011-03-16,81888,161897,243785
9812,RAPT3,2011-03-31,2011-05-09,81888,161897,243785
9813,RAPT3,2011-06-30,2011-08-09,81888,161897,243785
9814,RAPT3,2011-09-30,2011-11-08,81888,161897,243785
9815,RAPT3,2011-12-31,2012-02-28,81888,161897,243785
9816,RAPT3,2012-03-31,2012-05-08,81888,161897,243785
9817,RAPT3,2012-06-30,2012-08-08,81888,161897,243785
9818,RAPT3,2012-09-30,2012-11-12,81888,161897,243785
9819,RAPT3,2012-12-31,2013-02-28,81888,161897,243785
9820,RAPT3,2013-03-31,2013-05-08,81888,161897,243785
9821,RAPT3,2013-06-30,2013-08-08,81888,161897,243785
9822,RAPT3,2013-09-30,2013-11-07,81888,161897,243785
9823,RAPT3,2013-12-31,2014-04-02,81888,161897,243785
9824,RAPT3,2014-03-31,2014-05-08,81888,161897,243785
9825,RAPT3,2014-06-30,2014-08-07,102360,202371,304731
9826,RAPT3,2014-09-30,2014-11-10,102360,202371,304731
9827,RAPT3,2014-12-31,2015-03-12,102360,202371,304731
9828,RAPT3,2015-03-31,2015-05-13,102360,202371,304731
9829,RAPT3,2015-06-30,2015-08-12,102360,202371,304731
9830,RAPT3,2015-09-30,2015-11-11,102360,202371,304731
9831,RAPT3,2015-12-31,2016-03-23,102360,202371,304731
9832,RAPT3,2016-03-31,2016-05-12,102360,202371,304731
9833,RAPT3,2016-06-30,2016-08-11,116516,229260,345776
9834,RAPT3,2016-09-30,2016-11-10,116516,229260,345776
9835,RAPT3,2016-12-31,2017-03-24,116516,229260,345776
9836,RAPT3,2017-03-31,2017-05-10,116516,229260,345776
9837,RAPT3,2017-06-30,2017-08-09,116516,229260,345776
9838,RAPT3,2017-09-30,2017-11-09,116516,229260,345776
9839,RAPT3,2017-12-31,2018-03-14,116516,229260,345776
9840,RAPT3,2018-03-31,2018-05-10,116516,229260,345776
9841,RAPT3,2018-06-30,2018-08-08,116516,229260,345776
9842,RAPT3,2018-09-30,2018-11-08,116516,229260,345776
9843,RAPT3,2018-12-31,2019-03-20,116516,229260,345776
9844,RAPT3,2019-03-31,2019-05-09,116516,229260,345776
9845,RAPT3,2019-06-30,2019-08-13,116516,229260,345776
9846,RAPT3,2019-09-30,2019-11-13,116516,229260,345776
9847,RAPT3,2019-12-31,2020-03-05,116516,229260,345776
9848,RAPT3,2020-03-31,2020-06-04,116516,229260,345776
9849,RAPT3,2020-06-30,2020-08-13,116516,229260,345776
9850,RAPT3,2020-09-30,2020-11-12,116516,229260,345776
9851,RAPT3,2020-12-31,2021-03-11,116516,229260,345776
9852,RAPT4,2010-12-31,2011-03-16,81888,161897,243785
9853,RAPT4,2011-03-31,2011-05-09,81888,161897,243785
9854,RAPT4,2011-06-30,2011-08-09,81888,161897,243785
9855,RAPT4,2011-09-30,2011-11-08,81888,161897,243785
9856,RAPT4,2011-12-31,2012-02-28,81888,161897,243785
9857,RAPT4,2012-03-31,2012-05-08,81888,161897,243785
9858,RAPT4,2012-06-30,2012-08-08,81888,161897,243785
9859,RAPT4,2012-09-30,2012-11-12,81888,161897,243785
9860,RAPT4,2012-12-31,2013-02-28,81888,161897,243785
9861,RAPT4,2013-03-31,2013-05-08,81888,161897,243785
9862,RAPT4,2013-06-30,2013-08-08,81888,161897,243785
9863,RAPT4,2013-09-30,2013-11-07,81888,161897,243785
9864,RAPT4,2013-12-31,2014-04-02,81888,161897,243785
9865,RAPT4,2014-03-31,2014-05-08,81888,161897,243785
9866,RAPT4,2014-06-30,2014-08-07,102360,202371,304731
9867,RAPT4,2014-09-30,2014-11-10,102360,202371,304731
9868,RAPT4,2014-12-31,2015-03-12,102360,202371,304731
9869,RAPT4,2015-03-31,2015-05-13,102360,202371,304731
9870,RAPT4,2015-06-30,2015-08-12,102360,202371,304731
9871,RAPT4,2015-09-30,2015-11-11,102360,202371,304731
9872,RAPT4,2015-12-31,2016-03-23,102360,202371,304731
9873,RAPT4,2016-03-31,2016-05-12,102360,202371,304731
9874,RAPT4,2016-06-30,2016-08-11,116516,229260,345776
9875,RAPT4,2016-09-30,2016-11-10,116516,229260,345776
9876,RAPT4,2016-12-31,2017-03-24,116516,229260,345776
9877,RAPT4,2017-03-31,2017-05-10,116516,229260,345776
9878,RAPT4,2017-06-30,2017-08-09,116516,229260,345776
9879,RAPT4,2017-09-30,2017-11-09,116516,229260,345776
9880,RAPT4,2017-12-31,2018-03-14,116516,229260,345776
9881,RAPT4,2018-03-31,2018-05-10,116516,229260,345776
9882,RAPT4,2018-06-30,2018-08-08,116516,229260,345776
9883,RAPT4,2018-09-30,2018-11-08,116516,229260,345776
9884,RAPT4,2018-12-31,2019-03-20,116516,229260,345776
9885,RAPT4,2019-03-31,2019-05-09,116516,229260,345776
9886,RAPT4,2019-06-30,2019-08-13,116516,229260,345776
9887,RAPT4,2019-09-30,2019-11-13,116516,229260,345776
9888,RAPT4,2019-12-31,2020-03-05,116516,229260,345776
9889,RAPT4,2020-03-31,2020-06-04,116516,229260,345776
9890,RAPT4,2020-06-30,2020-08-13,116516,229260,345776
9891,RAPT4,2020-09-30,2020-11-12,116516,229260,345776
9892,RAPT4,2020-12-31,2021-03-11,116516,229260,345776
9893,TOYB3,2010-12-31,2011-03-28,517045378,519881428,1036926806
9894,TOYB3,2011-03-31,2011-05-13,517045378,519881428,1036926806
9895,TOYB3,2011-06-30,2011-08-12,517045378,519881428,1036926806
9896,TOYB3,2011-09-30,2011-11-09,685714430,636926305,1322640735
9897,TOYB3,2011-12-31,2012-04-03,685714430,636926305,1322640735
9898,TOYB3,2012-03-31,2012-05-14,685714430,636926305,1322640735
9899,TOYB3,2012-06-30,2012-08-14,685714430,636926305,1322640735
9900,TOYB3,2012-09-30,2012-11-14,685714430,636926305,1322640735
9901,TOYB3,2012-12-31,2013-03-26,685714430,636926305,1322640735
9902,TOYB3,2013-03-31,2013-05-15,685714430,636926305,1322640735
9903,TOYB3,2013-06-30,2013-08-14,685714430,636926305,1322640735
9904,TOYB3,2013-09-30,2013-11-13,685714430,636926305,1322640735
9905,TOYB3,2013-12-31,2014-03-27,685714430,636926305,1322640735
9906,TOYB3,2014-03-31,2014-05-14,685714430,636926305,1322640735
9907,TOYB3,2014-06-30,2014-08-14,685714430,636926305,1322640735
9908,TOYB3,2014-09-30,2014-11-14,685714430,636926305,1322640735
9909,TOYB3,2014-12-31,2015-03-30,685714430,636926305,1322640735
9910,TOYB3,2015-03-31,2015-05-14,685714430,636926305,1322640735
9911,TOYB3,2015-06-30,2015-08-17,2738293025,2548997735,5287290760
9912,TOYB3,2015-09-30,2015-11-16,2738293,2548997,5287290
9913,TOYB3,2015-12-31,2016-03-29,2738,2549,5287
9914,TOYB3,2016-03-31,2016-05-12,2738,2549,5287
9915,TOYB3,2016-06-30,2016-08-12,2738,2549,5287
9916,TOYB3,2016-09-30,2016-11-10,2738,2549,5287
9917,TOYB3,2016-12-31,2017-03-29,2738,2549,5287
9918,TOYB3,2017-03-31,2017-05-15,2738,2549,5287
9919,TOYB3,2017-06-30,2017-08-15,2738,2549,5287
9920,TOYB3,2017-09-30,2017-11-14,2738,2549,5287
9921,TOYB3,2017-12-31,2018-03-27,2738,2549,5287
9922,TOYB3,2018-03-31,2018-05-15,15570,14494,30064
9923,TOYB3,2018-06-30,2018-08-13,15570,14494,30064
9924,TOYB3,2018-09-30,2018-11-13,15570,14494,30064
9925,TOYB3,2018-12-31,2019-03-26,15570,14494,30064
9926,TOYB3,2019-03-31,2019-05-15,15570,14494,30064
9927,TOYB4,2010-12-31,2011-03-28,517045378,519881428,1036926806
9928,TOYB4,2011-03-31,2011-05-13,517045378,519881428,1036926806
9929,TOYB4,2011-06-30,2011-08-12,517045378,519881428,1036926806
9930,TOYB4,2011-09-30,2011-11-09,685714430,636926305,1322640735
9931,TOYB4,2011-12-31,2012-04-03,685714430,636926305,1322640735
9932,TOYB4,2012-03-31,2012-05-14,685714430,636926305,1322640735
9933,TOYB4,2012-06-30,2012-08-14,685714430,636926305,1322640735
9934,TOYB4,2012-09-30,2012-11-14,685714430,636926305,1322640735
9935,TOYB4,2012-12-31,2013-03-26,685714430,636926305,1322640735
9936,TOYB4,2013-03-31,2013-05-15,685714430,636926305,1322640735
9937,TOYB4,2013-06-30,2013-08-14,685714430,636926305,1322640735
9938,TOYB4,2013-09-30,2013-11-13,685714430,636926305,1322640735
9939,TOYB4,2013-12-31,2014-03-27,685714430,636926305,1322640735
9940,TOYB4,2014-03-31,2014-05-14,685714430,636926305,1322640735
9941,TOYB4,2014-06-30,2014-08-14,685714430,636926305,1322640735
9942,TOYB4,2014-09-30,2014-11-14,685714430,636926305,1322640735
9943,TOYB4,2014-12-31,2015-03-30,685714430,636926305,1322640735
9944,TOYB4,2015-03-31,2015-05-14,685714430,636926305,1322640735
9945,TOYB4,2015-06-30,2015-08-17,2738293025,2548997735,5287290760
9946,TOYB4,2015-09-30,2015-11-16,2738293,2548997,5287290
9947,TOYB4,2015-12-31,2016-03-29,2738,2549,5287
9948,TOYB4,2016-03-31,2016-05-12,2738,2549,5287
9949,TOYB4,2016-06-30,2016-08-12,2738,2549,5287
9950,TOYB4,2016-09-30,2016-11-10,2738,2549,5287
9951,TOYB4,2016-12-31,2017-03-29,2738,2549,5287
9952,TOYB4,2017-03-31,2017-05-15,2738,2549,5287
9953,TOYB4,2017-06-30,2017-08-15,2738,2549,5287
9954,TOYB4,2017-09-30,2017-11-14,2738,2549,5287
9955,TOYB4,2017-12-31,2018-03-27,2738,2549,5287
9956,TOYB4,2018-03-31,2018-05-15,15570,14494,30064
9957,TOYB4,2018-06-30,2018-08-13,15570,14494,30064
9958,TOYB4,2018-09-30,2018-11-13,15570,14494,30064
9959,TOYB4,2018-12-31,2019-03-26,15570,14494,30064
9960,TOYB4,2019-03-31,2019-05-15,15570,14494,30064
9961,ELPL3,2010-12-31,2011-03-23,66605,100739,167344
9962,ELPL3,2011-03-31,2011-05-11,66605,100739,167344
9963,ELPL3,2011-06-30,2011-08-10,66605,100739,167344
9964,ELPL3,2011-09-30,2011-11-09,66605,100739,167344
9965,ELPL3,2011-12-31,2012-03-14,66605,100739,167344
9966,ELPL3,2012-03-31,2012-05-03,66605,100739,167344
9967,ELPL3,2012-06-30,2012-08-03,66605,100739,167344
9968,ELPL3,2012-09-30,2012-11-06,66605,100739,167344
9969,ELPL3,2012-12-31,2013-02-28,66605,100739,167344
9970,ELPL3,2013-03-31,2013-05-08,66605,100739,167344
9971,ELPL3,2013-06-30,2013-08-07,66605,100739,167344
9972,ELPL3,2013-09-30,2013-11-06,66605,100739,167344
9973,ELPL3,2013-12-31,2014-02-26,66605,100739,167344
9974,ELPL3,2014-03-31,2014-05-07,66605,100739,167344
9975,ELPL3,2014-06-30,2014-08-06,66605,100739,167344
9976,ELPL3,2014-09-30,2014-11-05,66605,100739,167344
9977,ELPL3,2014-12-31,2015-02-25,66605,100739,167344
9978,ELPL3,2015-03-31,2015-05-08,66605,100739,167344
9979,ELPL3,2015-06-30,2015-08-07,66605,100739,167344
9980,ELPL3,2015-09-30,2015-11-04,66605,100739,167344
9981,ELPL3,2015-12-31,2016-02-25,66605,100739,167344
9982,ELPL3,2016-03-31,2016-05-06,66605,100739,167344
9983,ELPL3,2016-06-30,2016-08-04,66605,100739,167344
9984,ELPL3,2016-09-30,2016-11-03,66605,100739,167344
9985,ELPL3,2016-12-31,2017-02-24,55781,111563,167344
9986,ELPL3,2017-03-31,2017-05-05,55781,111563,167344
9987,ELPL3,2017-06-30,2017-08-07,55781,111563,167344
9988,ELPL3,2017-09-30,2017-11-01,55781,111563,167344
9989,ELPL3,2017-12-31,2018-03-26,164286,0,164286
9990,ELPL3,2018-03-31,2018-05-15,164286,0,164286
9991,ELPL3,2018-06-30,2018-08-02,167344,0,167344
9992,ELPL3,2018-09-30,2018-10-30,200515,0,200515
9993,ELPL3,2018-12-31,2019-02-26,200515,0,200515
9994,ELPL3,2019-03-31,2019-04-25,200515,0,200515
9995,ELPL3,2019-06-30,2019-07-30,200515,0,200515
9996,ELPL3,2019-09-30,2019-10-25,200515,0,200515
9997,ELPL3,2019-12-31,2020-02-20,197467,0,197467
9998,ELPL3,2020-03-31,2020-04-30,197467,0,197467
9999,ELPL3,2020-06-30,2020-07-27,197467,0,197467
10000,ELPL3,2020-09-30,2020-11-03,197467,0,197467
10001,ELPL3,2020-12-31,2021-02-24,197467,0,197467
10002,BSLI3,2010-12-31,2011-04-29,28015,8290,36305
10003,BSLI3,2011-03-31,2011-05-19,28015,8290,36305
10004,BSLI3,2011-06-30,2011-08-18,28015,8290,36305
10005,BSLI3,2011-09-30,2011-11-14,28015,8290,36305
10006,BSLI3,2011-12-31,2012-04-02,28015,8290,36305
10007,BSLI3,2012-03-31,2012-05-18,28015,8290,36305
10008,BSLI3,2012-06-30,2012-08-16,28015,8290,36305
10009,BSLI3,2012-09-30,2012-11-05,28015,8290,36305
10010,BSLI3,2012-12-31,2013-04-01,28015,8290,36305
10011,BSLI3,2013-03-31,2013-05-15,28015,8290,36305
10012,BSLI3,2013-06-30,2013-08-15,28015,8290,36305
10013,BSLI3,2013-09-30,2013-11-07,28014,8290,36304
10014,BSLI3,2013-12-31,2014-03-28,28014,8290,36304
10015,BSLI3,2014-03-31,2014-05-12,28014,8290,36304
10016,BSLI3,2014-06-30,2014-08-15,28014,8290,36304
10017,BSLI3,2014-09-30,2014-11-21,28014,8290,36304
10018,BSLI3,2014-12-31,2015-04-17,28014,8290,36304
10019,BSLI3,2015-03-31,2015-05-18,28014,8290,36304
10020,BSLI3,2015-06-30,2015-08-14,28014,8290,36304
10021,BSLI3,2015-09-30,2015-11-13,28014,8290,36304
10022,BSLI3,2015-12-31,2016-04-01,28014,8290,36304
10023,BSLI3,2016-03-31,2016-05-16,28014,8290,36304
10024,BSLI3,2016-06-30,2016-08-25,28014,8290,36304
10025,BSLI3,2016-09-30,2016-11-16,28014,8290,36304
10026,BSLI3,2016-12-31,2017-05-06,28014,8290,36304
10027,BSLI3,2017-03-31,2017-05-30,28014,8290,36304
10028,BSLI3,2017-06-30,2017-08-14,28014,8290,36304
10029,BSLI3,2017-09-30,2017-11-10,28014,8290,36304
10030,BSLI3,2017-12-31,2018-04-27,28014,8290,36304
10031,BSLI3,2018-03-31,2018-05-15,28014,8290,36304
10032,BSLI3,2018-06-30,2018-08-30,28014,8290,36304
10033,BSLI3,2018-09-30,2018-11-20,28014,8290,36304
10034,BSLI3,2018-12-31,2020-01-08,28014,8290,36304
10035,BSLI3,2019-03-31,2019-08-28,28014,8290,36304
10036,BSLI3,2019-06-30,2019-08-28,28014,8290,36304
10037,BSLI3,2019-09-30,2019-11-07,28014,8290,36304
10038,BSLI3,2019-12-31,2020-06-01,28014,8290,36304
10039,BSLI3,2020-03-31,2020-05-15,28014,8290,36304
10040,BSLI3,2020-06-30,2020-08-20,28014,8290,36304
10041,BSLI3,2020-09-30,2020-11-20,28014,8290,36304
10042,BSLI3,2020-12-31,2021-02-12,28014,8290,36304
10043,BSLI4,2010-12-31,2011-04-29,28015,8290,36305
10044,BSLI4,2011-03-31,2011-05-19,28015,8290,36305
10045,BSLI4,2011-06-30,2011-08-18,28015,8290,36305
10046,BSLI4,2011-09-30,2011-11-14,28015,8290,36305
10047,BSLI4,2011-12-31,2012-04-02,28015,8290,36305
10048,BSLI4,2012-03-31,2012-05-18,28015,8290,36305
10049,BSLI4,2012-06-30,2012-08-16,28015,8290,36305
10050,BSLI4,2012-09-30,2012-11-05,28015,8290,36305
10051,BSLI4,2012-12-31,2013-04-01,28015,8290,36305
10052,BSLI4,2013-03-31,2013-05-15,28015,8290,36305
10053,BSLI4,2013-06-30,2013-08-15,28015,8290,36305
10054,BSLI4,2013-09-30,2013-11-07,28014,8290,36304
10055,BSLI4,2013-12-31,2014-03-28,28014,8290,36304
10056,BSLI4,2014-03-31,2014-05-12,28014,8290,36304
10057,BSLI4,2014-06-30,2014-08-15,28014,8290,36304
10058,BSLI4,2014-09-30,2014-11-21,28014,8290,36304
10059,BSLI4,2014-12-31,2015-04-17,28014,8290,36304
10060,BSLI4,2015-03-31,2015-05-18,28014,8290,36304
10061,BSLI4,2015-06-30,2015-08-14,28014,8290,36304
10062,BSLI4,2015-09-30,2015-11-13,28014,8290,36304
10063,BSLI4,2015-12-31,2016-04-01,28014,8290,36304
10064,BSLI4,2016-03-31,2016-05-16,28014,8290,36304
10065,BSLI4,2016-06-30,2016-08-25,28014,8290,36304
10066,BSLI4,2016-09-30,2016-11-16,28014,8290,36304
10067,BSLI4,2016-12-31,2017-05-06,28014,8290,36304
10068,BSLI4,2017-03-31,2017-05-30,28014,8290,36304
10069,BSLI4,2017-06-30,2017-08-14,28014,8290,36304
10070,BSLI4,2017-09-30,2017-11-10,28014,8290,36304
10071,BSLI4,2017-12-31,2018-04-27,28014,8290,36304
10072,BSLI4,2018-03-31,2018-05-15,28014,8290,36304
10073,BSLI4,2018-06-30,2018-08-30,28014,8290,36304
10074,BSLI4,2018-09-30,2018-11-20,28014,8290,36304
10075,BSLI4,2018-12-31,2020-01-08,28014,8290,36304
10076,BSLI4,2019-03-31,2019-08-28,28014,8290,36304
10077,BSLI4,2019-06-30,2019-08-28,28014,8290,36304
10078,BSLI4,2019-09-30,2019-11-07,28014,8290,36304
10079,BSLI4,2019-12-31,2020-06-01,28014,8290,36304
10080,BSLI4,2020-03-31,2020-05-15,28014,8290,36304
10081,BSLI4,2020-06-30,2020-08-20,28014,8290,36304
10082,BSLI4,2020-09-30,2020-11-20,28014,8290,36304
10083,BSLI4,2020-12-31,2021-02-12,28014,8290,36304
10084,CPLE3,2010-12-31,2011-03-29,145031080,128624295,273655375
10085,CPLE3,2011-03-31,2011-05-11,145031080,128624295,273655375
10086,CPLE3,2011-06-30,2011-08-10,145031080,128624295,273655375
10087,CPLE3,2011-09-30,2011-11-09,145031080,128624295,273655375
10088,CPLE3,2011-12-31,2012-03-26,145031080,128624295,273655375
10089,CPLE3,2012-03-31,2012-05-15,145031080,128624295,273655375
10090,CPLE3,2012-06-30,2012-08-14,145031080,128624295,273655375
10091,CPLE3,2012-09-30,2012-11-13,145031080,128624295,273655375
10092,CPLE3,2012-12-31,2013-03-25,145031080,128624295,273655375
10093,CPLE3,2013-03-31,2013-05-15,145031080,128624295,273655375
10094,CPLE3,2013-06-30,2013-08-14,145031080,128624295,273655375
10095,CPLE3,2013-09-30,2013-11-08,145031080,128624295,273655375
10096,CPLE3,2013-12-31,2014-09-30,145031080,128624295,273655375
10097,CPLE3,2014-03-31,2014-05-14,145031080,128624295,273655375
10098,CPLE3,2014-06-30,2014-08-13,145031080,128624295,273655375
10099,CPLE3,2014-09-30,2014-11-13,145031080,128624295,273655375
10100,CPLE3,2014-12-31,2015-03-20,145031080,128624295,273655375
10101,CPLE3,2015-03-31,2015-05-14,145031080,128624295,273655375
10102,CPLE3,2015-06-30,2015-08-13,145031080,128624295,273655375
10103,CPLE3,2015-09-30,2015-11-11,145031080,128624295,273655375
10104,CPLE3,2015-12-31,2016-03-17,145031080,128624295,273655375
10105,CPLE3,2016-03-31,2016-05-12,145031080,128624295,273655375
10106,CPLE3,2016-06-30,2016-08-11,145031080,128624295,273655375
10107,CPLE3,2016-09-30,2016-11-10,145031080,128624295,273655375
10108,CPLE3,2016-12-31,2017-03-28,145031080,128624295,273655375
10109,CPLE3,2017-03-31,2018-06-13,145031080,128624295,273655375
10110,CPLE3,2017-06-30,2018-06-13,145031080,128624295,273655375
10111,CPLE3,2017-09-30,2018-06-13,145031080,128624295,273655375
10112,CPLE3,2017-12-31,2018-05-14,145031080,128624295,273655375
10113,CPLE3,2018-03-31,2018-05-15,145031080,128624295,273655375
10114,CPLE3,2018-06-30,2018-08-14,145031080,128624295,273655375
10115,CPLE3,2018-09-30,2018-11-08,145031080,128624295,273655375
10116,CPLE3,2018-12-31,2019-03-28,145031080,128624295,273655375
10117,CPLE3,2019-03-31,2020-12-17,145031080,128624295,273655375
10118,CPLE3,2019-06-30,2019-08-14,145031080,128624295,273655375
10119,CPLE3,2019-09-30,2019-11-12,145031080,128624295,273655375
10120,CPLE3,2019-12-31,2020-03-25,145031080,128624295,273655375
10121,CPLE3,2020-03-31,2020-05-14,145031080,128624295,273655375
10122,CPLE3,2020-06-30,2020-08-13,145031080,128624295,273655375
10123,CPLE3,2020-09-30,2020-11-12,145031080,128624295,273655375
10124,CPLE3,2020-12-31,2021-03-17,1450310800,1286242950,2736553750
10125,CPLE5,2010-12-31,2011-03-29,145031080,128624295,273655375
10126,CPLE5,2011-03-31,2011-05-11,145031080,128624295,273655375
10127,CPLE5,2011-06-30,2011-08-10,145031080,128624295,273655375
10128,CPLE5,2011-09-30,2011-11-09,145031080,128624295,273655375
10129,CPLE5,2011-12-31,2012-03-26,145031080,128624295,273655375
10130,CPLE5,2012-03-31,2012-05-15,145031080,128624295,273655375
10131,CPLE5,2012-06-30,2012-08-14,145031080,128624295,273655375
10132,CPLE5,2012-09-30,2012-11-13,145031080,128624295,273655375
10133,CPLE5,2012-12-31,2013-03-25,145031080,128624295,273655375
10134,CPLE5,2013-03-31,2013-05-15,145031080,128624295,273655375
10135,CPLE5,2013-06-30,2013-08-14,145031080,128624295,273655375
10136,CPLE5,2013-09-30,2013-11-08,145031080,128624295,273655375
10137,CPLE5,2013-12-31,2014-09-30,145031080,128624295,273655375
10138,CPLE5,2014-03-31,2014-05-14,145031080,128624295,273655375
10139,CPLE5,2014-06-30,2014-08-13,145031080,128624295,273655375
10140,CPLE5,2014-09-30,2014-11-13,145031080,128624295,273655375
10141,CPLE5,2014-12-31,2015-03-20,145031080,128624295,273655375
10142,CPLE5,2015-03-31,2015-05-14,145031080,128624295,273655375
10143,CPLE5,2015-06-30,2015-08-13,145031080,128624295,273655375
10144,CPLE5,2015-09-30,2015-11-11,145031080,128624295,273655375
10145,CPLE5,2015-12-31,2016-03-17,145031080,128624295,273655375
10146,CPLE5,2016-03-31,2016-05-12,145031080,128624295,273655375
10147,CPLE5,2016-06-30,2016-08-11,145031080,128624295,273655375
10148,CPLE5,2016-09-30,2016-11-10,145031080,128624295,273655375
10149,CPLE5,2016-12-31,2017-03-28,145031080,128624295,273655375
10150,CPLE5,2017-03-31,2018-06-13,145031080,128624295,273655375
10151,CPLE5,2017-06-30,2018-06-13,145031080,128624295,273655375
10152,CPLE5,2017-09-30,2018-06-13,145031080,128624295,273655375
10153,CPLE5,2017-12-31,2018-05-14,145031080,128624295,273655375
10154,CPLE5,2018-03-31,2018-05-15,145031080,128624295,273655375
10155,CPLE5,2018-06-30,2018-08-14,145031080,128624295,273655375
10156,CPLE5,2018-09-30,2018-11-08,145031080,128624295,273655375
10157,CPLE5,2018-12-31,2019-03-28,145031080,128624295,273655375
10158,CPLE5,2019-03-31,2020-12-17,145031080,128624295,273655375
10159,CPLE5,2019-06-30,2019-08-14,145031080,128624295,273655375
10160,CPLE5,2019-09-30,2019-11-12,145031080,128624295,273655375
10161,CPLE5,2019-12-31,2020-03-25,145031080,128624295,273655375
10162,CPLE5,2020-03-31,2020-05-14,145031080,128624295,273655375
10163,CPLE5,2020-06-30,2020-08-13,145031080,128624295,273655375
10164,CPLE5,2020-09-30,2020-11-12,145031080,128624295,273655375
10165,CPLE5,2020-12-31,2021-03-17,1450310800,1286242950,2736553750
10166,CPLE6,2010-12-31,2011-03-29,145031080,128624295,273655375
10167,CPLE6,2011-03-31,2011-05-11,145031080,128624295,273655375
10168,CPLE6,2011-06-30,2011-08-10,145031080,128624295,273655375
10169,CPLE6,2011-09-30,2011-11-09,145031080,128624295,273655375
10170,CPLE6,2011-12-31,2012-03-26,145031080,128624295,273655375
10171,CPLE6,2012-03-31,2012-05-15,145031080,128624295,273655375
10172,CPLE6,2012-06-30,2012-08-14,145031080,128624295,273655375
10173,CPLE6,2012-09-30,2012-11-13,145031080,128624295,273655375
10174,CPLE6,2012-12-31,2013-03-25,145031080,128624295,273655375
10175,CPLE6,2013-03-31,2013-05-15,145031080,128624295,273655375
10176,CPLE6,2013-06-30,2013-08-14,145031080,128624295,273655375
10177,CPLE6,2013-09-30,2013-11-08,145031080,128624295,273655375
10178,CPLE6,2013-12-31,2014-09-30,145031080,128624295,273655375
10179,CPLE6,2014-03-31,2014-05-14,145031080,128624295,273655375
10180,CPLE6,2014-06-30,2014-08-13,145031080,128624295,273655375
10181,CPLE6,2014-09-30,2014-11-13,145031080,128624295,273655375
10182,CPLE6,2014-12-31,2015-03-20,145031080,128624295,273655375
10183,CPLE6,2015-03-31,2015-05-14,145031080,128624295,273655375
10184,CPLE6,2015-06-30,2015-08-13,145031080,128624295,273655375
10185,CPLE6,2015-09-30,2015-11-11,145031080,128624295,273655375
10186,CPLE6,2015-12-31,2016-03-17,145031080,128624295,273655375
10187,CPLE6,2016-03-31,2016-05-12,145031080,128624295,273655375
10188,CPLE6,2016-06-30,2016-08-11,145031080,128624295,273655375
10189,CPLE6,2016-09-30,2016-11-10,145031080,128624295,273655375
10190,CPLE6,2016-12-31,2017-03-28,145031080,128624295,273655375
10191,CPLE6,2017-03-31,2018-06-13,145031080,128624295,273655375
10192,CPLE6,2017-06-30,2018-06-13,145031080,128624295,273655375
10193,CPLE6,2017-09-30,2018-06-13,145031080,128624295,273655375
10194,CPLE6,2017-12-31,2018-05-14,145031080,128624295,273655375
10195,CPLE6,2018-03-31,2018-05-15,145031080,128624295,273655375
10196,CPLE6,2018-06-30,2018-08-14,145031080,128624295,273655375
10197,CPLE6,2018-09-30,2018-11-08,145031080,128624295,273655375
10198,CPLE6,2018-12-31,2019-03-28,145031080,128624295,273655375
10199,CPLE6,2019-03-31,2020-12-17,145031080,128624295,273655375
10200,CPLE6,2019-06-30,2019-08-14,145031080,128624295,273655375
10201,CPLE6,2019-09-30,2019-11-12,145031080,128624295,273655375
10202,CPLE6,2019-12-31,2020-03-25,145031080,128624295,273655375
10203,CPLE6,2020-03-31,2020-05-14,145031080,128624295,273655375
10204,CPLE6,2020-06-30,2020-08-13,145031080,128624295,273655375
10205,CPLE6,2020-09-30,2020-11-12,145031080,128624295,273655375
10206,CPLE6,2020-12-31,2021-03-17,1450310800,1286242950,2736553750
10207,USIM3,2010-12-31,2011-03-16,505260684,508525506,1013786190
10208,USIM3,2011-03-31,2011-05-11,505260684,508525506,1013786190
10209,USIM3,2011-06-30,2011-08-02,505260684,508525506,1013786190
10210,USIM3,2011-09-30,2011-11-08,505260684,508525506,1013786190
10211,USIM3,2011-12-31,2012-03-07,505260684,508525506,1013786190
10212,USIM3,2012-03-31,2012-04-23,505260684,508525506,1013786190
10213,USIM3,2012-06-30,2012-07-30,505260684,508525506,1013786190
10214,USIM3,2012-09-30,2012-11-01,505260684,508525506,1013786190
10215,USIM3,2012-12-31,2013-03-04,505260684,508525506,1013786190
10216,USIM3,2013-03-31,2013-04-26,505260684,508525506,1013786190
10217,USIM3,2013-06-30,2013-07-26,505260684,508525506,1013786190
10218,USIM3,2013-09-30,2013-10-30,505260684,508525506,1013786190
10219,USIM3,2013-12-31,2014-02-14,505260684,508525506,1013786190
10220,USIM3,2014-03-31,2014-04-24,505260684,508525506,1013786190
10221,USIM3,2014-06-30,2014-07-24,505260684,508525506,1013786190
10222,USIM3,2014-09-30,2014-10-29,505260684,508525506,1013786190
10223,USIM3,2014-12-31,2015-03-04,505260684,508525506,1013786190
10224,USIM3,2015-03-31,2015-04-23,505260684,508525506,1013786190
10225,USIM3,2015-06-30,2015-08-06,505260684,508525506,1013786190
10226,USIM3,2015-09-30,2015-10-29,505260684,508525506,1013786190
10227,USIM3,2015-12-31,2016-02-18,505260684,508525506,1013786190
10228,USIM3,2016-03-31,2016-04-25,505260684,508525506,1013786190
10229,USIM3,2016-06-30,2016-07-28,505260684,547818424,1053079108
10230,USIM3,2016-09-30,2016-10-28,705260684,547818424,1253079108
10231,USIM3,2016-12-31,2017-02-17,705260684,547818424,1253079108
10232,USIM3,2017-03-31,2017-04-20,705260684,547818424,1253079108
10233,USIM3,2017-06-30,2017-07-28,705260684,547818424,1253079108
10234,USIM3,2017-09-30,2017-10-27,705260684,547818424,1253079108
10235,USIM3,2017-12-31,2018-02-09,705260684,547818424,1253079108
10236,USIM3,2018-03-31,2018-05-09,705260684,547818424,1253079108
10237,USIM3,2018-06-30,2018-07-27,705260684,547818424,1253079108
10238,USIM3,2018-09-30,2018-10-26,705260684,547818424,1253079108
10239,USIM3,2018-12-31,2019-02-15,705260684,547818424,1253079108
10240,USIM3,2019-03-31,2019-04-18,705260684,547818424,1253079108
10241,USIM3,2019-06-30,2019-07-26,702734028,526767025,1229501053
10242,USIM3,2019-09-30,2019-10-25,705260684,547818424,1253079108
10243,USIM3,2019-12-31,2020-02-14,705260684,547818424,1253079108
10244,USIM3,2020-03-31,2020-05-22,705260684,547818424,1253079108
10245,USIM3,2020-06-30,2020-07-30,705260684,547818424,1253079108
10246,USIM3,2020-09-30,2020-10-29,705260684,547818424,1253079108
10247,USIM3,2020-12-31,2021-02-12,705260684,547818424,1253079108
10248,USIM5,2010-12-31,2011-03-16,505260684,508525506,1013786190
10249,USIM5,2011-03-31,2011-05-11,505260684,508525506,1013786190
10250,USIM5,2011-06-30,2011-08-02,505260684,508525506,1013786190
10251,USIM5,2011-09-30,2011-11-08,505260684,508525506,1013786190
10252,USIM5,2011-12-31,2012-03-07,505260684,508525506,1013786190
10253,USIM5,2012-03-31,2012-04-23,505260684,508525506,1013786190
10254,USIM5,2012-06-30,2012-07-30,505260684,508525506,1013786190
10255,USIM5,2012-09-30,2012-11-01,505260684,508525506,1013786190
10256,USIM5,2012-12-31,2013-03-04,505260684,508525506,1013786190
10257,USIM5,2013-03-31,2013-04-26,505260684,508525506,1013786190
10258,USIM5,2013-06-30,2013-07-26,505260684,508525506,1013786190
10259,USIM5,2013-09-30,2013-10-30,505260684,508525506,1013786190
10260,USIM5,2013-12-31,2014-02-14,505260684,508525506,1013786190
10261,USIM5,2014-03-31,2014-04-24,505260684,508525506,1013786190
10262,USIM5,2014-06-30,2014-07-24,505260684,508525506,1013786190
10263,USIM5,2014-09-30,2014-10-29,505260684,508525506,1013786190
10264,USIM5,2014-12-31,2015-03-04,505260684,508525506,1013786190
10265,USIM5,2015-03-31,2015-04-23,505260684,508525506,1013786190
10266,USIM5,2015-06-30,2015-08-06,505260684,508525506,1013786190
10267,USIM5,2015-09-30,2015-10-29,505260684,508525506,1013786190
10268,USIM5,2015-12-31,2016-02-18,505260684,508525506,1013786190
10269,USIM5,2016-03-31,2016-04-25,505260684,508525506,1013786190
10270,USIM5,2016-06-30,2016-07-28,505260684,547818424,1053079108
10271,USIM5,2016-09-30,2016-10-28,705260684,547818424,1253079108
10272,USIM5,2016-12-31,2017-02-17,705260684,547818424,1253079108
10273,USIM5,2017-03-31,2017-04-20,705260684,547818424,1253079108
10274,USIM5,2017-06-30,2017-07-28,705260684,547818424,1253079108
10275,USIM5,2017-09-30,2017-10-27,705260684,547818424,1253079108
10276,USIM5,2017-12-31,2018-02-09,705260684,547818424,1253079108
10277,USIM5,2018-03-31,2018-05-09,705260684,547818424,1253079108
10278,USIM5,2018-06-30,2018-07-27,705260684,547818424,1253079108
10279,USIM5,2018-09-30,2018-10-26,705260684,547818424,1253079108
10280,USIM5,2018-12-31,2019-02-15,705260684,547818424,1253079108
10281,USIM5,2019-03-31,2019-04-18,705260684,547818424,1253079108
10282,USIM5,2019-06-30,2019-07-26,702734028,526767025,1229501053
10283,USIM5,2019-09-30,2019-10-25,705260684,547818424,1253079108
10284,USIM5,2019-12-31,2020-02-14,705260684,547818424,1253079108
10285,USIM5,2020-03-31,2020-05-22,705260684,547818424,1253079108
10286,USIM5,2020-06-30,2020-07-30,705260684,547818424,1253079108
10287,USIM5,2020-09-30,2020-10-29,705260684,547818424,1253079108
10288,USIM5,2020-12-31,2021-02-12,705260684,547818424,1253079108
10289,USIM6,2010-12-31,2011-03-16,505260684,508525506,1013786190
10290,USIM6,2011-03-31,2011-05-11,505260684,508525506,1013786190
10291,USIM6,2011-06-30,2011-08-02,505260684,508525506,1013786190
10292,USIM6,2011-09-30,2011-11-08,505260684,508525506,1013786190
10293,USIM6,2011-12-31,2012-03-07,505260684,508525506,1013786190
10294,USIM6,2012-03-31,2012-04-23,505260684,508525506,1013786190
10295,USIM6,2012-06-30,2012-07-30,505260684,508525506,1013786190
10296,USIM6,2012-09-30,2012-11-01,505260684,508525506,1013786190
10297,USIM6,2012-12-31,2013-03-04,505260684,508525506,1013786190
10298,USIM6,2013-03-31,2013-04-26,505260684,508525506,1013786190
10299,USIM6,2013-06-30,2013-07-26,505260684,508525506,1013786190
10300,USIM6,2013-09-30,2013-10-30,505260684,508525506,1013786190
10301,USIM6,2013-12-31,2014-02-14,505260684,508525506,1013786190
10302,USIM6,2014-03-31,2014-04-24,505260684,508525506,1013786190
10303,USIM6,2014-06-30,2014-07-24,505260684,508525506,1013786190
10304,USIM6,2014-09-30,2014-10-29,505260684,508525506,1013786190
10305,USIM6,2014-12-31,2015-03-04,505260684,508525506,1013786190
10306,USIM6,2015-03-31,2015-04-23,505260684,508525506,1013786190
10307,USIM6,2015-06-30,2015-08-06,505260684,508525506,1013786190
10308,USIM6,2015-09-30,2015-10-29,505260684,508525506,1013786190
10309,USIM6,2015-12-31,2016-02-18,505260684,508525506,1013786190
10310,USIM6,2016-03-31,2016-04-25,505260684,508525506,1013786190
10311,USIM6,2016-06-30,2016-07-28,505260684,547818424,1053079108
10312,USIM6,2016-09-30,2016-10-28,705260684,547818424,1253079108
10313,USIM6,2016-12-31,2017-02-17,705260684,547818424,1253079108
10314,USIM6,2017-03-31,2017-04-20,705260684,547818424,1253079108
10315,USIM6,2017-06-30,2017-07-28,705260684,547818424,1253079108
10316,USIM6,2017-09-30,2017-10-27,705260684,547818424,1253079108
10317,USIM6,2017-12-31,2018-02-09,705260684,547818424,1253079108
10318,USIM6,2018-03-31,2018-05-09,705260684,547818424,1253079108
10319,USIM6,2018-06-30,2018-07-27,705260684,547818424,1253079108
10320,USIM6,2018-09-30,2018-10-26,705260684,547818424,1253079108
10321,USIM6,2018-12-31,2019-02-15,705260684,547818424,1253079108
10322,USIM6,2019-03-31,2019-04-18,705260684,547818424,1253079108
10323,USIM6,2019-06-30,2019-07-26,702734028,526767025,1229501053
10324,USIM6,2019-09-30,2019-10-25,705260684,547818424,1253079108
10325,USIM6,2019-12-31,2020-02-14,705260684,547818424,1253079108
10326,USIM6,2020-03-31,2020-05-22,705260684,547818424,1253079108
10327,USIM6,2020-06-30,2020-07-30,705260684,547818424,1253079108
10328,USIM6,2020-09-30,2020-10-29,705260684,547818424,1253079108
10329,USIM6,2020-12-31,2021-02-12,705260684,547818424,1253079108
10330,WHRL3,2010-12-31,2011-03-25,1028701,474085,1502786
10331,WHRL3,2011-03-31,2011-05-12,1028701,474085,1502786
10332,WHRL3,2011-06-30,2011-08-15,1028701,474085,1502786
10333,WHRL3,2011-09-30,2011-11-03,1028701,474085,1502786
10334,WHRL3,2011-12-31,2012-02-28,1028701,474085,1502786
10335,WHRL3,2012-03-31,2012-04-27,1028701,474085,1502786
10336,WHRL3,2012-06-30,2012-07-25,1028701,474085,1502786
10337,WHRL3,2012-09-30,2012-10-24,1028701,474085,1502786
10338,WHRL3,2012-12-31,2013-04-19,1028701,474085,1502786
10339,WHRL3,2013-03-31,2013-04-30,1028701,474085,1502786
10340,WHRL3,2013-06-30,2013-07-22,1028701,474085,1502786
10341,WHRL3,2013-09-30,2013-10-23,1028701,474085,1502786
10342,WHRL3,2013-12-31,2014-02-19,1028701,474085,1502786
10343,WHRL3,2014-03-31,2014-04-28,1028701,474085,1502786
10344,WHRL3,2014-06-30,2014-07-24,1028701,474085,1502786
10345,WHRL3,2014-09-30,2014-10-29,1028701,474085,1502786
10346,WHRL3,2014-12-31,2015-02-27,1028701,474085,1502786
10347,WHRL3,2015-03-31,2015-05-05,1028701,474085,1502786
10348,WHRL3,2015-06-30,2015-07-27,1028701,474085,1502786
10349,WHRL3,2015-09-30,2015-11-06,1028701,474085,1502786
10350,WHRL3,2015-12-31,2016-02-18,1028701,474085,1502786
10351,WHRL3,2016-03-31,2016-04-27,1028701,474085,1502786
10352,WHRL3,2016-06-30,2016-07-25,1028701,474085,1502786
10353,WHRL3,2016-09-30,2016-10-26,1028701,474085,1502786
10354,WHRL3,2016-12-31,2017-02-22,1028701,474085,1502786
10355,WHRL3,2017-03-31,2017-05-12,1028701,474085,1502786
10356,WHRL3,2017-06-30,2017-08-21,1028701,474085,1502786
10357,WHRL3,2017-09-30,2017-11-14,1028701,474085,1502786
10358,WHRL3,2017-12-31,2018-02-28,1028701,474085,1502786
10359,WHRL3,2018-03-31,2018-05-11,1028701,474085,1502786
10360,WHRL3,2018-06-30,2018-09-26,1028701,474085,1502786
10361,WHRL3,2018-09-30,2018-11-14,1028701,474085,1502786
10362,WHRL3,2018-12-31,2019-03-26,1028701,474085,1502786
10363,WHRL3,2019-03-31,2019-05-13,1028701,474085,1502786
10364,WHRL3,2019-06-30,2019-08-19,1028701,474085,1502786
10365,WHRL3,2019-09-30,2019-11-14,1028701,474084,1502785
10366,WHRL3,2019-12-31,2020-03-24,1028701,474084,1502785
10367,WHRL3,2020-03-31,2020-06-10,1028701,474084,1502785
10368,WHRL3,2020-06-30,2020-08-14,1028701,474084,1502785
10369,WHRL3,2020-09-30,2020-11-30,1028701,474085,1502786
10370,WHRL3,2020-12-31,2021-03-24,1028701,474085,1502786
10371,WHRL4,2010-12-31,2011-03-25,1028701,474085,1502786
10372,WHRL4,2011-03-31,2011-05-12,1028701,474085,1502786
10373,WHRL4,2011-06-30,2011-08-15,1028701,474085,1502786
10374,WHRL4,2011-09-30,2011-11-03,1028701,474085,1502786
10375,WHRL4,2011-12-31,2012-02-28,1028701,474085,1502786
10376,WHRL4,2012-03-31,2012-04-27,1028701,474085,1502786
10377,WHRL4,2012-06-30,2012-07-25,1028701,474085,1502786
10378,WHRL4,2012-09-30,2012-10-24,1028701,474085,1502786
10379,WHRL4,2012-12-31,2013-04-19,1028701,474085,1502786
10380,WHRL4,2013-03-31,2013-04-30,1028701,474085,1502786
10381,WHRL4,2013-06-30,2013-07-22,1028701,474085,1502786
10382,WHRL4,2013-09-30,2013-10-23,1028701,474085,1502786
10383,WHRL4,2013-12-31,2014-02-19,1028701,474085,1502786
10384,WHRL4,2014-03-31,2014-04-28,1028701,474085,1502786
10385,WHRL4,2014-06-30,2014-07-24,1028701,474085,1502786
10386,WHRL4,2014-09-30,2014-10-29,1028701,474085,1502786
10387,WHRL4,2014-12-31,2015-02-27,1028701,474085,1502786
10388,WHRL4,2015-03-31,2015-05-05,1028701,474085,1502786
10389,WHRL4,2015-06-30,2015-07-27,1028701,474085,1502786
10390,WHRL4,2015-09-30,2015-11-06,1028701,474085,1502786
10391,WHRL4,2015-12-31,2016-02-18,1028701,474085,1502786
10392,WHRL4,2016-03-31,2016-04-27,1028701,474085,1502786
10393,WHRL4,2016-06-30,2016-07-25,1028701,474085,1502786
10394,WHRL4,2016-09-30,2016-10-26,1028701,474085,1502786
10395,WHRL4,2016-12-31,2017-02-22,1028701,474085,1502786
10396,WHRL4,2017-03-31,2017-05-12,1028701,474085,1502786
10397,WHRL4,2017-06-30,2017-08-21,1028701,474085,1502786
10398,WHRL4,2017-09-30,2017-11-14,1028701,474085,1502786
10399,WHRL4,2017-12-31,2018-02-28,1028701,474085,1502786
10400,WHRL4,2018-03-31,2018-05-11,1028701,474085,1502786
10401,WHRL4,2018-06-30,2018-09-26,1028701,474085,1502786
10402,WHRL4,2018-09-30,2018-11-14,1028701,474085,1502786
10403,WHRL4,2018-12-31,2019-03-26,1028701,474085,1502786
10404,WHRL4,2019-03-31,2019-05-13,1028701,474085,1502786
10405,WHRL4,2019-06-30,2019-08-19,1028701,474085,1502786
10406,WHRL4,2019-09-30,2019-11-14,1028701,474084,1502785
10407,WHRL4,2019-12-31,2020-03-24,1028701,474084,1502785
10408,WHRL4,2020-03-31,2020-06-10,1028701,474084,1502785
10409,WHRL4,2020-06-30,2020-08-14,1028701,474084,1502785
10410,WHRL4,2020-09-30,2020-11-30,1028701,474085,1502786
10411,WHRL4,2020-12-31,2021-03-24,1028701,474085,1502786
10412,CEPE3,2010-12-31,2011-02-18,66303,8309,74612
10413,CEPE3,2011-03-31,2011-05-13,66303,8309,74612
10414,CEPE3,2011-06-30,2011-07-29,66303,8309,74612
10415,CEPE3,2011-09-30,2011-10-31,66303,8309,74612
10416,CEPE3,2011-12-31,2012-02-07,66303,8309,74612
10417,CEPE3,2012-03-31,2012-05-04,66303,8309,74612
10418,CEPE3,2012-06-30,2012-07-27,66303,8309,74612
10419,CEPE3,2012-09-30,2012-11-14,66303,8309,74612
10420,CEPE3,2012-12-31,2013-03-25,66303,8309,74612
10421,CEPE3,2013-03-31,2013-05-15,66303,8309,74612
10422,CEPE3,2013-06-30,2013-08-19,66303,8309,74612
10423,CEPE3,2013-09-30,2013-11-08,66303,8309,74612
10424,CEPE3,2013-12-31,2014-03-24,66303,8309,74612
10425,CEPE3,2014-03-31,2014-05-15,66303,8309,74612
10426,CEPE3,2014-06-30,2014-08-14,66303,8309,74612
10427,CEPE3,2014-09-30,2014-11-12,66303,8309,74612
10428,CEPE3,2014-12-31,2017-07-25,66303,8309,74612
10429,CEPE3,2015-03-31,2015-05-14,66303,8309,74612
10430,CEPE3,2015-06-30,2015-08-13,66303,8309,74612
10431,CEPE3,2015-09-30,2015-11-12,66303,8309,74612
10432,CEPE3,2015-12-31,2017-07-25,66303,8309,74612
10433,CEPE3,2016-03-31,2016-05-12,66303,8309,74612
10434,CEPE3,2016-06-30,2016-08-11,66303,8309,74612
10435,CEPE3,2016-09-30,2016-11-11,66303,8309,74612
10436,CEPE3,2016-12-31,2017-07-25,66303,8309,74612
10437,CEPE3,2017-03-31,2017-08-10,66303,8309,74612
10438,CEPE3,2017-06-30,2017-08-10,66303,8309,74612
10439,CEPE3,2017-09-30,2017-11-05,66303,8309,74612
10440,CEPE3,2017-12-31,2018-02-19,66303,8309,74612
10441,CEPE3,2018-03-31,2018-04-23,66303,8309,74612
10442,CEPE3,2018-06-30,2018-07-23,66303,8309,74612
10443,CEPE3,2018-09-30,2018-10-22,66303,8309,74612
10444,CEPE3,2018-12-31,2019-02-14,66303,8309,74612
10445,CEPE3,2019-03-31,2019-04-23,66303,8309,74612
10446,CEPE3,2019-06-30,2019-10-24,66303,8309,74612
10447,CEPE3,2019-09-30,2019-10-24,66303,8309,74612
10448,CEPE3,2019-12-31,2020-02-17,66303,8309,74612
10449,CEPE3,2020-03-31,2020-04-27,66303,8309,74612
10450,CEPE3,2020-06-30,2020-07-23,66303,8309,74612
10451,CEPE3,2020-09-30,2020-10-20,66303,8309,74612
10452,CEPE3,2020-12-31,2021-02-09,66303,8309,74612
10453,CEPE5,2010-12-31,2011-02-18,66303,8309,74612
10454,CEPE5,2011-03-31,2011-05-13,66303,8309,74612
10455,CEPE5,2011-06-30,2011-07-29,66303,8309,74612
10456,CEPE5,2011-09-30,2011-10-31,66303,8309,74612
10457,CEPE5,2011-12-31,2012-02-07,66303,8309,74612
10458,CEPE5,2012-03-31,2012-05-04,66303,8309,74612
10459,CEPE5,2012-06-30,2012-07-27,66303,8309,74612
10460,CEPE5,2012-09-30,2012-11-14,66303,8309,74612
10461,CEPE5,2012-12-31,2013-03-25,66303,8309,74612
10462,CEPE5,2013-03-31,2013-05-15,66303,8309,74612
10463,CEPE5,2013-06-30,2013-08-19,66303,8309,74612
10464,CEPE5,2013-09-30,2013-11-08,66303,8309,74612
10465,CEPE5,2013-12-31,2014-03-24,66303,8309,74612
10466,CEPE5,2014-03-31,2014-05-15,66303,8309,74612
10467,CEPE5,2014-06-30,2014-08-14,66303,8309,74612
10468,CEPE5,2014-09-30,2014-11-12,66303,8309,74612
10469,CEPE5,2014-12-31,2017-07-25,66303,8309,74612
10470,CEPE5,2015-03-31,2015-05-14,66303,8309,74612
10471,CEPE5,2015-06-30,2015-08-13,66303,8309,74612
10472,CEPE5,2015-09-30,2015-11-12,66303,8309,74612
10473,CEPE5,2015-12-31,2017-07-25,66303,8309,74612
10474,CEPE5,2016-03-31,2016-05-12,66303,8309,74612
10475,CEPE5,2016-06-30,2016-08-11,66303,8309,74612
10476,CEPE5,2016-09-30,2016-11-11,66303,8309,74612
10477,CEPE5,2016-12-31,2017-07-25,66303,8309,74612
10478,CEPE5,2017-03-31,2017-08-10,66303,8309,74612
10479,CEPE5,2017-06-30,2017-08-10,66303,8309,74612
10480,CEPE5,2017-09-30,2017-11-05,66303,8309,74612
10481,CEPE5,2017-12-31,2018-02-19,66303,8309,74612
10482,CEPE5,2018-03-31,2018-04-23,66303,8309,74612
10483,CEPE5,2018-06-30,2018-07-23,66303,8309,74612
10484,CEPE5,2018-09-30,2018-10-22,66303,8309,74612
10485,CEPE5,2018-12-31,2019-02-14,66303,8309,74612
10486,CEPE5,2019-03-31,2019-04-23,66303,8309,74612
10487,CEPE5,2019-06-30,2019-10-24,66303,8309,74612
10488,CEPE5,2019-09-30,2019-10-24,66303,8309,74612
10489,CEPE5,2019-12-31,2020-02-17,66303,8309,74612
10490,CEPE5,2020-03-31,2020-04-27,66303,8309,74612
10491,CEPE5,2020-06-30,2020-07-23,66303,8309,74612
10492,CEPE5,2020-09-30,2020-10-20,66303,8309,74612
10493,CEPE5,2020-12-31,2021-02-09,66303,8309,74612
10494,CEPE6,2010-12-31,2011-02-18,66303,8309,74612
10495,CEPE6,2011-03-31,2011-05-13,66303,8309,74612
10496,CEPE6,2011-06-30,2011-07-29,66303,8309,74612
10497,CEPE6,2011-09-30,2011-10-31,66303,8309,74612
10498,CEPE6,2011-12-31,2012-02-07,66303,8309,74612
10499,CEPE6,2012-03-31,2012-05-04,66303,8309,74612
10500,CEPE6,2012-06-30,2012-07-27,66303,8309,74612
10501,CEPE6,2012-09-30,2012-11-14,66303,8309,74612
10502,CEPE6,2012-12-31,2013-03-25,66303,8309,74612
10503,CEPE6,2013-03-31,2013-05-15,66303,8309,74612
10504,CEPE6,2013-06-30,2013-08-19,66303,8309,74612
10505,CEPE6,2013-09-30,2013-11-08,66303,8309,74612
10506,CEPE6,2013-12-31,2014-03-24,66303,8309,74612
10507,CEPE6,2014-03-31,2014-05-15,66303,8309,74612
10508,CEPE6,2014-06-30,2014-08-14,66303,8309,74612
10509,CEPE6,2014-09-30,2014-11-12,66303,8309,74612
10510,CEPE6,2014-12-31,2017-07-25,66303,8309,74612
10511,CEPE6,2015-03-31,2015-05-14,66303,8309,74612
10512,CEPE6,2015-06-30,2015-08-13,66303,8309,74612
10513,CEPE6,2015-09-30,2015-11-12,66303,8309,74612
10514,CEPE6,2015-12-31,2017-07-25,66303,8309,74612
10515,CEPE6,2016-03-31,2016-05-12,66303,8309,74612
10516,CEPE6,2016-06-30,2016-08-11,66303,8309,74612
10517,CEPE6,2016-09-30,2016-11-11,66303,8309,74612
10518,CEPE6,2016-12-31,2017-07-25,66303,8309,74612
10519,CEPE6,2017-03-31,2017-08-10,66303,8309,74612
10520,CEPE6,2017-06-30,2017-08-10,66303,8309,74612
10521,CEPE6,2017-09-30,2017-11-05,66303,8309,74612
10522,CEPE6,2017-12-31,2018-02-19,66303,8309,74612
10523,CEPE6,2018-03-31,2018-04-23,66303,8309,74612
10524,CEPE6,2018-06-30,2018-07-23,66303,8309,74612
10525,CEPE6,2018-09-30,2018-10-22,66303,8309,74612
10526,CEPE6,2018-12-31,2019-02-14,66303,8309,74612
10527,CEPE6,2019-03-31,2019-04-23,66303,8309,74612
10528,CEPE6,2019-06-30,2019-10-24,66303,8309,74612
10529,CEPE6,2019-09-30,2019-10-24,66303,8309,74612
10530,CEPE6,2019-12-31,2020-02-17,66303,8309,74612
10531,CEPE6,2020-03-31,2020-04-27,66303,8309,74612
10532,CEPE6,2020-06-30,2020-07-23,66303,8309,74612
10533,CEPE6,2020-09-30,2020-10-20,66303,8309,74612
10534,CEPE6,2020-12-31,2021-02-09,66303,8309,74612
10535,SBSP3,2010-12-31,2011-03-29,227836,0,227836
10536,SBSP3,2011-03-31,2011-05-13,227836623,0,227836623
10537,SBSP3,2011-06-30,2011-08-11,227836623,0,227836623
10538,SBSP3,2011-09-30,2011-11-10,227836623,0,227836623
10539,SBSP3,2011-12-31,2012-03-23,227836,0,227836
10540,SBSP3,2012-03-31,2012-05-10,227836623,0,227836623
10541,SBSP3,2012-06-30,2012-08-10,227836623,0,227836623
10542,SBSP3,2012-09-30,2012-11-14,227836623,0,227836623
10543,SBSP3,2012-12-31,2013-03-25,227836623,0,227836623
10544,SBSP3,2013-03-31,2013-05-09,683509869,0,683509869
10545,SBSP3,2013-06-30,2013-08-13,683509869,0,683509869
10546,SBSP3,2013-09-30,2013-11-14,683509869,0,683509869
10547,SBSP3,2013-12-31,2014-03-28,683509869,0,683509869
10548,SBSP3,2014-03-31,2014-05-15,683509869,0,683509869
10549,SBSP3,2014-06-30,2014-08-14,683509869,0,683509869
10550,SBSP3,2014-09-30,2014-11-13,683509869,0,683509869
10551,SBSP3,2014-12-31,2015-03-26,683509869,0,683509869
10552,SBSP3,2015-03-31,2015-05-14,683509869,0,683509869
10553,SBSP3,2015-06-30,2015-08-13,683509869,0,683509869
10554,SBSP3,2015-09-30,2015-11-12,683509869,0,683509869
10555,SBSP3,2015-12-31,2016-03-25,683509869,0,683509869
10556,SBSP3,2016-03-31,2016-05-12,683509869,0,683509869
10557,SBSP3,2016-06-30,2016-08-12,683509869,0,683509869
10558,SBSP3,2016-09-30,2016-11-10,683509869,0,683509869
10559,SBSP3,2016-12-31,2017-03-27,683509869,0,683509869
10560,SBSP3,2017-03-31,2017-05-12,683509869,0,683509869
10561,SBSP3,2017-06-30,2017-08-14,683509869,0,683509869
10562,SBSP3,2017-09-30,2017-11-14,683509869,0,683509869
10563,SBSP3,2017-12-31,2018-03-27,683509869,0,683509869
10564,SBSP3,2018-03-31,2018-05-10,683509869,0,683509869
10565,SBSP3,2018-06-30,2018-08-09,683509869,0,683509869
10566,SBSP3,2018-09-30,2018-11-08,683509869,0,683509869
10567,SBSP3,2018-12-31,2019-03-28,683509869,0,683509869
10568,SBSP3,2019-03-31,2019-05-09,683509869,0,683509869
10569,SBSP3,2019-06-30,2019-08-14,683509869,0,683509869
10570,SBSP3,2019-09-30,2019-11-14,683509869,0,683509869
10571,SBSP3,2019-12-31,2020-03-27,683509869,0,683509869
10572,SBSP3,2020-03-31,2020-05-14,683509869,0,683509869
10573,SBSP3,2020-06-30,2020-08-13,683509869,0,683509869
10574,SBSP3,2020-09-30,2020-11-12,683509869,0,683509869
10575,SBSP3,2020-12-31,2021-03-25,683509869,0,683509869
10576,CEBR3,2010-12-31,2011-07-18,4576,4607,9183
10577,CEBR3,2011-03-31,2012-02-23,4576,4607,9183
10578,CEBR3,2011-06-30,2012-02-23,4576,4607,9183
10579,CEBR3,2011-09-30,2012-02-23,4576,4607,9183
10580,CEBR3,2011-12-31,2012-04-09,4576432,4607026,9183458
10581,CEBR3,2012-03-31,2012-05-15,4576432,4607026,9183458
10582,CEBR3,2012-06-30,2012-08-14,4576432,4607026,9183458
10583,CEBR3,2012-09-30,2012-11-14,4576432,4607026,9183458
10584,CEBR3,2012-12-31,2013-03-28,4576432,4607026,9183458
10585,CEBR3,2013-03-31,2013-05-17,4576432,4607026,9183458
10586,CEBR3,2013-06-30,2013-08-30,4576432,4607026,9183458
10587,CEBR3,2013-09-30,2013-11-21,4576432,4607026,9183458
10588,CEBR3,2013-12-31,2014-04-25,4576432,4607026,9183458
10589,CEBR3,2014-03-31,2014-08-08,4576432,4607026,9183458
10590,CEBR3,2014-06-30,2014-08-14,4576432,4607026,9183458
10591,CEBR3,2014-09-30,2014-11-12,4576432,4607026,9183458
10592,CEBR3,2014-12-31,2015-03-27,4576432,4607026,9183458
10593,CEBR3,2015-03-31,2015-05-14,4576432,4607026,9183458
10594,CEBR3,2015-06-30,2015-08-14,4576432,4607026,9183458
10595,CEBR3,2015-09-30,2015-11-17,7184178,7232205,14416383
10596,CEBR3,2015-12-31,2016-03-30,7184187,7232196,14416383
10597,CEBR3,2016-03-31,2016-05-15,7184187,7232196,14416383
10598,CEBR3,2016-06-30,2016-08-15,7184187,7232196,14416383
10599,CEBR3,2016-09-30,2016-11-14,7184178,7232205,14416383
10600,CEBR3,2016-12-31,2017-03-28,7184178,7232205,14416383
10601,CEBR3,2017-03-31,2017-05-15,7184178,7232205,14416383
10602,CEBR3,2017-06-30,2017-08-14,7184187,7232196,14416383
10603,CEBR3,2017-09-30,2017-11-14,7184187,7232196,14416383
10604,CEBR3,2017-12-31,2018-03-29,7184178,7232205,14416383
10605,CEBR3,2018-03-31,2018-05-15,7184178,7232205,14416383
10606,CEBR3,2018-06-30,2018-08-16,7184178,7232205,14416383
10607,CEBR3,2018-09-30,2018-11-14,7184178,7232205,14416383
10608,CEBR3,2018-12-31,2019-03-29,7184178,7232205,14416383
10609,CEBR3,2019-03-31,2019-08-15,7184178,7232205,14416383
10610,CEBR3,2019-06-30,2019-08-14,7184178,7232205,14416383
10611,CEBR3,2019-09-30,2019-11-14,7184178,7232205,14416383
10612,CEBR3,2019-12-31,2020-03-26,7184178,7232205,14416383
10613,CEBR3,2020-03-31,2020-05-29,7184178,7232205,14416383
10614,CEBR3,2020-06-30,2020-08-28,7184178,7232205,14416383
10615,CEBR3,2020-09-30,2020-11-13,7184178,7232205,14416383
10616,CEBR5,2010-12-31,2011-07-18,4576,4607,9183
10617,CEBR5,2011-03-31,2012-02-23,4576,4607,9183
10618,CEBR5,2011-06-30,2012-02-23,4576,4607,9183
10619,CEBR5,2011-09-30,2012-02-23,4576,4607,9183
10620,CEBR5,2011-12-31,2012-04-09,4576432,4607026,9183458
10621,CEBR5,2012-03-31,2012-05-15,4576432,4607026,9183458
10622,CEBR5,2012-06-30,2012-08-14,4576432,4607026,9183458
10623,CEBR5,2012-09-30,2012-11-14,4576432,4607026,9183458
10624,CEBR5,2012-12-31,2013-03-28,4576432,4607026,9183458
10625,CEBR5,2013-03-31,2013-05-17,4576432,4607026,9183458
10626,CEBR5,2013-06-30,2013-08-30,4576432,4607026,9183458
10627,CEBR5,2013-09-30,2013-11-21,4576432,4607026,9183458
10628,CEBR5,2013-12-31,2014-04-25,4576432,4607026,9183458
10629,CEBR5,2014-03-31,2014-08-08,4576432,4607026,9183458
10630,CEBR5,2014-06-30,2014-08-14,4576432,4607026,9183458
10631,CEBR5,2014-09-30,2014-11-12,4576432,4607026,9183458
10632,CEBR5,2014-12-31,2015-03-27,4576432,4607026,9183458
10633,CEBR5,2015-03-31,2015-05-14,4576432,4607026,9183458
10634,CEBR5,2015-06-30,2015-08-14,4576432,4607026,9183458
10635,CEBR5,2015-09-30,2015-11-17,7184178,7232205,14416383
10636,CEBR5,2015-12-31,2016-03-30,7184187,7232196,14416383
10637,CEBR5,2016-03-31,2016-05-15,7184187,7232196,14416383
10638,CEBR5,2016-06-30,2016-08-15,7184187,7232196,14416383
10639,CEBR5,2016-09-30,2016-11-14,7184178,7232205,14416383
10640,CEBR5,2016-12-31,2017-03-28,7184178,7232205,14416383
10641,CEBR5,2017-03-31,2017-05-15,7184178,7232205,14416383
10642,CEBR5,2017-06-30,2017-08-14,7184187,7232196,14416383
10643,CEBR5,2017-09-30,2017-11-14,7184187,7232196,14416383
10644,CEBR5,2017-12-31,2018-03-29,7184178,7232205,14416383
10645,CEBR5,2018-03-31,2018-05-15,7184178,7232205,14416383
10646,CEBR5,2018-06-30,2018-08-16,7184178,7232205,14416383
10647,CEBR5,2018-09-30,2018-11-14,7184178,7232205,14416383
10648,CEBR5,2018-12-31,2019-03-29,7184178,7232205,14416383
10649,CEBR5,2019-03-31,2019-08-15,7184178,7232205,14416383
10650,CEBR5,2019-06-30,2019-08-14,7184178,7232205,14416383
10651,CEBR5,2019-09-30,2019-11-14,7184178,7232205,14416383
10652,CEBR5,2019-12-31,2020-03-26,7184178,7232205,14416383
10653,CEBR5,2020-03-31,2020-05-29,7184178,7232205,14416383
10654,CEBR5,2020-06-30,2020-08-28,7184178,7232205,14416383
10655,CEBR5,2020-09-30,2020-11-13,7184178,7232205,14416383
10656,CEBR6,2010-12-31,2011-07-18,4576,4607,9183
10657,CEBR6,2011-03-31,2012-02-23,4576,4607,9183
10658,CEBR6,2011-06-30,2012-02-23,4576,4607,9183
10659,CEBR6,2011-09-30,2012-02-23,4576,4607,9183
10660,CEBR6,2011-12-31,2012-04-09,4576432,4607026,9183458
10661,CEBR6,2012-03-31,2012-05-15,4576432,4607026,9183458
10662,CEBR6,2012-06-30,2012-08-14,4576432,4607026,9183458
10663,CEBR6,2012-09-30,2012-11-14,4576432,4607026,9183458
10664,CEBR6,2012-12-31,2013-03-28,4576432,4607026,9183458
10665,CEBR6,2013-03-31,2013-05-17,4576432,4607026,9183458
10666,CEBR6,2013-06-30,2013-08-30,4576432,4607026,9183458
10667,CEBR6,2013-09-30,2013-11-21,4576432,4607026,9183458
10668,CEBR6,2013-12-31,2014-04-25,4576432,4607026,9183458
10669,CEBR6,2014-03-31,2014-08-08,4576432,4607026,9183458
10670,CEBR6,2014-06-30,2014-08-14,4576432,4607026,9183458
10671,CEBR6,2014-09-30,2014-11-12,4576432,4607026,9183458
10672,CEBR6,2014-12-31,2015-03-27,4576432,4607026,9183458
10673,CEBR6,2015-03-31,2015-05-14,4576432,4607026,9183458
10674,CEBR6,2015-06-30,2015-08-14,4576432,4607026,9183458
10675,CEBR6,2015-09-30,2015-11-17,7184178,7232205,14416383
10676,CEBR6,2015-12-31,2016-03-30,7184187,7232196,14416383
10677,CEBR6,2016-03-31,2016-05-15,7184187,7232196,14416383
10678,CEBR6,2016-06-30,2016-08-15,7184187,7232196,14416383
10679,CEBR6,2016-09-30,2016-11-14,7184178,7232205,14416383
10680,CEBR6,2016-12-31,2017-03-28,7184178,7232205,14416383
10681,CEBR6,2017-03-31,2017-05-15,7184178,7232205,14416383
10682,CEBR6,2017-06-30,2017-08-14,7184187,7232196,14416383
10683,CEBR6,2017-09-30,2017-11-14,7184187,7232196,14416383
10684,CEBR6,2017-12-31,2018-03-29,7184178,7232205,14416383
10685,CEBR6,2018-03-31,2018-05-15,7184178,7232205,14416383
10686,CEBR6,2018-06-30,2018-08-16,7184178,7232205,14416383
10687,CEBR6,2018-09-30,2018-11-14,7184178,7232205,14416383
10688,CEBR6,2018-12-31,2019-03-29,7184178,7232205,14416383
10689,CEBR6,2019-03-31,2019-08-15,7184178,7232205,14416383
10690,CEBR6,2019-06-30,2019-08-14,7184178,7232205,14416383
10691,CEBR6,2019-09-30,2019-11-14,7184178,7232205,14416383
10692,CEBR6,2019-12-31,2020-03-26,7184178,7232205,14416383
10693,CEBR6,2020-03-31,2020-05-29,7184178,7232205,14416383
10694,CEBR6,2020-06-30,2020-08-28,7184178,7232205,14416383
10695,CEBR6,2020-09-30,2020-11-13,7184178,7232205,14416383
10696,CYRE3,2010-12-31,2011-03-29,423004,0,423004
10697,CYRE3,2011-03-31,2011-05-13,423004,0,423004
10698,CYRE3,2011-06-30,2011-08-11,423004,0,423004
10699,CYRE3,2011-09-30,2011-11-09,423004,0,423004
10700,CYRE3,2011-12-31,2012-03-26,423004,0,423004
10701,CYRE3,2012-03-31,2012-05-14,423004,0,423004
10702,CYRE3,2012-06-30,2012-08-13,416659,0,416659
10703,CYRE3,2012-09-30,2012-11-13,416659,0,416659
10704,CYRE3,2012-12-31,2013-03-21,416659,0,416659
10705,CYRE3,2013-03-31,2013-05-13,416659,0,416659
10706,CYRE3,2013-06-30,2013-08-14,416659,0,416659
10707,CYRE3,2013-09-30,2013-11-13,416659,0,416659
10708,CYRE3,2013-12-31,2014-03-20,416659,0,416659
10709,CYRE3,2014-03-31,2014-05-14,416859,0,416859
10710,CYRE3,2014-06-30,2014-08-14,399743,0,399743
10711,CYRE3,2014-09-30,2014-11-13,399743,0,399743
10712,CYRE3,2014-12-31,2015-03-19,399743,0,399743
10713,CYRE3,2015-03-31,2015-05-14,399743,0,399743
10714,CYRE3,2015-06-30,2015-08-13,399743,0,399743
10715,CYRE3,2015-09-30,2015-11-12,399743,0,399743
10716,CYRE3,2015-12-31,2016-03-23,399743,0,399743
10717,CYRE3,2016-03-31,2016-05-12,399743,0,399743
10718,CYRE3,2016-06-30,2016-08-09,399743,0,399743
10719,CYRE3,2016-09-30,2016-11-10,399743,0,399743
10720,CYRE3,2016-12-31,2017-03-23,399743,0,399743
10721,CYRE3,2017-03-31,2017-05-11,399743,0,399743
10722,CYRE3,2017-06-30,2017-08-10,399743,0,399743
10723,CYRE3,2017-09-30,2017-11-10,399743,0,399743
10724,CYRE3,2017-12-31,2018-03-22,399743,0,399743
10725,CYRE3,2018-03-31,2018-05-10,399743,0,399743
10726,CYRE3,2018-06-30,2018-08-10,399743,0,399743
10727,CYRE3,2018-09-30,2018-11-08,399743,0,399743
10728,CYRE3,2018-12-31,2019-03-27,399815,0,399815
10729,CYRE3,2019-03-31,2019-05-09,399743,0,399743
10730,CYRE3,2019-06-30,2019-08-08,399743,0,399743
10731,CYRE3,2019-09-30,2019-11-07,399743,0,399743
10732,CYRE3,2019-12-31,2020-03-19,399743,0,399743
10733,CYRE3,2020-03-31,2020-05-14,399743,0,399743
10734,CYRE3,2020-06-30,2020-08-13,399743,0,399743
10735,CYRE3,2020-09-30,2020-11-12,399743,0,399743
10736,CYRE3,2020-12-31,2021-03-18,399743,0,399743
10737,CEEB3,2010-12-31,2011-02-18,109304,78873,188177
10738,CEEB3,2011-03-31,2011-05-13,109304,78873,188177
10739,CEEB3,2011-06-30,2011-07-29,109304,78873,188177
10740,CEEB3,2011-09-30,2011-10-31,109304,78873,188177
10741,CEEB3,2011-12-31,2012-04-11,109304,78873,188177
10742,CEEB3,2012-03-31,2012-05-04,109304,78873,188177
10743,CEEB3,2012-06-30,2012-07-27,109304,78873,188177
10744,CEEB3,2012-09-30,2012-12-21,109304,78873,188177
10745,CEEB3,2012-12-31,2013-03-25,109304,78873,188177
10746,CEEB3,2013-03-31,2013-05-15,109304,78873,188177
10747,CEEB3,2013-06-30,2013-08-19,109304,78873,188177
10748,CEEB3,2013-09-30,2013-11-08,109304,78873,188177
10749,CEEB3,2013-12-31,2014-03-24,109304,78873,188177
10750,CEEB3,2014-03-31,2014-05-15,109304,78873,188177
10751,CEEB3,2014-06-30,2014-08-14,109304,78873,188177
10752,CEEB3,2014-09-30,2014-11-12,109304,78873,188177
10753,CEEB3,2014-12-31,2017-07-25,109304,78873,188177
10754,CEEB3,2015-03-31,2015-05-14,109304,78873,188177
10755,CEEB3,2015-06-30,2015-08-13,109304,78873,188177
10756,CEEB3,2015-09-30,2015-11-12,109304,78873,188177
10757,CEEB3,2015-12-31,2017-07-25,109304,78873,188177
10758,CEEB3,2016-03-31,2016-05-13,109304,78873,188177
10759,CEEB3,2016-06-30,2016-08-11,109304,78873,188177
10760,CEEB3,2016-09-30,2016-11-10,109304,78873,188177
10761,CEEB3,2016-12-31,2017-07-25,109304,78873,188177
10762,CEEB3,2017-03-31,2017-08-10,109304,78873,188177
10763,CEEB3,2017-06-30,2017-08-10,109304,78873,188177
10764,CEEB3,2017-09-30,2017-11-05,109304,78873,188177
10765,CEEB3,2017-12-31,2018-02-19,118498,85512,204010
10766,CEEB3,2018-03-31,2018-04-23,135762,98178,233940
10767,CEEB3,2018-06-30,2018-07-23,135762,98178,233940
10768,CEEB3,2018-09-30,2018-10-22,151997,110098,262095
10769,CEEB3,2018-12-31,2019-02-14,151997,110098,262095
10770,CEEB3,2019-03-31,2019-04-23,151997,110098,262095
10771,CEEB3,2019-06-30,2019-10-24,151997,110098,262095
10772,CEEB3,2019-09-30,2019-10-24,151997,110098,262095
10773,CEEB3,2019-12-31,2020-02-17,151997,110098,262095
10774,CEEB3,2020-03-31,2020-04-27,151997,110098,262095
10775,CEEB3,2020-06-30,2020-07-23,151997,110098,262095
10776,CEEB3,2020-09-30,2020-10-20,151997,110098,262095
10777,CEEB3,2020-12-31,2021-02-09,151998,110098,262096
10778,CEEB5,2010-12-31,2011-02-18,109304,78873,188177
10779,CEEB5,2011-03-31,2011-05-13,109304,78873,188177
10780,CEEB5,2011-06-30,2011-07-29,109304,78873,188177
10781,CEEB5,2011-09-30,2011-10-31,109304,78873,188177
10782,CEEB5,2011-12-31,2012-04-11,109304,78873,188177
10783,CEEB5,2012-03-31,2012-05-04,109304,78873,188177
10784,CEEB5,2012-06-30,2012-07-27,109304,78873,188177
10785,CEEB5,2012-09-30,2012-12-21,109304,78873,188177
10786,CEEB5,2012-12-31,2013-03-25,109304,78873,188177
10787,CEEB5,2013-03-31,2013-05-15,109304,78873,188177
10788,CEEB5,2013-06-30,2013-08-19,109304,78873,188177
10789,CEEB5,2013-09-30,2013-11-08,109304,78873,188177
10790,CEEB5,2013-12-31,2014-03-24,109304,78873,188177
10791,CEEB5,2014-03-31,2014-05-15,109304,78873,188177
10792,CEEB5,2014-06-30,2014-08-14,109304,78873,188177
10793,CEEB5,2014-09-30,2014-11-12,109304,78873,188177
10794,CEEB5,2014-12-31,2017-07-25,109304,78873,188177
10795,CEEB5,2015-03-31,2015-05-14,109304,78873,188177
10796,CEEB5,2015-06-30,2015-08-13,109304,78873,188177
10797,CEEB5,2015-09-30,2015-11-12,109304,78873,188177
10798,CEEB5,2015-12-31,2017-07-25,109304,78873,188177
10799,CEEB5,2016-03-31,2016-05-13,109304,78873,188177
10800,CEEB5,2016-06-30,2016-08-11,109304,78873,188177
10801,CEEB5,2016-09-30,2016-11-10,109304,78873,188177
10802,CEEB5,2016-12-31,2017-07-25,109304,78873,188177
10803,CEEB5,2017-03-31,2017-08-10,109304,78873,188177
10804,CEEB5,2017-06-30,2017-08-10,109304,78873,188177
10805,CEEB5,2017-09-30,2017-11-05,109304,78873,188177
10806,CEEB5,2017-12-31,2018-02-19,118498,85512,204010
10807,CEEB5,2018-03-31,2018-04-23,135762,98178,233940
10808,CEEB5,2018-06-30,2018-07-23,135762,98178,233940
10809,CEEB5,2018-09-30,2018-10-22,151997,110098,262095
10810,CEEB5,2018-12-31,2019-02-14,151997,110098,262095
10811,CEEB5,2019-03-31,2019-04-23,151997,110098,262095
10812,CEEB5,2019-06-30,2019-10-24,151997,110098,262095
10813,CEEB5,2019-09-30,2019-10-24,151997,110098,262095
10814,CEEB5,2019-12-31,2020-02-17,151997,110098,262095
10815,CEEB5,2020-03-31,2020-04-27,151997,110098,262095
10816,CEEB5,2020-06-30,2020-07-23,151997,110098,262095
10817,CEEB5,2020-09-30,2020-10-20,151997,110098,262095
10818,CEEB5,2020-12-31,2021-02-09,151998,110098,262096
10819,CEEB6,2010-12-31,2011-02-18,109304,78873,188177
10820,CEEB6,2011-03-31,2011-05-13,109304,78873,188177
10821,CEEB6,2011-06-30,2011-07-29,109304,78873,188177
10822,CEEB6,2011-09-30,2011-10-31,109304,78873,188177
10823,CEEB6,2011-12-31,2012-04-11,109304,78873,188177
10824,CEEB6,2012-03-31,2012-05-04,109304,78873,188177
10825,CEEB6,2012-06-30,2012-07-27,109304,78873,188177
10826,CEEB6,2012-09-30,2012-12-21,109304,78873,188177
10827,CEEB6,2012-12-31,2013-03-25,109304,78873,188177
10828,CEEB6,2013-03-31,2013-05-15,109304,78873,188177
10829,CEEB6,2013-06-30,2013-08-19,109304,78873,188177
10830,CEEB6,2013-09-30,2013-11-08,109304,78873,188177
10831,CEEB6,2013-12-31,2014-03-24,109304,78873,188177
10832,CEEB6,2014-03-31,2014-05-15,109304,78873,188177
10833,CEEB6,2014-06-30,2014-08-14,109304,78873,188177
10834,CEEB6,2014-09-30,2014-11-12,109304,78873,188177
10835,CEEB6,2014-12-31,2017-07-25,109304,78873,188177
10836,CEEB6,2015-03-31,2015-05-14,109304,78873,188177
10837,CEEB6,2015-06-30,2015-08-13,109304,78873,188177
10838,CEEB6,2015-09-30,2015-11-12,109304,78873,188177
10839,CEEB6,2015-12-31,2017-07-25,109304,78873,188177
10840,CEEB6,2016-03-31,2016-05-13,109304,78873,188177
10841,CEEB6,2016-06-30,2016-08-11,109304,78873,188177
10842,CEEB6,2016-09-30,2016-11-10,109304,78873,188177
10843,CEEB6,2016-12-31,2017-07-25,109304,78873,188177
10844,CEEB6,2017-03-31,2017-08-10,109304,78873,188177
10845,CEEB6,2017-06-30,2017-08-10,109304,78873,188177
10846,CEEB6,2017-09-30,2017-11-05,109304,78873,188177
10847,CEEB6,2017-12-31,2018-02-19,118498,85512,204010
10848,CEEB6,2018-03-31,2018-04-23,135762,98178,233940
10849,CEEB6,2018-06-30,2018-07-23,135762,98178,233940
10850,CEEB6,2018-09-30,2018-10-22,151997,110098,262095
10851,CEEB6,2018-12-31,2019-02-14,151997,110098,262095
10852,CEEB6,2019-03-31,2019-04-23,151997,110098,262095
10853,CEEB6,2019-06-30,2019-10-24,151997,110098,262095
10854,CEEB6,2019-09-30,2019-10-24,151997,110098,262095
10855,CEEB6,2019-12-31,2020-02-17,151997,110098,262095
10856,CEEB6,2020-03-31,2020-04-27,151997,110098,262095
10857,CEEB6,2020-06-30,2020-07-23,151997,110098,262095
10858,CEEB6,2020-09-30,2020-10-20,151997,110098,262095
10859,CEEB6,2020-12-31,2021-02-09,151998,110098,262096
10860,ENMT3,2010-12-31,2011-03-16,41018,77835,118853
10861,ENMT3,2011-03-31,2011-05-20,41018,77835,118853
10862,ENMT3,2011-06-30,2011-08-15,41018,77835,118853
10863,ENMT3,2011-09-30,2011-11-10,41018,77835,118853
10864,ENMT3,2011-12-31,2012-03-30,41018,77835,118853
10865,ENMT3,2012-03-31,2012-05-15,41018,77835,118853
10866,ENMT3,2012-06-30,2012-08-11,41018,77835,118853
10867,ENMT3,2012-09-30,2012-11-14,41018,77835,118853
10868,ENMT3,2012-12-31,2013-03-27,41018,77835,118853
10869,ENMT3,2013-03-31,2013-05-17,41018,77835,118853
10870,ENMT3,2013-06-30,2013-08-23,41018,77835,118853
10871,ENMT3,2013-09-30,2013-11-06,41018,77835,118853
10872,ENMT3,2013-12-31,2014-02-10,41018,77835,118853
10873,ENMT3,2014-03-31,2014-05-14,41018,77835,118853
10874,ENMT3,2014-06-30,2014-08-29,58782,111546,170328
10875,ENMT3,2014-09-30,2014-11-14,58782,111546,170328
10876,ENMT3,2014-12-31,2015-04-01,58782,111546,170328
10877,ENMT3,2015-03-31,2015-05-15,58782,111546,170328
10878,ENMT3,2015-06-30,2015-08-14,58782,111546,170328
10879,ENMT3,2015-09-30,2015-11-16,58782,111546,170328
10880,ENMT3,2015-12-31,2016-03-22,58782489,111546028,170328517
10881,ENMT3,2016-03-31,2016-05-13,58782489,111546028,170328517
10882,ENMT3,2016-06-30,2016-08-12,58782,111546,170328
10883,ENMT3,2016-09-30,2016-11-11,58782489,111546028,170328517
10884,ENMT3,2016-12-31,2017-03-23,73478111,139432535,212910646
10885,ENMT3,2017-03-31,2017-05-11,73478111,139432535,212910646
10886,ENMT3,2017-06-30,2017-08-09,73478111,139432535,212910646
10887,ENMT3,2017-09-30,2017-11-14,73478111,139432535,212910646
10888,ENMT3,2017-12-31,2018-03-14,73478111,139432535,212910646
10889,ENMT3,2018-03-31,2018-05-10,73478111,139432535,212910646
10890,ENMT3,2018-06-30,2018-08-08,73478111,139432535,212910646
10891,ENMT3,2018-09-30,2018-11-08,73478111,139432535,212910646
10892,ENMT3,2018-12-31,2019-03-19,73478111,139432535,212910646
10893,ENMT3,2019-03-31,2019-05-09,73478111,139432535,212910646
10894,ENMT3,2019-06-30,2019-08-08,73478111,139432535,212910646
10895,ENMT3,2019-09-30,2019-11-07,73478111,139432535,212910646
10896,ENMT3,2019-12-31,2020-03-12,73478111,139432535,212910646
10897,ENMT3,2020-03-31,2020-05-20,73478111,139432535,212910646
10898,ENMT3,2020-06-30,2020-08-13,75529774,143412165,218941939
10899,ENMT3,2020-09-30,2020-11-12,75529774,143412165,218941939
10900,ENMT3,2020-12-31,2021-03-11,75529774,143412165,218941939
10901,ENMT4,2010-12-31,2011-03-16,41018,77835,118853
10902,ENMT4,2011-03-31,2011-05-20,41018,77835,118853
10903,ENMT4,2011-06-30,2011-08-15,41018,77835,118853
10904,ENMT4,2011-09-30,2011-11-10,41018,77835,118853
10905,ENMT4,2011-12-31,2012-03-30,41018,77835,118853
10906,ENMT4,2012-03-31,2012-05-15,41018,77835,118853
10907,ENMT4,2012-06-30,2012-08-11,41018,77835,118853
10908,ENMT4,2012-09-30,2012-11-14,41018,77835,118853
10909,ENMT4,2012-12-31,2013-03-27,41018,77835,118853
10910,ENMT4,2013-03-31,2013-05-17,41018,77835,118853
10911,ENMT4,2013-06-30,2013-08-23,41018,77835,118853
10912,ENMT4,2013-09-30,2013-11-06,41018,77835,118853
10913,ENMT4,2013-12-31,2014-02-10,41018,77835,118853
10914,ENMT4,2014-03-31,2014-05-14,41018,77835,118853
10915,ENMT4,2014-06-30,2014-08-29,58782,111546,170328
10916,ENMT4,2014-09-30,2014-11-14,58782,111546,170328
10917,ENMT4,2014-12-31,2015-04-01,58782,111546,170328
10918,ENMT4,2015-03-31,2015-05-15,58782,111546,170328
10919,ENMT4,2015-06-30,2015-08-14,58782,111546,170328
10920,ENMT4,2015-09-30,2015-11-16,58782,111546,170328
10921,ENMT4,2015-12-31,2016-03-22,58782489,111546028,170328517
10922,ENMT4,2016-03-31,2016-05-13,58782489,111546028,170328517
10923,ENMT4,2016-06-30,2016-08-12,58782,111546,170328
10924,ENMT4,2016-09-30,2016-11-11,58782489,111546028,170328517
10925,ENMT4,2016-12-31,2017-03-23,73478111,139432535,212910646
10926,ENMT4,2017-03-31,2017-05-11,73478111,139432535,212910646
10927,ENMT4,2017-06-30,2017-08-09,73478111,139432535,212910646
10928,ENMT4,2017-09-30,2017-11-14,73478111,139432535,212910646
10929,ENMT4,2017-12-31,2018-03-14,73478111,139432535,212910646
10930,ENMT4,2018-03-31,2018-05-10,73478111,139432535,212910646
10931,ENMT4,2018-06-30,2018-08-08,73478111,139432535,212910646
10932,ENMT4,2018-09-30,2018-11-08,73478111,139432535,212910646
10933,ENMT4,2018-12-31,2019-03-19,73478111,139432535,212910646
10934,ENMT4,2019-03-31,2019-05-09,73478111,139432535,212910646
10935,ENMT4,2019-06-30,2019-08-08,73478111,139432535,212910646
10936,ENMT4,2019-09-30,2019-11-07,73478111,139432535,212910646
10937,ENMT4,2019-12-31,2020-03-12,73478111,139432535,212910646
10938,ENMT4,2020-03-31,2020-05-20,73478111,139432535,212910646
10939,ENMT4,2020-06-30,2020-08-13,75529774,143412165,218941939
10940,ENMT4,2020-09-30,2020-11-12,75529774,143412165,218941939
10941,ENMT4,2020-12-31,2021-03-11,75529774,143412165,218941939
10942,SHUL3,2010-12-31,2011-12-05,27267,36550,63817
10943,SHUL3,2011-03-31,2011-05-12,27267,36550,63817
10944,SHUL3,2011-06-30,2011-08-01,27267,36550,63817
10945,SHUL3,2011-09-30,2011-11-11,27267,36550,63817
10946,SHUL3,2011-12-31,2012-03-14,27266565,36550360,63816925
10947,SHUL3,2012-03-31,2012-05-15,27266565,36550360,63816925
10948,SHUL3,2012-06-30,2012-08-15,27266565,36550360,63816925
10949,SHUL3,2012-09-30,2012-11-29,27266565,36550360,63816925
10950,SHUL3,2012-12-31,2013-02-27,27266565,36550360,63816925
10951,SHUL3,2013-03-31,2013-05-15,27266565,36550360,63816925
10952,SHUL3,2013-06-30,2013-08-06,27266565,36550360,63816925
10953,SHUL3,2013-09-30,2013-11-07,27266565,36550360,63816925
10954,SHUL3,2013-12-31,2014-02-26,27266565,36550360,63816925
10955,SHUL3,2014-03-31,2014-05-07,27266565,36550360,63816925
10956,SHUL3,2014-06-30,2014-08-08,27266565,36550360,63816925
10957,SHUL3,2014-09-30,2014-11-14,27266565,36550360,63816925
10958,SHUL3,2014-12-31,2015-03-16,27266565,36550360,63816925
10959,SHUL3,2015-03-31,2015-05-13,27266565,36550360,63816925
10960,SHUL3,2015-06-30,2015-08-06,27266565,36550360,63816925
10961,SHUL3,2015-09-30,2015-11-16,27266565,36550360,63816925
10962,SHUL3,2015-12-31,2016-03-24,27266565,36550360,63816925
10963,SHUL3,2016-03-31,2016-05-16,27266565,36550360,63816925
10964,SHUL3,2016-06-30,2016-08-10,27266565,36550360,63816925
10965,SHUL3,2016-09-30,2016-11-10,27266565,36550360,63816925
10966,SHUL3,2016-12-31,2017-03-30,27266565,36550360,63816925
10967,SHUL3,2017-03-31,2017-05-11,27266565,36550360,63816925
10968,SHUL3,2017-06-30,2020-11-27,27266565,36550360,63816925
10969,SHUL3,2017-09-30,2017-11-14,27266565,36550360,63816925
10970,SHUL3,2017-12-31,2018-04-02,27266565,36550360,63816925
10971,SHUL3,2018-03-31,2018-05-10,27266565,36550360,63816925
10972,SHUL3,2018-06-30,2018-08-09,27266565,36550360,63816925
10973,SHUL3,2018-09-30,2018-11-14,27266565,36550360,63816925
10974,SHUL3,2018-12-31,2019-03-27,38173191,51170504,89343695
10975,SHUL3,2019-03-31,2019-05-09,38173191,51170504,89343695
10976,SHUL3,2019-06-30,2019-08-13,38173191,51170504,89343695
10977,SHUL3,2019-09-30,2019-11-13,38173191,51170504,89343695
10978,SHUL3,2019-12-31,2020-02-27,38173191,51170504,89343695
10979,SHUL3,2020-03-31,2020-05-27,38173191,51170504,89343695
10980,SHUL3,2020-06-30,2020-08-25,38173191,51170504,89343695
10981,SHUL3,2020-09-30,2020-11-12,38173191,51170504,89343695
10982,SHUL3,2020-12-31,2021-03-10,38173191,51170504,89343695
10983,SHUL4,2010-12-31,2011-12-05,27267,36550,63817
10984,SHUL4,2011-03-31,2011-05-12,27267,36550,63817
10985,SHUL4,2011-06-30,2011-08-01,27267,36550,63817
10986,SHUL4,2011-09-30,2011-11-11,27267,36550,63817
10987,SHUL4,2011-12-31,2012-03-14,27266565,36550360,63816925
10988,SHUL4,2012-03-31,2012-05-15,27266565,36550360,63816925
10989,SHUL4,2012-06-30,2012-08-15,27266565,36550360,63816925
10990,SHUL4,2012-09-30,2012-11-29,27266565,36550360,63816925
10991,SHUL4,2012-12-31,2013-02-27,27266565,36550360,63816925
10992,SHUL4,2013-03-31,2013-05-15,27266565,36550360,63816925
10993,SHUL4,2013-06-30,2013-08-06,27266565,36550360,63816925
10994,SHUL4,2013-09-30,2013-11-07,27266565,36550360,63816925
10995,SHUL4,2013-12-31,2014-02-26,27266565,36550360,63816925
10996,SHUL4,2014-03-31,2014-05-07,27266565,36550360,63816925
10997,SHUL4,2014-06-30,2014-08-08,27266565,36550360,63816925
10998,SHUL4,2014-09-30,2014-11-14,27266565,36550360,63816925
10999,SHUL4,2014-12-31,2015-03-16,27266565,36550360,63816925
11000,SHUL4,2015-03-31,2015-05-13,27266565,36550360,63816925
11001,SHUL4,2015-06-30,2015-08-06,27266565,36550360,63816925
11002,SHUL4,2015-09-30,2015-11-16,27266565,36550360,63816925
11003,SHUL4,2015-12-31,2016-03-24,27266565,36550360,63816925
11004,SHUL4,2016-03-31,2016-05-16,27266565,36550360,63816925
11005,SHUL4,2016-06-30,2016-08-10,27266565,36550360,63816925
11006,SHUL4,2016-09-30,2016-11-10,27266565,36550360,63816925
11007,SHUL4,2016-12-31,2017-03-30,27266565,36550360,63816925
11008,SHUL4,2017-03-31,2017-05-11,27266565,36550360,63816925
11009,SHUL4,2017-06-30,2020-11-27,27266565,36550360,63816925
11010,SHUL4,2017-09-30,2017-11-14,27266565,36550360,63816925
11011,SHUL4,2017-12-31,2018-04-02,27266565,36550360,63816925
11012,SHUL4,2018-03-31,2018-05-10,27266565,36550360,63816925
11013,SHUL4,2018-06-30,2018-08-09,27266565,36550360,63816925
11014,SHUL4,2018-09-30,2018-11-14,27266565,36550360,63816925
11015,SHUL4,2018-12-31,2019-03-27,38173191,51170504,89343695
11016,SHUL4,2019-03-31,2019-05-09,38173191,51170504,89343695
11017,SHUL4,2019-06-30,2019-08-13,38173191,51170504,89343695
11018,SHUL4,2019-09-30,2019-11-13,38173191,51170504,89343695
11019,SHUL4,2019-12-31,2020-02-27,38173191,51170504,89343695
11020,SHUL4,2020-03-31,2020-05-27,38173191,51170504,89343695
11021,SHUL4,2020-06-30,2020-08-25,38173191,51170504,89343695
11022,SHUL4,2020-09-30,2020-11-12,38173191,51170504,89343695
11023,SHUL4,2020-12-31,2021-03-10,38173191,51170504,89343695
11024,HGTX3,2010-12-31,2011-03-04,162722,0,162722
11025,HGTX3,2011-03-31,2011-04-28,162722,0,162722
11026,HGTX3,2011-06-30,2011-07-28,163430,0,163430
11027,HGTX3,2011-09-30,2011-11-17,163430,0,163430
11028,HGTX3,2011-12-31,2012-02-29,163430,0,163430
11029,HGTX3,2012-03-31,2012-04-25,163444,0,163444
11030,HGTX3,2012-06-30,2012-07-19,164224,0,164224
11031,HGTX3,2012-09-30,2012-10-18,164224,0,164224
11032,HGTX3,2012-12-31,2013-02-21,164224,0,164224
11033,HGTX3,2013-03-31,2013-04-23,164224,0,164224
11034,HGTX3,2013-06-30,2013-07-17,164611,0,164611
11035,HGTX3,2013-09-30,2013-10-24,164611,0,164611
11036,HGTX3,2013-12-31,2014-02-20,164611,0,164611
11037,HGTX3,2014-03-31,2014-04-24,164611,0,164611
11038,HGTX3,2014-06-30,2014-07-24,164611,0,164611
11039,HGTX3,2014-09-30,2014-10-22,164611,0,164611
11040,HGTX3,2014-12-31,2015-02-26,164611,0,164611
11041,HGTX3,2015-03-31,2015-05-07,164611,0,164611
11042,HGTX3,2015-06-30,2015-08-05,163771,0,163771
11043,HGTX3,2015-09-30,2015-10-29,163771,0,163771
11044,HGTX3,2015-12-31,2016-02-25,163771,0,163771
11045,HGTX3,2016-03-31,2016-04-28,163771,0,163771
11046,HGTX3,2016-06-30,2016-07-28,161228,0,161228
11047,HGTX3,2016-09-30,2016-10-27,161228,0,161228
11048,HGTX3,2016-12-31,2017-02-23,161228,0,161228
11049,HGTX3,2017-03-31,2017-04-27,161228,0,161228
11050,HGTX3,2017-06-30,2017-08-02,161280,0,161280
11051,HGTX3,2017-09-30,2017-10-26,161844,0,161844
11052,HGTX3,2017-12-31,2018-03-01,161844,0,161844
11053,HGTX3,2018-03-31,2018-04-26,161844,0,161844
11054,HGTX3,2018-06-30,2018-07-26,161844,0,161844
11055,HGTX3,2018-09-30,2018-10-31,161844,0,161844
11056,HGTX3,2018-12-31,2019-02-28,161844,0,161844
11057,HGTX3,2019-03-31,2019-04-25,161844,0,161844
11058,HGTX3,2019-06-30,2019-08-01,162115,0,162115
11059,HGTX3,2019-09-30,2019-11-01,162534,0,162534
11060,HGTX3,2019-12-31,2020-03-05,162534,0,162534
11061,HGTX3,2020-03-31,2020-05-28,162534,0,162534
11062,HGTX3,2020-06-30,2020-08-13,162534,0,162534
11063,HGTX3,2020-09-30,2020-11-04,162534,0,162534
11064,HGTX3,2020-12-31,2021-03-03,162534,0,162534
11065,CMSA3,2010-12-31,2011-05-04,126243,240000,366243
11066,CMSA3,2011-03-31,2011-05-13,126243,240000,366243
11067,CMSA3,2011-06-30,2011-08-15,226243,440000,666243
11068,CMSA3,2011-09-30,2011-11-11,226243,440000,666243
11069,CMSA3,2011-12-31,2012-03-29,226243,440000,666243
11070,CMSA3,2012-03-31,2012-05-15,226243,440000,666243
11071,CMSA3,2012-06-30,2012-08-14,226243,440000,666243
11072,CMSA3,2012-09-30,2012-11-14,226243,440000,666243
11073,CMSA3,2012-12-31,2013-03-27,255466,510777,766243
11074,CMSA3,2013-03-31,2013-05-15,255466,510777,766243
11075,CMSA3,2013-06-30,2013-08-14,255466,510777,766243
11076,CMSA3,2013-09-30,2013-11-14,255466,510777,766243
11077,CMSA3,2013-12-31,2014-03-24,255466,510777,766243
11078,CMSA3,2014-03-31,2014-05-15,355466,710777,1066243
11079,CMSA3,2014-06-30,2014-08-14,355466,710777,1066243
11080,CMSA3,2014-09-30,2014-11-14,355466,710777,1066243
11081,CMSA3,2014-12-31,2015-02-24,355466,710777,1066243
11082,CMSA3,2015-03-31,2015-05-15,355466,710777,1066243
11083,CMSA3,2015-06-30,2015-08-14,355466,710777,1066243
11084,CMSA3,2015-09-30,2015-11-13,355466,710777,1066243
11085,CMSA3,2015-12-31,2016-03-22,355466,710777,1066243
11086,CMSA3,2016-03-31,2016-05-13,388801,777442,1166243
11087,CMSA3,2016-06-30,2016-08-12,388801,777442,1166243
11088,CMSA3,2016-09-30,2016-11-09,3698406,7396652,11095058
11089,CMSA3,2016-12-31,2017-03-24,3698406,7396652,11095058
11090,CMSA3,2017-03-31,2017-05-15,3698406,7396652,11095058
11091,CMSA3,2017-06-30,2017-08-14,3698406,7396652,11095058
11092,CMSA3,2017-09-30,2017-11-14,7008011,14015862,21023873
11093,CMSA3,2017-12-31,2018-03-27,7008011,14015862,21023873
11094,CMSA3,2018-03-31,2018-05-15,7008011,14015862,21023873
11095,CMSA3,2018-06-30,2018-08-16,7008011,14015862,21023873
11096,CMSA3,2018-09-30,2018-11-13,7008011,14015862,21023873
11097,CMSA3,2018-12-31,2019-03-29,7008011,14015862,21023873
11098,CMSA3,2019-03-31,2019-05-15,10317616,20635072,30952688
11099,CMSA3,2019-06-30,2019-08-14,10317616,20635072,30952688
11100,CMSA3,2019-09-30,2019-11-14,10317616,20635072,30952688
11101,CMSA3,2019-12-31,2020-03-30,10317616,20635072,30952688
11102,CMSA3,2020-03-31,2020-05-20,12799820,25599480,38399300
11103,CMSA3,2020-06-30,2020-08-18,12799820,25599480,38399300
11104,CMSA3,2020-09-30,2020-11-13,12799820,25599480,38399300
11105,CMSA4,2010-12-31,2011-05-04,126243,240000,366243
11106,CMSA4,2011-03-31,2011-05-13,126243,240000,366243
11107,CMSA4,2011-06-30,2011-08-15,226243,440000,666243
11108,CMSA4,2011-09-30,2011-11-11,226243,440000,666243
11109,CMSA4,2011-12-31,2012-03-29,226243,440000,666243
11110,CMSA4,2012-03-31,2012-05-15,226243,440000,666243
11111,CMSA4,2012-06-30,2012-08-14,226243,440000,666243
11112,CMSA4,2012-09-30,2012-11-14,226243,440000,666243
11113,CMSA4,2012-12-31,2013-03-27,255466,510777,766243
11114,CMSA4,2013-03-31,2013-05-15,255466,510777,766243
11115,CMSA4,2013-06-30,2013-08-14,255466,510777,766243
11116,CMSA4,2013-09-30,2013-11-14,255466,510777,766243
11117,CMSA4,2013-12-31,2014-03-24,255466,510777,766243
11118,CMSA4,2014-03-31,2014-05-15,355466,710777,1066243
11119,CMSA4,2014-06-30,2014-08-14,355466,710777,1066243
11120,CMSA4,2014-09-30,2014-11-14,355466,710777,1066243
11121,CMSA4,2014-12-31,2015-02-24,355466,710777,1066243
11122,CMSA4,2015-03-31,2015-05-15,355466,710777,1066243
11123,CMSA4,2015-06-30,2015-08-14,355466,710777,1066243
11124,CMSA4,2015-09-30,2015-11-13,355466,710777,1066243
11125,CMSA4,2015-12-31,2016-03-22,355466,710777,1066243
11126,CMSA4,2016-03-31,2016-05-13,388801,777442,1166243
11127,CMSA4,2016-06-30,2016-08-12,388801,777442,1166243
11128,CMSA4,2016-09-30,2016-11-09,3698406,7396652,11095058
11129,CMSA4,2016-12-31,2017-03-24,3698406,7396652,11095058
11130,CMSA4,2017-03-31,2017-05-15,3698406,7396652,11095058
11131,CMSA4,2017-06-30,2017-08-14,3698406,7396652,11095058
11132,CMSA4,2017-09-30,2017-11-14,7008011,14015862,21023873
11133,CMSA4,2017-12-31,2018-03-27,7008011,14015862,21023873
11134,CMSA4,2018-03-31,2018-05-15,7008011,14015862,21023873
11135,CMSA4,2018-06-30,2018-08-16,7008011,14015862,21023873
11136,CMSA4,2018-09-30,2018-11-13,7008011,14015862,21023873
11137,CMSA4,2018-12-31,2019-03-29,7008011,14015862,21023873
11138,CMSA4,2019-03-31,2019-05-15,10317616,20635072,30952688
11139,CMSA4,2019-06-30,2019-08-14,10317616,20635072,30952688
11140,CMSA4,2019-09-30,2019-11-14,10317616,20635072,30952688
11141,CMSA4,2019-12-31,2020-03-30,10317616,20635072,30952688
11142,CMSA4,2020-03-31,2020-05-20,12799820,25599480,38399300
11143,CMSA4,2020-06-30,2020-08-18,12799820,25599480,38399300
11144,CMSA4,2020-09-30,2020-11-13,12799820,25599480,38399300
11145,PCAR3,2010-12-31,2011-05-13,99680,158094,257774
11146,PCAR3,2011-03-31,2011-05-13,99679,158094,257773
11147,PCAR3,2011-06-30,2011-07-25,99680,160280,259960
11148,PCAR3,2011-09-30,2011-11-11,99680,160539,260219
11149,PCAR3,2011-12-31,2012-02-16,99680,160559,260239
11150,PCAR3,2012-03-31,2012-05-08,99680,160595,260275
11151,PCAR3,2012-06-30,2012-07-23,99680,163368,263048
11152,PCAR3,2012-09-30,2012-10-31,99680,163376,263056
11153,PCAR3,2012-12-31,2013-02-20,99680,163730,263410
11154,PCAR3,2013-03-31,2013-05-02,99680,163771,263451
11155,PCAR3,2013-06-30,2013-07-23,99680,164612,264292
11156,PCAR3,2013-09-30,2013-10-16,99680,164638,264318
11157,PCAR3,2013-12-31,2014-03-18,99680,164773,264453
11158,PCAR3,2014-03-31,2014-04-29,99680,165243,264923
11159,PCAR3,2014-06-30,2014-07-23,99680,165458,265138
11160,PCAR3,2014-09-30,2014-10-31,99680,165539,265219
11161,PCAR3,2014-12-31,2015-02-12,99680,165603,265283
11162,PCAR3,2015-03-31,2016-10-28,99680,165635,265315
11163,PCAR3,2015-06-30,2016-10-28,99680,165982,265662
11164,PCAR3,2015-09-30,2016-10-27,99680,166017,265697
11165,PCAR3,2015-12-31,2016-07-29,99680,166022,265702
11166,PCAR3,2016-03-31,2016-07-28,99680,166032,265712
11167,PCAR3,2016-06-30,2016-08-02,99680,166044,265724
11168,PCAR3,2016-09-30,2016-10-27,99680,166087,265767
11169,PCAR3,2016-12-31,2017-03-07,99680,166396,266076
11170,PCAR3,2017-03-31,2017-05-05,99680,166506,266186
11171,PCAR3,2017-06-30,2017-07-25,99680,166568,266248
11172,PCAR3,2017-09-30,2017-10-26,99680,166772,266452
11173,PCAR3,2017-12-31,2018-02-19,99680,166899,266579
11174,PCAR3,2018-03-31,2018-04-26,99680,166907,266587
11175,PCAR3,2018-06-30,2018-07-24,99680,166950,266630
11176,PCAR3,2018-09-30,2018-10-25,99680,167119,266799
11177,PCAR3,2018-12-31,2019-03-26,99680,167165,266845
11178,PCAR3,2019-03-31,2019-05-08,99680,167174,266854
11179,PCAR3,2019-06-30,2019-07-24,99680,167399,267079
11180,PCAR3,2019-09-30,2019-10-30,99680,168086,267766
11181,PCAR3,2019-12-31,2020-10-28,99680,168317,267997
11182,PCAR3,2020-03-31,2020-05-14,268046,0,268046
11183,PCAR3,2020-06-30,2020-07-29,268049,0,268049
11184,PCAR3,2020-09-30,2020-10-28,268336,0,268336
11185,PCAR3,2020-12-31,2021-02-23,268352,0,268352
11186,PCAR4,2010-12-31,2011-05-13,99680,158094,257774
11187,PCAR4,2011-03-31,2011-05-13,99679,158094,257773
11188,PCAR4,2011-06-30,2011-07-25,99680,160280,259960
11189,PCAR4,2011-09-30,2011-11-11,99680,160539,260219
11190,PCAR4,2011-12-31,2012-02-16,99680,160559,260239
11191,PCAR4,2012-03-31,2012-05-08,99680,160595,260275
11192,PCAR4,2012-06-30,2012-07-23,99680,163368,263048
11193,PCAR4,2012-09-30,2012-10-31,99680,163376,263056
11194,PCAR4,2012-12-31,2013-02-20,99680,163730,263410
11195,PCAR4,2013-03-31,2013-05-02,99680,163771,263451
11196,PCAR4,2013-06-30,2013-07-23,99680,164612,264292
11197,PCAR4,2013-09-30,2013-10-16,99680,164638,264318
11198,PCAR4,2013-12-31,2014-03-18,99680,164773,264453
11199,PCAR4,2014-03-31,2014-04-29,99680,165243,264923
11200,PCAR4,2014-06-30,2014-07-23,99680,165458,265138
11201,PCAR4,2014-09-30,2014-10-31,99680,165539,265219
11202,PCAR4,2014-12-31,2015-02-12,99680,165603,265283
11203,PCAR4,2015-03-31,2016-10-28,99680,165635,265315
11204,PCAR4,2015-06-30,2016-10-28,99680,165982,265662
11205,PCAR4,2015-09-30,2016-10-27,99680,166017,265697
11206,PCAR4,2015-12-31,2016-07-29,99680,166022,265702
11207,PCAR4,2016-03-31,2016-07-28,99680,166032,265712
11208,PCAR4,2016-06-30,2016-08-02,99680,166044,265724
11209,PCAR4,2016-09-30,2016-10-27,99680,166087,265767
11210,PCAR4,2016-12-31,2017-03-07,99680,166396,266076
11211,PCAR4,2017-03-31,2017-05-05,99680,166506,266186
11212,PCAR4,2017-06-30,2017-07-25,99680,166568,266248
11213,PCAR4,2017-09-30,2017-10-26,99680,166772,266452
11214,PCAR4,2017-12-31,2018-02-19,99680,166899,266579
11215,PCAR4,2018-03-31,2018-04-26,99680,166907,266587
11216,PCAR4,2018-06-30,2018-07-24,99680,166950,266630
11217,PCAR4,2018-09-30,2018-10-25,99680,167119,266799
11218,PCAR4,2018-12-31,2019-03-26,99680,167165,266845
11219,PCAR4,2019-03-31,2019-05-08,99680,167174,266854
11220,PCAR4,2019-06-30,2019-07-24,99680,167399,267079
11221,PCAR4,2019-09-30,2019-10-30,99680,168086,267766
11222,PCAR4,2019-12-31,2020-10-28,99680,168317,267997
11223,PCAR4,2020-03-31,2020-05-14,268046,0,268046
11224,PCAR4,2020-06-30,2020-07-29,268049,0,268049
11225,PCAR4,2020-09-30,2020-10-28,268336,0,268336
11226,PCAR4,2020-12-31,2021-02-23,268352,0,268352
11227,PCAR99,2010-12-31,2011-05-13,99680,158094,257774
11228,PCAR99,2011-03-31,2011-05-13,99679,158094,257773
11229,PCAR99,2011-06-30,2011-07-25,99680,160280,259960
11230,PCAR99,2011-09-30,2011-11-11,99680,160539,260219
11231,PCAR99,2011-12-31,2012-02-16,99680,160559,260239
11232,PCAR99,2012-03-31,2012-05-08,99680,160595,260275
11233,PCAR99,2012-06-30,2012-07-23,99680,163368,263048
11234,PCAR99,2012-09-30,2012-10-31,99680,163376,263056
11235,PCAR99,2012-12-31,2013-02-20,99680,163730,263410
11236,PCAR99,2013-03-31,2013-05-02,99680,163771,263451
11237,PCAR99,2013-06-30,2013-07-23,99680,164612,264292
11238,PCAR99,2013-09-30,2013-10-16,99680,164638,264318
11239,PCAR99,2013-12-31,2014-03-18,99680,164773,264453
11240,PCAR99,2014-03-31,2014-04-29,99680,165243,264923
11241,PCAR99,2014-06-30,2014-07-23,99680,165458,265138
11242,PCAR99,2014-09-30,2014-10-31,99680,165539,265219
11243,PCAR99,2014-12-31,2015-02-12,99680,165603,265283
11244,PCAR99,2015-03-31,2016-10-28,99680,165635,265315
11245,PCAR99,2015-06-30,2016-10-28,99680,165982,265662
11246,PCAR99,2015-09-30,2016-10-27,99680,166017,265697
11247,PCAR99,2015-12-31,2016-07-29,99680,166022,265702
11248,PCAR99,2016-03-31,2016-07-28,99680,166032,265712
11249,PCAR99,2016-06-30,2016-08-02,99680,166044,265724
11250,PCAR99,2016-09-30,2016-10-27,99680,166087,265767
11251,PCAR99,2016-12-31,2017-03-07,99680,166396,266076
11252,PCAR99,2017-03-31,2017-05-05,99680,166506,266186
11253,PCAR99,2017-06-30,2017-07-25,99680,166568,266248
11254,PCAR99,2017-09-30,2017-10-26,99680,166772,266452
11255,PCAR99,2017-12-31,2018-02-19,99680,166899,266579
11256,PCAR99,2018-03-31,2018-04-26,99680,166907,266587
11257,PCAR99,2018-06-30,2018-07-24,99680,166950,266630
11258,PCAR99,2018-09-30,2018-10-25,99680,167119,266799
11259,PCAR99,2018-12-31,2019-03-26,99680,167165,266845
11260,PCAR99,2019-03-31,2019-05-08,99680,167174,266854
11261,PCAR99,2019-06-30,2019-07-24,99680,167399,267079
11262,PCAR99,2019-09-30,2019-10-30,99680,168086,267766
11263,PCAR99,2019-12-31,2020-10-28,99680,168317,267997
11264,PCAR99,2020-03-31,2020-05-14,268046,0,268046
11265,PCAR99,2020-06-30,2020-07-29,268049,0,268049
11266,PCAR99,2020-09-30,2020-10-28,268336,0,268336
11267,PCAR99,2020-12-31,2021-02-23,268352,0,268352
11268,COCE3,2010-12-31,2011-04-18,48067937,29787362,77855299
11269,COCE3,2011-03-31,2011-05-17,48067937,29787362,77855299
11270,COCE3,2011-06-30,2011-08-08,48067937,29787362,77855299
11271,COCE3,2011-09-30,2011-10-31,48067937,29787362,77855299
11272,COCE3,2011-12-31,2012-03-26,48067937,29787362,77855299
11273,COCE3,2012-03-31,2013-03-28,48067937,29787362,77855299
11274,COCE3,2012-06-30,2013-03-28,48067937,29787362,77855299
11275,COCE3,2012-09-30,2013-03-28,48067937,29787362,77855299
11276,COCE3,2012-12-31,2013-03-27,48067937,29787362,77855299
11277,COCE3,2013-03-31,2013-05-16,48067937,29787362,77855299
11278,COCE3,2013-06-30,2013-07-31,48067937,29787362,77855299
11279,COCE3,2013-09-30,2013-10-29,48067937,29787362,77855299
11280,COCE3,2013-12-31,2014-02-06,48067937,29787362,77855299
11281,COCE3,2014-03-31,2014-05-05,48067937,29787362,77855299
11282,COCE3,2014-06-30,2014-07-25,48067937,29787362,77855299
11283,COCE3,2014-09-30,2014-10-28,48067937,29787362,77855299
11284,COCE3,2014-12-31,2015-03-27,48067937,29787362,77855299
11285,COCE3,2015-03-31,2015-04-27,48067937,29787362,77855299
11286,COCE3,2015-06-30,2015-07-26,48067937,29787362,77855299
11287,COCE3,2015-09-30,2015-10-29,48067937,29787362,77855299
11288,COCE3,2015-12-31,2016-02-04,48067937,29787362,77855299
11289,COCE3,2016-03-31,2016-05-06,48067937,29787362,77855299
11290,COCE3,2016-06-30,2016-08-30,48067937,29787362,77855299
11291,COCE3,2016-09-30,2016-11-03,48067937,29787362,77855299
11292,COCE3,2016-12-31,2017-02-22,48067937,29787362,77855299
11293,COCE3,2017-03-31,2017-05-04,48067937,29787362,77855299
11294,COCE3,2017-06-30,2017-07-25,48067937,29787362,77855299
11295,COCE3,2017-09-30,2017-10-30,48067937,29787362,77855299
11296,COCE3,2017-12-31,2018-02-27,48067937,29787362,77855299
11297,COCE3,2018-03-31,2018-05-02,48067937,29787362,77855299
11298,COCE3,2018-06-30,2018-07-26,48067937,29787362,77855299
11299,COCE3,2018-09-30,2018-10-29,48067937,29787362,77855299
11300,COCE3,2018-12-31,2019-02-26,48067937,29787362,77855299
11301,COCE3,2019-03-31,2019-04-24,48067937,29787362,77855299
11302,COCE3,2019-06-30,2019-07-30,48067937,29787362,77855299
11303,COCE3,2019-09-30,2019-10-25,48067937,29787362,77855299
11304,COCE3,2019-12-31,2020-02-20,48067937,29787362,77855299
11305,COCE3,2020-03-31,2020-04-30,48067937,29787362,77855299
11306,COCE3,2020-06-30,2020-07-27,48067937,29787362,77855299
11307,COCE3,2020-09-30,2020-11-03,48067937,29787362,77855299
11308,COCE3,2020-12-31,2021-02-24,48067937,29787362,77855299
11309,COCE5,2010-12-31,2011-04-18,48067937,29787362,77855299
11310,COCE5,2011-03-31,2011-05-17,48067937,29787362,77855299
11311,COCE5,2011-06-30,2011-08-08,48067937,29787362,77855299
11312,COCE5,2011-09-30,2011-10-31,48067937,29787362,77855299
11313,COCE5,2011-12-31,2012-03-26,48067937,29787362,77855299
11314,COCE5,2012-03-31,2013-03-28,48067937,29787362,77855299
11315,COCE5,2012-06-30,2013-03-28,48067937,29787362,77855299
11316,COCE5,2012-09-30,2013-03-28,48067937,29787362,77855299
11317,COCE5,2012-12-31,2013-03-27,48067937,29787362,77855299
11318,COCE5,2013-03-31,2013-05-16,48067937,29787362,77855299
11319,COCE5,2013-06-30,2013-07-31,48067937,29787362,77855299
11320,COCE5,2013-09-30,2013-10-29,48067937,29787362,77855299
11321,COCE5,2013-12-31,2014-02-06,48067937,29787362,77855299
11322,COCE5,2014-03-31,2014-05-05,48067937,29787362,77855299
11323,COCE5,2014-06-30,2014-07-25,48067937,29787362,77855299
11324,COCE5,2014-09-30,2014-10-28,48067937,29787362,77855299
11325,COCE5,2014-12-31,2015-03-27,48067937,29787362,77855299
11326,COCE5,2015-03-31,2015-04-27,48067937,29787362,77855299
11327,COCE5,2015-06-30,2015-07-26,48067937,29787362,77855299
11328,COCE5,2015-09-30,2015-10-29,48067937,29787362,77855299
11329,COCE5,2015-12-31,2016-02-04,48067937,29787362,77855299
11330,COCE5,2016-03-31,2016-05-06,48067937,29787362,77855299
11331,COCE5,2016-06-30,2016-08-30,48067937,29787362,77855299
11332,COCE5,2016-09-30,2016-11-03,48067937,29787362,77855299
11333,COCE5,2016-12-31,2017-02-22,48067937,29787362,77855299
11334,COCE5,2017-03-31,2017-05-04,48067937,29787362,77855299
11335,COCE5,2017-06-30,2017-07-25,48067937,29787362,77855299
11336,COCE5,2017-09-30,2017-10-30,48067937,29787362,77855299
11337,COCE5,2017-12-31,2018-02-27,48067937,29787362,77855299
11338,COCE5,2018-03-31,2018-05-02,48067937,29787362,77855299
11339,COCE5,2018-06-30,2018-07-26,48067937,29787362,77855299
11340,COCE5,2018-09-30,2018-10-29,48067937,29787362,77855299
11341,COCE5,2018-12-31,2019-02-26,48067937,29787362,77855299
11342,COCE5,2019-03-31,2019-04-24,48067937,29787362,77855299
11343,COCE5,2019-06-30,2019-07-30,48067937,29787362,77855299
11344,COCE5,2019-09-30,2019-10-25,48067937,29787362,77855299
11345,COCE5,2019-12-31,2020-02-20,48067937,29787362,77855299
11346,COCE5,2020-03-31,2020-04-30,48067937,29787362,77855299
11347,COCE5,2020-06-30,2020-07-27,48067937,29787362,77855299
11348,COCE5,2020-09-30,2020-11-03,48067937,29787362,77855299
11349,COCE5,2020-12-31,2021-02-24,48067937,29787362,77855299
11350,COCE6,2010-12-31,2011-04-18,48067937,29787362,77855299
11351,COCE6,2011-03-31,2011-05-17,48067937,29787362,77855299
11352,COCE6,2011-06-30,2011-08-08,48067937,29787362,77855299
11353,COCE6,2011-09-30,2011-10-31,48067937,29787362,77855299
11354,COCE6,2011-12-31,2012-03-26,48067937,29787362,77855299
11355,COCE6,2012-03-31,2013-03-28,48067937,29787362,77855299
11356,COCE6,2012-06-30,2013-03-28,48067937,29787362,77855299
11357,COCE6,2012-09-30,2013-03-28,48067937,29787362,77855299
11358,COCE6,2012-12-31,2013-03-27,48067937,29787362,77855299
11359,COCE6,2013-03-31,2013-05-16,48067937,29787362,77855299
11360,COCE6,2013-06-30,2013-07-31,48067937,29787362,77855299
11361,COCE6,2013-09-30,2013-10-29,48067937,29787362,77855299
11362,COCE6,2013-12-31,2014-02-06,48067937,29787362,77855299
11363,COCE6,2014-03-31,2014-05-05,48067937,29787362,77855299
11364,COCE6,2014-06-30,2014-07-25,48067937,29787362,77855299
11365,COCE6,2014-09-30,2014-10-28,48067937,29787362,77855299
11366,COCE6,2014-12-31,2015-03-27,48067937,29787362,77855299
11367,COCE6,2015-03-31,2015-04-27,48067937,29787362,77855299
11368,COCE6,2015-06-30,2015-07-26,48067937,29787362,77855299
11369,COCE6,2015-09-30,2015-10-29,48067937,29787362,77855299
11370,COCE6,2015-12-31,2016-02-04,48067937,29787362,77855299
11371,COCE6,2016-03-31,2016-05-06,48067937,29787362,77855299
11372,COCE6,2016-06-30,2016-08-30,48067937,29787362,77855299
11373,COCE6,2016-09-30,2016-11-03,48067937,29787362,77855299
11374,COCE6,2016-12-31,2017-02-22,48067937,29787362,77855299
11375,COCE6,2017-03-31,2017-05-04,48067937,29787362,77855299
11376,COCE6,2017-06-30,2017-07-25,48067937,29787362,77855299
11377,COCE6,2017-09-30,2017-10-30,48067937,29787362,77855299
11378,COCE6,2017-12-31,2018-02-27,48067937,29787362,77855299
11379,COCE6,2018-03-31,2018-05-02,48067937,29787362,77855299
11380,COCE6,2018-06-30,2018-07-26,48067937,29787362,77855299
11381,COCE6,2018-09-30,2018-10-29,48067937,29787362,77855299
11382,COCE6,2018-12-31,2019-02-26,48067937,29787362,77855299
11383,COCE6,2019-03-31,2019-04-24,48067937,29787362,77855299
11384,COCE6,2019-06-30,2019-07-30,48067937,29787362,77855299
11385,COCE6,2019-09-30,2019-10-25,48067937,29787362,77855299
11386,COCE6,2019-12-31,2020-02-20,48067937,29787362,77855299
11387,COCE6,2020-03-31,2020-04-30,48067937,29787362,77855299
11388,COCE6,2020-06-30,2020-07-27,48067937,29787362,77855299
11389,COCE6,2020-09-30,2020-11-03,48067937,29787362,77855299
11390,COCE6,2020-12-31,2021-02-24,48067937,29787362,77855299
11391,LTEL3B,2010-12-31,2011-05-19,247128,36158,283286
11392,LTEL3B,2011-03-31,2011-09-06,247128,36158,283286
11393,LTEL3B,2011-06-30,2011-09-14,247128,35567,282695
11394,LTEL3B,2011-09-30,2011-11-18,247128,35567,282695
11395,LTEL3B,2011-12-31,2012-03-30,247128,34977,282105
11396,LTEL3B,2012-03-31,2012-05-15,247128,34977,282105
11397,LTEL3B,2012-06-30,2012-08-15,247128,34505,281633
11398,LTEL3B,2012-09-30,2012-11-13,247128,34505,281633
11399,LTEL3B,2012-12-31,2013-03-28,247128,34035,281163
11400,LTEL3B,2013-03-31,2013-05-15,247128,34035,281163
11401,LTEL3B,2013-06-30,2013-08-14,247128,33491,280619
11402,LTEL3B,2013-09-30,2013-11-14,247128,33491,280619
11403,LTEL3B,2013-12-31,2014-03-31,247128,28386,275514
11404,LTEL3B,2014-03-31,2014-05-14,247128,28386,275514
11405,LTEL3B,2014-06-30,2014-08-14,247128,31514,278642
11406,LTEL3B,2014-09-30,2014-11-27,247128,31514,278642
11407,LTEL3B,2014-12-31,2015-04-01,247128,30081,277209
11408,LTEL3B,2015-03-31,2015-05-14,247128,30081,277209
11409,LTEL3B,2015-06-30,2015-08-14,247128,29234,276362
11410,LTEL3B,2015-09-30,2015-11-13,247128,29234,276362
11411,LTEL3B,2015-12-31,2016-03-29,247128,28386,275514
11412,LTEL3B,2016-03-31,2016-05-12,247128,28386,275514
11413,LTEL3B,2016-06-30,2016-08-11,247128,28386,275514
11414,LTEL3B,2016-09-30,2016-11-11,247128,28386,275514
11415,LTEL3B,2016-12-31,2017-03-20,247128,28386,275514
11416,LTEL3B,2017-03-31,2017-05-11,247128,28386,275514
11417,LTEL3B,2017-06-30,2017-08-10,247128,28386,275514
11418,LTEL3B,2017-09-30,2017-11-14,247128,28386,275514
11419,LTEL3B,2017-12-31,2018-03-29,247128,28386,275514
11420,LTEL3B,2018-03-31,2018-05-15,247128,28386,275514
11421,LTEL3B,2018-06-30,2018-08-15,247128,28386,275514
11422,LTEL3B,2018-09-30,2018-11-13,247128,28386,275514
11423,LTEL3B,2018-12-31,2019-03-29,247128,28386,275514
11424,LTEL3B,2019-03-31,2019-05-15,247128,28386,275514
11425,LTEL3B,2019-06-30,2019-08-13,247128,28386,275514
11426,LTEL3B,2019-09-30,2019-11-14,215495,0,215495
11427,LTEL3B,2019-12-31,2020-04-27,215495,0,215495
11428,LTEL3B,2020-03-31,2020-05-15,215495,0,215495
11429,LTEL3B,2020-06-30,2020-08-14,215495,0,215495
11430,LTEL3B,2020-09-30,2020-11-13,215495,0,215495
11431,LTEL3B,2020-12-31,2021-03-26,215495,0,215495
11432,ENGI11,2010-12-31,2011-03-21,522604,577253,1099857
11433,ENGI11,2011-03-31,2012-02-17,522604,577253,1099857
11434,ENGI11,2011-06-30,2012-02-27,522604,577253,1099857
11435,ENGI11,2011-09-30,2012-02-17,522604,577253,1099857
11436,ENGI11,2011-12-31,2012-03-09,522604,577253,1099857
11437,ENGI11,2012-03-31,2012-07-03,522604,577253,1099857
11438,ENGI11,2012-06-30,2012-08-14,522604096,577253459,1099857555
11439,ENGI11,2012-09-30,2012-11-08,522604096,577253459,1099857555
11440,ENGI11,2012-12-31,2013-03-05,522604,577253,1099857
11441,ENGI11,2013-03-31,2013-05-16,522604096,577253459,1099857555
11442,ENGI11,2013-06-30,2013-08-09,592714397,652976492,1245690889
11443,ENGI11,2013-09-30,2013-11-08,592714397,652976492,1245690889
11444,ENGI11,2013-12-31,2014-03-18,592714,652976,1245690
11445,ENGI11,2014-03-31,2014-05-16,592714397,652976492,1245690889
11446,ENGI11,2014-06-30,2014-09-19,592714397,652976492,1245690889
11447,ENGI11,2014-09-30,2015-01-27,592714397,652976492,1245690889
11448,ENGI11,2014-12-31,2015-03-27,592714,652976,1245690
11449,ENGI11,2015-03-31,2015-05-15,592714397,652976492,1245690889
11450,ENGI11,2015-06-30,2015-08-14,592714397,652976492,1245690889
11451,ENGI11,2015-09-30,2015-11-13,592714397,652976492,1245690889
11452,ENGI11,2015-12-31,2016-03-22,641553,695047,1336600
11453,ENGI11,2016-03-31,2016-07-05,641553423,695046557,1336599980
11454,ENGI11,2016-06-30,2016-08-12,641553423,695046557,1336599980
11455,ENGI11,2016-09-30,2016-11-11,720210378,1009616927,1729827305
11456,ENGI11,2016-12-31,2017-03-23,720210,1009617,1729827
11457,ENGI11,2017-03-31,2017-07-20,720210378,1009616927,1729827305
11458,ENGI11,2017-06-30,2017-08-18,720210378,1009616927,1729827305
11459,ENGI11,2017-09-30,2017-11-14,720210378,1009616927,1729827305
11460,ENGI11,2017-12-31,2018-03-14,720210,1009617,1729827
11461,ENGI11,2018-03-31,2018-05-10,720210378,1009616927,1729827305
11462,ENGI11,2018-06-30,2018-08-08,720210378,1009616927,1729827305
11463,ENGI11,2018-09-30,2018-11-08,720210378,1009616927,1729827305
11464,ENGI11,2018-12-31,2019-03-21,755993938,1058567972,1814561910
11465,ENGI11,2019-03-31,2019-05-09,755993938,1058567972,1814561910
11466,ENGI11,2019-06-30,2019-08-08,755993938,1058567972,1814561910
11467,ENGI11,2019-09-30,2019-11-07,755993938,1058567972,1814561910
11468,ENGI11,2019-12-31,2020-03-18,755993938,1058567972,1814561910
11469,ENGI11,2020-03-31,2020-05-14,755993938,1058567972,1814561910
11470,ENGI11,2020-06-30,2020-08-28,755993938,1058567972,1814561910
11471,ENGI11,2020-09-30,2020-11-12,755993938,1058567972,1814561910
11472,ENGI11,2020-12-31,2021-03-11,250588254,999267963,1249856217
11473,ENGI3,2010-12-31,2011-03-21,522604,577253,1099857
11474,ENGI3,2011-03-31,2012-02-17,522604,577253,1099857
11475,ENGI3,2011-06-30,2012-02-27,522604,577253,1099857
11476,ENGI3,2011-09-30,2012-02-17,522604,577253,1099857
11477,ENGI3,2011-12-31,2012-03-09,522604,577253,1099857
11478,ENGI3,2012-03-31,2012-07-03,522604,577253,1099857
11479,ENGI3,2012-06-30,2012-08-14,522604096,577253459,1099857555
11480,ENGI3,2012-09-30,2012-11-08,522604096,577253459,1099857555
11481,ENGI3,2012-12-31,2013-03-05,522604,577253,1099857
11482,ENGI3,2013-03-31,2013-05-16,522604096,577253459,1099857555
11483,ENGI3,2013-06-30,2013-08-09,592714397,652976492,1245690889
11484,ENGI3,2013-09-30,2013-11-08,592714397,652976492,1245690889
11485,ENGI3,2013-12-31,2014-03-18,592714,652976,1245690
11486,ENGI3,2014-03-31,2014-05-16,592714397,652976492,1245690889
11487,ENGI3,2014-06-30,2014-09-19,592714397,652976492,1245690889
11488,ENGI3,2014-09-30,2015-01-27,592714397,652976492,1245690889
11489,ENGI3,2014-12-31,2015-03-27,592714,652976,1245690
11490,ENGI3,2015-03-31,2015-05-15,592714397,652976492,1245690889
11491,ENGI3,2015-06-30,2015-08-14,592714397,652976492,1245690889
11492,ENGI3,2015-09-30,2015-11-13,592714397,652976492,1245690889
11493,ENGI3,2015-12-31,2016-03-22,641553,695047,1336600
11494,ENGI3,2016-03-31,2016-07-05,641553423,695046557,1336599980
11495,ENGI3,2016-06-30,2016-08-12,641553423,695046557,1336599980
11496,ENGI3,2016-09-30,2016-11-11,720210378,1009616927,1729827305
11497,ENGI3,2016-12-31,2017-03-23,720210,1009617,1729827
11498,ENGI3,2017-03-31,2017-07-20,720210378,1009616927,1729827305
11499,ENGI3,2017-06-30,2017-08-18,720210378,1009616927,1729827305
11500,ENGI3,2017-09-30,2017-11-14,720210378,1009616927,1729827305
11501,ENGI3,2017-12-31,2018-03-14,720210,1009617,1729827
11502,ENGI3,2018-03-31,2018-05-10,720210378,1009616927,1729827305
11503,ENGI3,2018-06-30,2018-08-08,720210378,1009616927,1729827305
11504,ENGI3,2018-09-30,2018-11-08,720210378,1009616927,1729827305
11505,ENGI3,2018-12-31,2019-03-21,755993938,1058567972,1814561910
11506,ENGI3,2019-03-31,2019-05-09,755993938,1058567972,1814561910
11507,ENGI3,2019-06-30,2019-08-08,755993938,1058567972,1814561910
11508,ENGI3,2019-09-30,2019-11-07,755993938,1058567972,1814561910
11509,ENGI3,2019-12-31,2020-03-18,755993938,1058567972,1814561910
11510,ENGI3,2020-03-31,2020-05-14,755993938,1058567972,1814561910
11511,ENGI3,2020-06-30,2020-08-28,755993938,1058567972,1814561910
11512,ENGI3,2020-09-30,2020-11-12,755993938,1058567972,1814561910
11513,ENGI3,2020-12-31,2021-03-11,250588254,999267963,1249856217
11514,ENGI4,2010-12-31,2011-03-21,522604,577253,1099857
11515,ENGI4,2011-03-31,2012-02-17,522604,577253,1099857
11516,ENGI4,2011-06-30,2012-02-27,522604,577253,1099857
11517,ENGI4,2011-09-30,2012-02-17,522604,577253,1099857
11518,ENGI4,2011-12-31,2012-03-09,522604,577253,1099857
11519,ENGI4,2012-03-31,2012-07-03,522604,577253,1099857
11520,ENGI4,2012-06-30,2012-08-14,522604096,577253459,1099857555
11521,ENGI4,2012-09-30,2012-11-08,522604096,577253459,1099857555
11522,ENGI4,2012-12-31,2013-03-05,522604,577253,1099857
11523,ENGI4,2013-03-31,2013-05-16,522604096,577253459,1099857555
11524,ENGI4,2013-06-30,2013-08-09,592714397,652976492,1245690889
11525,ENGI4,2013-09-30,2013-11-08,592714397,652976492,1245690889
11526,ENGI4,2013-12-31,2014-03-18,592714,652976,1245690
11527,ENGI4,2014-03-31,2014-05-16,592714397,652976492,1245690889
11528,ENGI4,2014-06-30,2014-09-19,592714397,652976492,1245690889
11529,ENGI4,2014-09-30,2015-01-27,592714397,652976492,1245690889
11530,ENGI4,2014-12-31,2015-03-27,592714,652976,1245690
11531,ENGI4,2015-03-31,2015-05-15,592714397,652976492,1245690889
11532,ENGI4,2015-06-30,2015-08-14,592714397,652976492,1245690889
11533,ENGI4,2015-09-30,2015-11-13,592714397,652976492,1245690889
11534,ENGI4,2015-12-31,2016-03-22,641553,695047,1336600
11535,ENGI4,2016-03-31,2016-07-05,641553423,695046557,1336599980
11536,ENGI4,2016-06-30,2016-08-12,641553423,695046557,1336599980
11537,ENGI4,2016-09-30,2016-11-11,720210378,1009616927,1729827305
11538,ENGI4,2016-12-31,2017-03-23,720210,1009617,1729827
11539,ENGI4,2017-03-31,2017-07-20,720210378,1009616927,1729827305
11540,ENGI4,2017-06-30,2017-08-18,720210378,1009616927,1729827305
11541,ENGI4,2017-09-30,2017-11-14,720210378,1009616927,1729827305
11542,ENGI4,2017-12-31,2018-03-14,720210,1009617,1729827
11543,ENGI4,2018-03-31,2018-05-10,720210378,1009616927,1729827305
11544,ENGI4,2018-06-30,2018-08-08,720210378,1009616927,1729827305
11545,ENGI4,2018-09-30,2018-11-08,720210378,1009616927,1729827305
11546,ENGI4,2018-12-31,2019-03-21,755993938,1058567972,1814561910
11547,ENGI4,2019-03-31,2019-05-09,755993938,1058567972,1814561910
11548,ENGI4,2019-06-30,2019-08-08,755993938,1058567972,1814561910
11549,ENGI4,2019-09-30,2019-11-07,755993938,1058567972,1814561910
11550,ENGI4,2019-12-31,2020-03-18,755993938,1058567972,1814561910
11551,ENGI4,2020-03-31,2020-05-14,755993938,1058567972,1814561910
11552,ENGI4,2020-06-30,2020-08-28,755993938,1058567972,1814561910
11553,ENGI4,2020-09-30,2020-11-12,755993938,1058567972,1814561910
11554,ENGI4,2020-12-31,2021-03-11,250588254,999267963,1249856217
11555,FRRN3B,2010-12-31,2011-03-30,690816080,16726960,707543040
11556,FRRN3B,2011-03-31,2011-05-16,690816080,16726960,707543040
11557,FRRN3B,2011-06-30,2011-08-15,690816080,16726960,707543040
11558,FRRN3B,2011-09-30,2011-11-11,690816080,16726960,707543040
11559,FRRN3B,2011-12-31,2012-03-23,690816080,16726960,707543040
11560,FRRN3B,2012-03-31,2012-05-14,690816080,16726960,707543040
11561,FRRN3B,2012-06-30,2012-08-14,690816080,16726960,707543040
11562,FRRN3B,2012-09-30,2012-11-14,690816080,16726960,707543040
11563,FRRN3B,2012-12-31,2013-03-21,690816080,74510626,765326706
11564,FRRN3B,2013-03-31,2013-05-15,690816080,74510626,765326706
11565,FRRN3B,2013-06-30,2013-08-14,690816080,74510626,765326706
11566,FRRN3B,2013-09-30,2013-11-14,690816080,74510626,765326706
11567,FRRN3B,2013-12-31,2014-03-31,690816080,74510626,765326706
11568,FRRN3B,2014-03-31,2014-05-15,690816080,74510626,765326706
11569,FRRN3B,2014-06-30,2014-08-14,690816080,74510626,765326706
11570,FRRN3B,2014-09-30,2014-11-14,690816080,69380885,760196965
11571,FRRN3B,2014-12-31,2015-04-08,690816080,69380885,760196965
11572,FRRN3B,2015-03-31,2015-06-17,690816080,69380885,760196965
11573,FRRN3B,2015-06-30,2015-09-30,690816080,74510626,765326706
11574,FRRN3B,2015-09-30,2015-11-13,690816080,74510626,765326706
11575,FRRN3B,2015-12-31,2016-03-30,690816080,74510626,765326706
11576,FRRN3B,2016-03-31,2016-05-13,690816080,74510626,765326706
11577,FRRN3B,2016-06-30,2016-08-12,690816080,74510626,765326706
11578,FRRN3B,2016-09-30,2016-11-11,690816080,74510626,765326706
11579,FRRN3B,2016-12-31,2017-03-17,1107698070,81714293,1189412363
11580,FRRN3B,2017-03-31,2017-05-15,1107698070,81714293,1189412363
11581,FRRN3B,2017-06-30,2017-08-10,1107698070,81714293,1189412363
11582,FRRN3B,2017-09-30,2017-11-13,1107698070,81714293,1189412363
11583,FRRN3B,2017-12-31,2018-03-15,1107698070,81714293,1189412363
11584,FRRN3B,2018-03-31,2018-05-14,1107698070,81714293,1189412363
11585,FRRN3B,2018-06-30,2018-08-13,1107698070,81714293,1189412363
11586,FRRN3B,2018-09-30,2018-11-13,1107698070,81714293,1189412363
11587,FRRN3B,2018-12-31,2019-02-22,1107698070,81714293,1189412363
11588,FRRN3B,2019-03-31,2019-05-14,1107698070,81714293,1189412363
11589,FRRN3B,2019-06-30,2019-08-14,1107698070,81714293,1189412363
11590,FRRN3B,2019-09-30,2019-11-12,1107698070,81714293,1189412363
11591,FRRN3B,2019-12-31,2020-02-19,1107698070,81714293,1189412363
11592,FRRN3B,2020-03-31,2020-05-29,1107698070,81714293,1189412363
11593,FRRN3B,2020-06-30,2020-08-14,1107698070,81714293,1189412363
11594,FRRN3B,2020-09-30,2020-11-12,1107698070,81714293,1189412363
11595,FRRN3B,2020-12-31,2021-03-17,1107698070,81714293,1189412363
11596,FRRN5B,2010-12-31,2011-03-30,690816080,16726960,707543040
11597,FRRN5B,2011-03-31,2011-05-16,690816080,16726960,707543040
11598,FRRN5B,2011-06-30,2011-08-15,690816080,16726960,707543040
11599,FRRN5B,2011-09-30,2011-11-11,690816080,16726960,707543040
11600,FRRN5B,2011-12-31,2012-03-23,690816080,16726960,707543040
11601,FRRN5B,2012-03-31,2012-05-14,690816080,16726960,707543040
11602,FRRN5B,2012-06-30,2012-08-14,690816080,16726960,707543040
11603,FRRN5B,2012-09-30,2012-11-14,690816080,16726960,707543040
11604,FRRN5B,2012-12-31,2013-03-21,690816080,74510626,765326706
11605,FRRN5B,2013-03-31,2013-05-15,690816080,74510626,765326706
11606,FRRN5B,2013-06-30,2013-08-14,690816080,74510626,765326706
11607,FRRN5B,2013-09-30,2013-11-14,690816080,74510626,765326706
11608,FRRN5B,2013-12-31,2014-03-31,690816080,74510626,765326706
11609,FRRN5B,2014-03-31,2014-05-15,690816080,74510626,765326706
11610,FRRN5B,2014-06-30,2014-08-14,690816080,74510626,765326706
11611,FRRN5B,2014-09-30,2014-11-14,690816080,69380885,760196965
11612,FRRN5B,2014-12-31,2015-04-08,690816080,69380885,760196965
11613,FRRN5B,2015-03-31,2015-06-17,690816080,69380885,760196965
11614,FRRN5B,2015-06-30,2015-09-30,690816080,74510626,765326706
11615,FRRN5B,2015-09-30,2015-11-13,690816080,74510626,765326706
11616,FRRN5B,2015-12-31,2016-03-30,690816080,74510626,765326706
11617,FRRN5B,2016-03-31,2016-05-13,690816080,74510626,765326706
11618,FRRN5B,2016-06-30,2016-08-12,690816080,74510626,765326706
11619,FRRN5B,2016-09-30,2016-11-11,690816080,74510626,765326706
11620,FRRN5B,2016-12-31,2017-03-17,1107698070,81714293,1189412363
11621,FRRN5B,2017-03-31,2017-05-15,1107698070,81714293,1189412363
11622,FRRN5B,2017-06-30,2017-08-10,1107698070,81714293,1189412363
11623,FRRN5B,2017-09-30,2017-11-13,1107698070,81714293,1189412363
11624,FRRN5B,2017-12-31,2018-03-15,1107698070,81714293,1189412363
11625,FRRN5B,2018-03-31,2018-05-14,1107698070,81714293,1189412363
11626,FRRN5B,2018-06-30,2018-08-13,1107698070,81714293,1189412363
11627,FRRN5B,2018-09-30,2018-11-13,1107698070,81714293,1189412363
11628,FRRN5B,2018-12-31,2019-02-22,1107698070,81714293,1189412363
11629,FRRN5B,2019-03-31,2019-05-14,1107698070,81714293,1189412363
11630,FRRN5B,2019-06-30,2019-08-14,1107698070,81714293,1189412363
11631,FRRN5B,2019-09-30,2019-11-12,1107698070,81714293,1189412363
11632,FRRN5B,2019-12-31,2020-02-19,1107698070,81714293,1189412363
11633,FRRN5B,2020-03-31,2020-05-29,1107698070,81714293,1189412363
11634,FRRN5B,2020-06-30,2020-08-14,1107698070,81714293,1189412363
11635,FRRN5B,2020-09-30,2020-11-12,1107698070,81714293,1189412363
11636,FRRN5B,2020-12-31,2021-03-17,1107698070,81714293,1189412363
11637,FRRN6B,2010-12-31,2011-03-30,690816080,16726960,707543040
11638,FRRN6B,2011-03-31,2011-05-16,690816080,16726960,707543040
11639,FRRN6B,2011-06-30,2011-08-15,690816080,16726960,707543040
11640,FRRN6B,2011-09-30,2011-11-11,690816080,16726960,707543040
11641,FRRN6B,2011-12-31,2012-03-23,690816080,16726960,707543040
11642,FRRN6B,2012-03-31,2012-05-14,690816080,16726960,707543040
11643,FRRN6B,2012-06-30,2012-08-14,690816080,16726960,707543040
11644,FRRN6B,2012-09-30,2012-11-14,690816080,16726960,707543040
11645,FRRN6B,2012-12-31,2013-03-21,690816080,74510626,765326706
11646,FRRN6B,2013-03-31,2013-05-15,690816080,74510626,765326706
11647,FRRN6B,2013-06-30,2013-08-14,690816080,74510626,765326706
11648,FRRN6B,2013-09-30,2013-11-14,690816080,74510626,765326706
11649,FRRN6B,2013-12-31,2014-03-31,690816080,74510626,765326706
11650,FRRN6B,2014-03-31,2014-05-15,690816080,74510626,765326706
11651,FRRN6B,2014-06-30,2014-08-14,690816080,74510626,765326706
11652,FRRN6B,2014-09-30,2014-11-14,690816080,69380885,760196965
11653,FRRN6B,2014-12-31,2015-04-08,690816080,69380885,760196965
11654,FRRN6B,2015-03-31,2015-06-17,690816080,69380885,760196965
11655,FRRN6B,2015-06-30,2015-09-30,690816080,74510626,765326706
11656,FRRN6B,2015-09-30,2015-11-13,690816080,74510626,765326706
11657,FRRN6B,2015-12-31,2016-03-30,690816080,74510626,765326706
11658,FRRN6B,2016-03-31,2016-05-13,690816080,74510626,765326706
11659,FRRN6B,2016-06-30,2016-08-12,690816080,74510626,765326706
11660,FRRN6B,2016-09-30,2016-11-11,690816080,74510626,765326706
11661,FRRN6B,2016-12-31,2017-03-17,1107698070,81714293,1189412363
11662,FRRN6B,2017-03-31,2017-05-15,1107698070,81714293,1189412363
11663,FRRN6B,2017-06-30,2017-08-10,1107698070,81714293,1189412363
11664,FRRN6B,2017-09-30,2017-11-13,1107698070,81714293,1189412363
11665,FRRN6B,2017-12-31,2018-03-15,1107698070,81714293,1189412363
11666,FRRN6B,2018-03-31,2018-05-14,1107698070,81714293,1189412363
11667,FRRN6B,2018-06-30,2018-08-13,1107698070,81714293,1189412363
11668,FRRN6B,2018-09-30,2018-11-13,1107698070,81714293,1189412363
11669,FRRN6B,2018-12-31,2019-02-22,1107698070,81714293,1189412363
11670,FRRN6B,2019-03-31,2019-05-14,1107698070,81714293,1189412363
11671,FRRN6B,2019-06-30,2019-08-14,1107698070,81714293,1189412363
11672,FRRN6B,2019-09-30,2019-11-12,1107698070,81714293,1189412363
11673,FRRN6B,2019-12-31,2020-02-19,1107698070,81714293,1189412363
11674,FRRN6B,2020-03-31,2020-05-29,1107698070,81714293,1189412363
11675,FRRN6B,2020-06-30,2020-08-14,1107698070,81714293,1189412363
11676,FRRN6B,2020-09-30,2020-11-12,1107698070,81714293,1189412363
11677,FRRN6B,2020-12-31,2021-03-17,1107698070,81714293,1189412363
11678,VSPT3,2010-12-31,2011-02-24,210197577031,66665,210197643696
11679,VSPT3,2011-03-31,2011-05-06,210197577031,66665,210197643696
11680,VSPT3,2011-06-30,2011-07-28,210197577031,66665,210197643696
11681,VSPT3,2011-09-30,2011-10-26,210197577031,66665,210197643696
11682,VSPT3,2011-12-31,2012-04-02,210197577031,66665,210197643696
11683,VSPT3,2012-03-31,2012-04-24,210197577031,66665,210197643696
11684,VSPT3,2012-06-30,2012-07-24,210197577031,66665,210197643696
11685,VSPT3,2012-09-30,2012-10-24,210197577031,66665,210197643696
11686,VSPT3,2012-12-31,2013-03-21,210197577031,66665,210197643696
11687,VSPT3,2013-03-31,2013-04-24,210197577031,66665,210197643696
11688,VSPT3,2013-06-30,2013-08-06,210197577031,66665,210197643696
11689,VSPT3,2013-09-30,2013-11-05,210197577031,66665,210197643696
11690,VSPT3,2013-12-31,2014-03-25,210197577031,66665,210197643696
11691,VSPT3,2014-03-31,2014-05-15,210197577031,66665,210197643696
11692,VSPT3,2014-06-30,2014-08-14,210197577031,66665,210197643696
11693,VSPT3,2014-09-30,2014-11-20,210197577031,66665,210197643696
11694,VSPT3,2014-12-31,2015-03-26,210197577031,66665,210197643696
11695,VSPT3,2015-03-31,2015-05-08,210197577031,66665,210197643696
11696,VSPT3,2015-06-30,2015-08-14,210197577031,66665,210197643696
11697,VSPT3,2015-09-30,2015-11-13,210197577031,66665,210197643696
11698,VSPT3,2015-12-31,2016-03-30,210197577031,66665,210197643696
11699,VSPT3,2016-03-31,2016-05-11,210197577031,66665,210197643696
11700,VSPT3,2016-06-30,2016-08-10,210197577031,66665,210197643696
11701,VSPT3,2016-09-30,2016-11-14,210197577031,66665,210197643696
11702,VSPT3,2016-12-31,2017-03-24,367645433927,66665,367645500592
11703,VSPT3,2017-03-31,2017-05-15,367645433927,66665,367645500592
11704,VSPT3,2017-06-30,2017-08-11,367645433926,66665,367645500591
11705,VSPT3,2017-09-30,2017-11-10,367645433926,66665,367645500591
11706,VSPT3,2017-12-31,2018-03-26,110293641,19,110293660
11707,VSPT3,2018-03-31,2018-05-15,110293641,19,110293660
11708,VSPT3,2018-06-30,2018-08-10,112303527,19,112303546
11709,VSPT3,2018-09-30,2018-11-14,112303527,19,112303546
11710,VSPT3,2018-12-31,2019-04-18,112303527,19,112303546
11711,VSPT3,2019-03-31,2019-07-12,112303527,19,112303546
11712,VSPT3,2019-06-30,2019-08-14,125445701,19,125445720
11713,VSPT3,2019-09-30,2019-11-08,125445701,19,125445720
11714,VSPT3,2019-12-31,2020-05-29,125445701,19,125445720
11715,VSPT3,2020-03-31,2020-06-29,125445701,19,125445720
11716,VSPT3,2020-06-30,2020-08-07,125445701,19,125445720
11717,VSPT3,2020-09-30,2020-11-06,125445701,19,125445720
11718,VSPT3,2020-12-31,2021-02-25,136242616,19,136242635
11719,VSPT4,2010-12-31,2011-02-24,210197577031,66665,210197643696
11720,VSPT4,2011-03-31,2011-05-06,210197577031,66665,210197643696
11721,VSPT4,2011-06-30,2011-07-28,210197577031,66665,210197643696
11722,VSPT4,2011-09-30,2011-10-26,210197577031,66665,210197643696
11723,VSPT4,2011-12-31,2012-04-02,210197577031,66665,210197643696
11724,VSPT4,2012-03-31,2012-04-24,210197577031,66665,210197643696
11725,VSPT4,2012-06-30,2012-07-24,210197577031,66665,210197643696
11726,VSPT4,2012-09-30,2012-10-24,210197577031,66665,210197643696
11727,VSPT4,2012-12-31,2013-03-21,210197577031,66665,210197643696
11728,VSPT4,2013-03-31,2013-04-24,210197577031,66665,210197643696
11729,VSPT4,2013-06-30,2013-08-06,210197577031,66665,210197643696
11730,VSPT4,2013-09-30,2013-11-05,210197577031,66665,210197643696
11731,VSPT4,2013-12-31,2014-03-25,210197577031,66665,210197643696
11732,VSPT4,2014-03-31,2014-05-15,210197577031,66665,210197643696
11733,VSPT4,2014-06-30,2014-08-14,210197577031,66665,210197643696
11734,VSPT4,2014-09-30,2014-11-20,210197577031,66665,210197643696
11735,VSPT4,2014-12-31,2015-03-26,210197577031,66665,210197643696
11736,VSPT4,2015-03-31,2015-05-08,210197577031,66665,210197643696
11737,VSPT4,2015-06-30,2015-08-14,210197577031,66665,210197643696
11738,VSPT4,2015-09-30,2015-11-13,210197577031,66665,210197643696
11739,VSPT4,2015-12-31,2016-03-30,210197577031,66665,210197643696
11740,VSPT4,2016-03-31,2016-05-11,210197577031,66665,210197643696
11741,VSPT4,2016-06-30,2016-08-10,210197577031,66665,210197643696
11742,VSPT4,2016-09-30,2016-11-14,210197577031,66665,210197643696
11743,VSPT4,2016-12-31,2017-03-24,367645433927,66665,367645500592
11744,VSPT4,2017-03-31,2017-05-15,367645433927,66665,367645500592
11745,VSPT4,2017-06-30,2017-08-11,367645433926,66665,367645500591
11746,VSPT4,2017-09-30,2017-11-10,367645433926,66665,367645500591
11747,VSPT4,2017-12-31,2018-03-26,110293641,19,110293660
11748,VSPT4,2018-03-31,2018-05-15,110293641,19,110293660
11749,VSPT4,2018-06-30,2018-08-10,112303527,19,112303546
11750,VSPT4,2018-09-30,2018-11-14,112303527,19,112303546
11751,VSPT4,2018-12-31,2019-04-18,112303527,19,112303546
11752,VSPT4,2019-03-31,2019-07-12,112303527,19,112303546
11753,VSPT4,2019-06-30,2019-08-14,125445701,19,125445720
11754,VSPT4,2019-09-30,2019-11-08,125445701,19,125445720
11755,VSPT4,2019-12-31,2020-05-29,125445701,19,125445720
11756,VSPT4,2020-03-31,2020-06-29,125445701,19,125445720
11757,VSPT4,2020-06-30,2020-08-07,125445701,19,125445720
11758,VSPT4,2020-09-30,2020-11-06,125445701,19,125445720
11759,VSPT4,2020-12-31,2021-02-25,136242616,19,136242635
11760,ATOM3,2010-12-31,2011-03-31,88485,0,88485
11761,ATOM3,2011-03-31,2011-05-16,88485,0,88485
11762,ATOM3,2011-06-30,2011-08-15,88485,0,88485
11763,ATOM3,2011-09-30,2011-11-18,88485,0,88485
11764,ATOM3,2011-12-31,2012-03-30,88485,0,88485
11765,ATOM3,2012-03-31,2012-05-15,88485,0,88485
11766,ATOM3,2012-06-30,2012-08-14,88485,0,88485
11767,ATOM3,2012-09-30,2012-11-14,88485,0,88485
11768,ATOM3,2012-12-31,2013-03-28,88485,0,88485
11769,ATOM3,2013-03-31,2013-05-15,88485,0,88485
11770,ATOM3,2013-06-30,2013-08-14,88485,0,88485
11771,ATOM3,2013-09-30,2013-11-13,88485,0,88485
11772,ATOM3,2013-12-31,2014-03-28,313485,0,313485
11773,ATOM3,2014-03-31,2014-05-15,313485,0,313485
11774,ATOM3,2014-06-30,2014-08-14,313485,0,313485
11775,ATOM3,2014-09-30,2014-11-18,313485,0,313485
11776,ATOM3,2014-12-31,2015-05-12,313485,0,313485
11777,ATOM3,2015-03-31,2015-06-09,313485,0,313485
11778,ATOM3,2015-06-30,2015-08-28,313485,0,313485
11779,ATOM3,2015-09-30,2015-11-13,313485,0,313485
11780,ATOM3,2015-12-31,2016-03-10,313485,0,313485
11781,ATOM3,2016-03-31,2016-05-11,313485,0,313485
11782,ATOM3,2016-06-30,2016-08-03,62697,0,62697
11783,ATOM3,2016-09-30,2016-10-24,20898,0,20898
11784,ATOM3,2016-12-31,2017-02-07,20898,0,20898
11785,ATOM3,2017-03-31,2017-05-08,20898,0,20898
11786,ATOM3,2017-06-30,2019-09-16,20898,0,20898
11787,ATOM3,2017-09-30,2019-09-16,20898,0,20898
11788,ATOM3,2017-12-31,2019-09-16,20898,0,20898
11789,ATOM3,2018-03-31,2019-04-26,20898,0,20898
11790,ATOM3,2018-06-30,2019-04-26,20898,0,20898
11791,ATOM3,2018-09-30,2019-04-26,20898,0,20898
11792,ATOM3,2018-12-31,2020-05-22,20898,0,20898
11793,ATOM3,2019-03-31,2020-05-22,20898,0,20898
11794,ATOM3,2019-06-30,2020-05-22,20898,0,20898
11795,ATOM3,2019-09-30,2020-05-22,20898,0,20898
11796,ATOM3,2019-12-31,2020-05-22,20898,0,20898
11797,ATOM3,2020-03-31,2020-05-25,20898,0,20898
11798,ATOM3,2020-06-30,2020-07-31,20898,0,20898
11799,ATOM3,2020-09-30,2020-11-09,20898,0,20898
11800,ATOM3,2020-12-31,2021-03-17,20898,0,20898
11801,BTTL3,2010-12-31,2011-03-28,49912,99766,149678
11802,BTTL3,2011-03-31,2011-05-13,49912,99766,149678
11803,BTTL3,2011-06-30,2011-08-15,49912,99766,149678
11804,BTTL3,2011-09-30,2011-11-11,49912,99766,149678
11805,BTTL3,2011-12-31,2012-03-20,49912,99766,149678
11806,BTTL3,2012-03-31,2012-05-14,49912,99766,149678
11807,BTTL3,2012-06-30,2012-08-16,49912,99766,149678
11808,BTTL3,2012-09-30,2012-11-14,49912,99766,149678
11809,BTTL3,2012-12-31,2013-03-21,49912,99766,149678
11810,BTTL3,2013-03-31,2013-05-15,49912,99766,149678
11811,BTTL3,2013-06-30,2013-08-14,49912,99766,149678
11812,BTTL3,2013-09-30,2013-11-14,49912,99766,149678
11813,BTTL3,2013-12-31,2014-03-17,49912,99766,149678
11814,BTTL3,2014-03-31,2014-05-09,49912,99766,149678
11815,BTTL3,2014-06-30,2014-08-15,49912,99766,149678
11816,BTTL3,2014-09-30,2014-11-14,49912,99766,149678
11817,BTTL3,2014-12-31,2015-04-24,49912,99766,149678
11818,BTTL3,2015-03-31,2015-05-15,49912,99766,149678
11819,BTTL3,2015-06-30,2015-08-14,49912,99766,149678
11820,BTTL3,2015-09-30,2015-11-16,49912,99766,149678
11821,BTTL3,2015-12-31,2016-03-29,1996,3991,5987
11822,BTTL3,2016-03-31,2016-05-13,1996,3991,5987
11823,BTTL3,2016-06-30,2016-10-24,1996,3991,5987
11824,BTTL3,2016-09-30,2016-12-07,1996,3991,5987
11825,BTTL3,2016-12-31,2017-03-24,5120,10239,15359
11826,BTTL3,2017-03-31,2017-05-15,5120,10239,15359
11827,BTTL3,2017-06-30,2017-08-14,5120,10239,15359
11828,BTTL3,2017-09-30,2017-11-20,12409,2950,15359
11829,BTTL3,2017-12-31,2018-04-04,12409,2950,15359
11830,BTTL3,2018-03-31,2018-05-15,12409,2950,15359
11831,BTTL3,2018-06-30,2018-08-15,12409,2950,15359
11832,BTTL3,2018-09-30,2018-11-16,12409,2950,15359
11833,BTTL3,2018-12-31,2019-03-28,15359,0,15359
11834,BTTL3,2019-03-31,2019-05-13,15359,0,15359
11835,BTTL3,2019-06-30,2019-08-14,15359,0,15359
11836,BTTL3,2019-09-30,2019-11-12,15359,0,15359
11837,BTTL3,2019-12-31,2020-12-21,14860,0,14860
11838,BTTL3,2020-03-31,2020-12-21,14860,0,14860
11839,BTTL3,2020-06-30,2020-12-21,14860,0,14860
11840,BTTL3,2020-09-30,2020-12-07,14860,0,14860
11841,NEOE3,2010-12-31,2011-02-19,5850636,0,5850636
11842,NEOE3,2011-03-31,2011-05-13,5850636,0,5850636
11843,NEOE3,2011-06-30,2011-08-03,5850636,0,5850636
11844,NEOE3,2011-09-30,2011-10-31,5850636,0,5850636
11845,NEOE3,2011-12-31,2012-02-07,5850636,0,5850636
11846,NEOE3,2012-03-31,2012-05-04,5850636,0,5850636
11847,NEOE3,2012-06-30,2012-07-27,5850636,0,5850636
11848,NEOE3,2012-09-30,2012-11-14,5850636,0,5850636
11849,NEOE3,2012-12-31,2013-03-25,5850636,0,5850636
11850,NEOE3,2013-03-31,2013-05-21,5850636,0,5850636
11851,NEOE3,2013-06-30,2013-08-23,5850636,0,5850636
11852,NEOE3,2013-09-30,2013-11-08,5850636,0,5850636
11853,NEOE3,2013-12-31,2014-03-24,5850636,0,5850636
11854,NEOE3,2014-03-31,2014-05-15,5850636,0,5850636
11855,NEOE3,2014-06-30,2014-08-14,5850636,0,5850636
11856,NEOE3,2014-09-30,2014-11-12,5850636,0,5850636
11857,NEOE3,2014-12-31,2017-11-28,5850636,0,5850636
11858,NEOE3,2015-03-31,2015-05-14,5850636,0,5850636
11859,NEOE3,2015-06-30,2015-08-13,5850636,0,5850636
11860,NEOE3,2015-09-30,2015-11-12,5850636,0,5850636
11861,NEOE3,2015-12-31,2017-11-28,5850636,0,5850636
11862,NEOE3,2016-03-31,2016-05-12,5850636,0,5850636
11863,NEOE3,2016-06-30,2016-08-11,5850636,0,5850636
11864,NEOE3,2016-09-30,2016-11-11,5850636,0,5850636
11865,NEOE3,2016-12-31,2019-04-24,779590,0,779590
11866,NEOE3,2017-03-31,2017-08-10,5850636,0,5850636
11867,NEOE3,2017-06-30,2017-11-06,5850636,0,5850636
11868,NEOE3,2017-09-30,2017-11-28,7504760,0,7504760
11869,NEOE3,2017-12-31,2019-04-23,1154167,0,1154167
11870,NEOE3,2018-03-31,2018-04-23,1213797,0,1213797
11871,NEOE3,2018-06-30,2018-07-31,1213797,0,1213797
11872,NEOE3,2018-09-30,2018-10-22,1213797,0,1213797
11873,NEOE3,2018-12-31,2019-04-23,1213797,0,1213797
11874,NEOE3,2019-03-31,2019-04-24,1213797,0,1213797
11875,NEOE3,2019-06-30,2019-07-24,1213797,0,1213797
11876,NEOE3,2019-09-30,2019-10-21,1213797,0,1213797
11877,NEOE3,2019-12-31,2020-02-17,1213797,0,1213797
11878,NEOE3,2020-03-31,2020-04-27,1213797,0,1213797
11879,NEOE3,2020-06-30,2020-07-21,1213797,0,1213797
11880,NEOE3,2020-09-30,2020-10-20,1213797,0,1213797
11881,NEOE3,2020-12-31,2021-02-09,1213797,0,1213797
11882,CGAS3,2010-12-31,2011-03-25,93911,25912,119823
11883,CGAS3,2011-03-31,2011-04-27,93911,25912,119823
11884,CGAS3,2011-06-30,2011-07-25,93911,25912,119823
11885,CGAS3,2011-09-30,2011-10-24,93911,25912,119823
11886,CGAS3,2011-12-31,2012-02-17,93911,25912,119823
11887,CGAS3,2012-03-31,2012-05-02,93911,25912,119823
11888,CGAS3,2012-06-30,2012-07-25,93911,25912,119823
11889,CGAS3,2012-09-30,2012-10-30,93911,25912,119823
11890,CGAS3,2012-12-31,2013-05-07,93911,25912,119823
11891,CGAS3,2013-03-31,2013-07-05,93911,25912,119823
11892,CGAS3,2013-06-30,2013-08-06,93911,25912,119823
11893,CGAS3,2013-09-30,2013-11-05,93911,25912,119823
11894,CGAS3,2013-12-31,2014-02-25,93911,25912,119823
11895,CGAS3,2014-03-31,2014-05-12,93911,25912,119823
11896,CGAS3,2014-06-30,2014-08-12,95516,26355,121871
11897,CGAS3,2014-09-30,2014-11-04,95516,26355,121871
11898,CGAS3,2014-12-31,2015-03-17,95516,26355,121871
11899,CGAS3,2015-03-31,2015-05-05,95516,26355,121871
11900,CGAS3,2015-06-30,2015-08-10,97192,26817,124009
11901,CGAS3,2015-09-30,2015-11-05,97192,26817,124009
11902,CGAS3,2015-12-31,2016-02-18,97192,26817,124009
11903,CGAS3,2016-03-31,2016-05-11,97192,26817,124009
11904,CGAS3,2016-06-30,2016-08-09,99782,27531,127313
11905,CGAS3,2016-09-30,2016-10-28,99782,27531,127313
11906,CGAS3,2016-12-31,2017-02-15,99782,27531,127313
11907,CGAS3,2017-03-31,2017-05-08,99782,27531,127313
11908,CGAS3,2017-06-30,2017-08-08,101917,28121,130038
11909,CGAS3,2017-09-30,2017-11-07,101917,28121,130038
11910,CGAS3,2017-12-31,2018-02-22,101917264,28121015,130038279
11911,CGAS3,2018-03-31,2018-05-11,101917264,28121015,130038279
11912,CGAS3,2018-06-30,2018-08-07,103472982,28550269,132023251
11913,CGAS3,2018-09-30,2018-11-06,103472982,28550269,132023251
11914,CGAS3,2018-12-31,2019-02-13,103472982,28550269,132023251
11915,CGAS3,2019-03-31,2019-05-07,103862768,28657819,132520587
11916,CGAS3,2019-06-30,2019-08-07,103862768,28657819,132520587
11917,CGAS3,2019-09-30,2019-11-06,103862768,28657819,132520587
11918,CGAS3,2019-12-31,2020-02-14,103862768,28657819,132520587
11919,CGAS3,2020-03-31,2020-05-25,103862768,28657819,132520587
11920,CGAS3,2020-06-30,2020-08-04,103862768,28657819,132520587
11921,CGAS3,2020-09-30,2020-11-12,103862768,28657819,132520587
11922,CGAS3,2020-12-31,2021-02-10,103862768,28657819,132520587
11923,CGAS5,2010-12-31,2011-03-25,93911,25912,119823
11924,CGAS5,2011-03-31,2011-04-27,93911,25912,119823
11925,CGAS5,2011-06-30,2011-07-25,93911,25912,119823
11926,CGAS5,2011-09-30,2011-10-24,93911,25912,119823
11927,CGAS5,2011-12-31,2012-02-17,93911,25912,119823
11928,CGAS5,2012-03-31,2012-05-02,93911,25912,119823
11929,CGAS5,2012-06-30,2012-07-25,93911,25912,119823
11930,CGAS5,2012-09-30,2012-10-30,93911,25912,119823
11931,CGAS5,2012-12-31,2013-05-07,93911,25912,119823
11932,CGAS5,2013-03-31,2013-07-05,93911,25912,119823
11933,CGAS5,2013-06-30,2013-08-06,93911,25912,119823
11934,CGAS5,2013-09-30,2013-11-05,93911,25912,119823
11935,CGAS5,2013-12-31,2014-02-25,93911,25912,119823
11936,CGAS5,2014-03-31,2014-05-12,93911,25912,119823
11937,CGAS5,2014-06-30,2014-08-12,95516,26355,121871
11938,CGAS5,2014-09-30,2014-11-04,95516,26355,121871
11939,CGAS5,2014-12-31,2015-03-17,95516,26355,121871
11940,CGAS5,2015-03-31,2015-05-05,95516,26355,121871
11941,CGAS5,2015-06-30,2015-08-10,97192,26817,124009
11942,CGAS5,2015-09-30,2015-11-05,97192,26817,124009
11943,CGAS5,2015-12-31,2016-02-18,97192,26817,124009
11944,CGAS5,2016-03-31,2016-05-11,97192,26817,124009
11945,CGAS5,2016-06-30,2016-08-09,99782,27531,127313
11946,CGAS5,2016-09-30,2016-10-28,99782,27531,127313
11947,CGAS5,2016-12-31,2017-02-15,99782,27531,127313
11948,CGAS5,2017-03-31,2017-05-08,99782,27531,127313
11949,CGAS5,2017-06-30,2017-08-08,101917,28121,130038
11950,CGAS5,2017-09-30,2017-11-07,101917,28121,130038
11951,CGAS5,2017-12-31,2018-02-22,101917264,28121015,130038279
11952,CGAS5,2018-03-31,2018-05-11,101917264,28121015,130038279
11953,CGAS5,2018-06-30,2018-08-07,103472982,28550269,132023251
11954,CGAS5,2018-09-30,2018-11-06,103472982,28550269,132023251
11955,CGAS5,2018-12-31,2019-02-13,103472982,28550269,132023251
11956,CGAS5,2019-03-31,2019-05-07,103862768,28657819,132520587
11957,CGAS5,2019-06-30,2019-08-07,103862768,28657819,132520587
11958,CGAS5,2019-09-30,2019-11-06,103862768,28657819,132520587
11959,CGAS5,2019-12-31,2020-02-14,103862768,28657819,132520587
11960,CGAS5,2020-03-31,2020-05-25,103862768,28657819,132520587
11961,CGAS5,2020-06-30,2020-08-04,103862768,28657819,132520587
11962,CGAS5,2020-09-30,2020-11-12,103862768,28657819,132520587
11963,CGAS5,2020-12-31,2021-02-10,103862768,28657819,132520587
11964,LIPR3,2010-12-31,2011-05-12,11765,0,11765
11965,LIPR3,2011-03-31,2011-06-20,11765,0,11765
11966,LIPR3,2011-06-30,2011-08-22,11765,0,11765
11967,LIPR3,2011-09-30,2011-11-10,11764,0,11764
11968,LIPR3,2011-12-31,2012-03-30,11764,0,11764
11969,LIPR3,2012-03-31,2012-05-15,11764,0,11764
11970,LIPR3,2012-06-30,2012-08-14,11764,0,11764
11971,LIPR3,2012-09-30,2012-11-14,11764,0,11764
11972,LIPR3,2012-12-31,2013-03-26,11764,0,11764
11973,LIPR3,2013-03-31,2013-05-15,11764,0,11764
11974,LIPR3,2013-06-30,2013-08-14,11764,0,11764
11975,LIPR3,2013-09-30,2013-11-14,11764,0,11764
11976,LIPR3,2013-12-31,2014-03-27,11764,0,11764
11977,LIPR3,2014-03-30,2014-05-15,11764,0,11764
11978,LIPR3,2014-06-30,2014-08-12,11764,0,11764
11979,LIPR3,2014-09-30,2014-11-14,11764,0,11764
11980,LIPR3,2014-12-31,2015-03-27,11764,0,11764
11981,LIPR3,2015-03-31,2015-05-15,11764,0,11764
11982,LIPR3,2015-06-30,2015-08-14,11764,0,11764
11983,LIPR3,2015-09-30,2015-11-12,11764,0,11764
11984,LIPR3,2015-12-31,2016-03-30,11764,0,11764
11985,LIPR3,2016-03-31,2016-05-11,11764,0,11764
11986,LIPR3,2016-06-30,2016-08-15,11764,0,11764
11987,LIPR3,2016-09-30,2016-11-09,11764,0,11764
11988,LIPR3,2016-12-31,2017-03-27,11764,0,11764
11989,LIPR3,2017-03-31,2017-05-12,11764,0,11764
11990,LIPR3,2017-06-30,2017-08-10,11764,0,11764
11991,LIPR3,2017-09-30,2017-11-13,11764,0,11764
11992,LIPR3,2017-12-31,2018-03-26,11764,0,11764
11993,LIPR3,2018-03-31,2018-05-15,11764,0,11764
11994,LIPR3,2018-06-30,2018-08-14,11764,0,11764
11995,LIPR3,2018-09-30,2018-11-12,11764,0,11764
11996,LIPR3,2018-12-31,2019-03-27,11764,0,11764
11997,LIPR3,2019-03-31,2019-05-13,11764,0,11764
11998,LIPR3,2019-06-30,2019-08-12,11764,0,11764
11999,LIPR3,2019-09-30,2019-11-11,11764,0,11764
12000,LIPR3,2019-12-31,2020-03-27,11764,0,11764
12001,LIPR3,2020-03-31,2020-05-28,11764,0,11764
12002,LIPR3,2020-06-30,2020-08-12,11764,0,11764
12003,LIPR3,2020-09-30,2020-11-11,11764,0,11764
12004,LIPR3,2020-12-31,2021-03-19,11764,0,11764
12005,GFSA3,2010-12-31,2011-03-28,431515,0,431515
12006,GFSA3,2011-03-31,2011-05-10,431984,0,431984
12007,GFSA3,2011-06-30,2011-08-11,432137,0,432137
12008,GFSA3,2011-09-30,2011-11-24,432515,0,432515
12009,GFSA3,2011-12-31,2012-04-19,432099,0,432099
12010,GFSA3,2012-03-31,2012-05-08,432099,0,432099
12011,GFSA3,2012-06-30,2012-08-10,432872,0,432872
12012,GFSA3,2012-09-30,2012-11-12,432872,0,432872
12013,GFSA3,2012-12-31,2013-03-11,433230,0,433230
12014,GFSA3,2013-03-31,2013-05-10,431629,0,431629
12015,GFSA3,2013-06-30,2013-08-12,435099,0,435099
12016,GFSA3,2013-09-30,2013-11-05,435380,0,435380
12017,GFSA3,2013-12-31,2014-02-26,435559,0,435559
12018,GFSA3,2014-03-31,2014-05-09,435559,0,435559
12019,GFSA3,2014-06-30,2014-08-08,435559,0,435559
12020,GFSA3,2014-09-30,2014-11-07,435559,0,435559
12021,GFSA3,2014-12-31,2015-02-27,408066,0,408066
12022,GFSA3,2015-03-31,2015-05-07,378066,0,378066
12023,GFSA3,2015-06-30,2015-08-07,378066,0,378066
12024,GFSA3,2015-09-30,2015-11-06,378066,0,378066
12025,GFSA3,2015-12-31,2016-03-03,378066,0,378066
12026,GFSA3,2016-03-31,2016-05-05,378066,0,378066
12027,GFSA3,2016-06-30,2016-08-11,378066,0,378066
12028,GFSA3,2016-09-30,2016-11-08,378066,0,378066
12029,GFSA3,2016-12-31,2017-05-09,378066,0,378066
12030,GFSA3,2017-03-31,2017-05-09,28040,0,28040
12031,GFSA3,2017-06-30,2017-08-10,28040,0,28040
12032,GFSA3,2017-09-30,2017-11-09,28040,0,28040
12033,GFSA3,2017-12-31,2018-03-09,28040,0,28040
12034,GFSA3,2018-03-31,2018-05-10,44758,0,44758
12035,GFSA3,2018-06-30,2018-08-09,44758,0,44758
12036,GFSA3,2018-09-30,2018-11-08,44758,0,44758
12037,GFSA3,2018-12-31,2019-04-03,43728,0,43728
12038,GFSA3,2019-03-31,2019-05-14,43358,0,43358
12039,GFSA3,2019-06-30,2019-08-14,71032,0,71032
12040,GFSA3,2019-09-30,2019-11-08,71032,0,71032
12041,GFSA3,2019-12-31,2020-03-26,120000,0,120000
12042,GFSA3,2020-03-31,2020-05-14,120000,0,120000
12043,GFSA3,2020-06-30,2020-08-11,120000,0,120000
12044,GFSA3,2020-09-30,2020-11-16,290732,0,290732
12045,GFSA3,2020-12-31,2021-03-16,300676,0,300676
12046,ETRO3B,2010-12-31,2011-03-30,3106083,0,3106083
12047,ETRO3B,2011-03-31,2011-05-16,3958855,0,3958855
12048,ETRO3B,2011-06-30,2011-08-15,4513019,0,4513019
12049,ETRO3B,2011-09-30,2011-11-14,4946516,0,4946516
12050,ETRO3B,2011-12-31,2012-06-27,5562545,0,5562545
12051,ETRO3B,2012-03-31,2012-05-11,5562545,0,5562545
12052,ETRO3B,2012-06-30,2012-07-30,5562545,0,5562545
12053,ETRO3B,2012-09-30,2012-10-23,6852867,0,6852867
12054,ETRO3B,2012-12-31,2013-03-28,8913937,0,8913937
12055,ETRO3B,2013-03-31,2013-05-13,9149820,0,9149820
12056,ETRO3B,2013-06-30,2013-08-08,9187987,0,9187987
12057,ETRO3B,2013-09-30,2013-11-12,9187987,0,9187987
12058,ETRO3B,2013-12-31,2014-03-07,9330441,0,9330441
12059,ETRO3B,2014-03-31,2014-05-09,9447229,0,9447229
12060,ETRO3B,2014-06-30,2014-08-04,9447229,0,9447229
12061,ETRO3B,2014-09-30,2014-11-05,9447229,0,9447229
12062,ETRO3B,2014-12-31,2015-03-16,9855258,0,9855258
12063,ETRO3B,2015-03-31,2015-05-13,9987376,0,9987376
12064,ETRO3B,2015-06-30,2015-08-11,10904411,0,10904411
12065,ETRO3B,2015-09-30,2015-11-13,11456184,0,11456184
12066,ETRO3B,2015-12-31,2016-03-08,11684861,0,11684861
12067,ETRO3B,2016-03-31,2016-05-12,11684861,0,11684861
12068,ETRO3B,2016-06-30,2016-08-09,12052508,0,12052508
12069,ETRO3B,2016-09-30,2016-11-09,13037069,0,13037069
12070,ETRO3B,2016-12-31,2017-03-17,13037069,0,13037069
12071,ETRO3B,2017-03-31,2017-05-15,13110377,0,13110377
12072,ETRO3B,2017-06-30,2017-08-10,14228798,0,14228798
12073,ETRO3B,2017-09-30,2017-11-13,14228798,0,14228798
12074,ETRO3B,2017-12-31,2018-03-28,48740433,0,48740433
12075,ETRO3B,2018-03-31,2018-05-15,48743059,0,48743059
12076,ETRO3B,2018-06-30,2018-08-14,48743059,0,48743059
12077,ETRO3B,2018-09-30,2018-11-23,48743059,0,48743059
12078,ETRO3B,2018-12-31,2019-03-27,48743059,0,48743059
12079,ETRO3B,2019-03-31,2019-05-15,48743059,0,48743059
12080,ETRO3B,2019-06-30,2019-08-12,48743059,0,48743059
12081,ETRO3B,2019-09-30,2019-11-14,48743059,0,48743059
12082,QVQP3B,2010-12-31,2011-03-28,176263,0,176263
12083,QVQP3B,2011-03-31,2011-05-17,176261901,0,176261901
12084,QVQP3B,2011-06-30,2011-08-15,176261901,0,176261901
12085,QVQP3B,2011-09-30,2011-11-14,176261901,0,176261901
12086,QVQP3B,2011-12-31,2012-03-27,176262,0,176262
12087,QVQP3B,2012-03-31,2012-05-10,176261901,0,176261901
12088,QVQP3B,2012-06-30,2012-07-31,176261901,0,176261901
12089,QVQP3B,2012-09-30,2012-10-23,176261901,0,176261901
12090,QVQP3B,2012-12-31,2013-03-22,176262,0,176262
12091,QVQP3B,2013-03-31,2013-05-09,176262,0,176262
12092,QVQP3B,2013-06-30,2013-08-05,176262,0,176262
12093,QVQP3B,2013-09-30,2013-11-01,176262,0,176262
12094,QVQP3B,2013-12-31,2014-02-24,176262,0,176262
12095,QVQP3B,2014-03-31,2014-05-12,176262,0,176262
12096,QVQP3B,2014-06-30,2014-08-01,176262,0,176262
12097,QVQP3B,2014-09-30,2014-11-04,176262,0,176262
12098,QVQP3B,2014-12-31,2015-02-23,176262,0,176262
12099,QVQP3B,2015-03-31,2015-05-11,176262,0,176262
12100,QVQP3B,2015-06-30,2015-08-05,176262,0,176262
12101,QVQP3B,2015-09-30,2015-11-06,176262,0,176262
12102,QVQP3B,2015-12-31,2016-03-01,176262,0,176262
12103,QVQP3B,2016-03-31,2016-05-12,176262,0,176262
12104,QVQP3B,2016-06-30,2016-07-20,176262,0,176262
12105,QVQP3B,2016-09-30,2016-11-04,176262,0,176262
12106,QVQP3B,2016-12-31,2017-03-17,176262,0,176262
12107,QVQP3B,2017-03-31,2017-05-15,176262,0,176262
12108,QVQP3B,2017-06-30,2017-08-11,176262,0,176262
12109,QVQP3B,2017-09-30,2017-11-13,176262,0,176262
12110,QVQP3B,2017-12-31,2018-03-27,186262,0,186262
12111,QVQP3B,2018-03-31,2018-05-15,196262,0,196262
12112,QVQP3B,2018-06-30,2018-08-14,196262,0,196262
12113,QVQP3B,2018-09-30,2018-11-14,196262,0,196262
12114,QVQP3B,2018-12-31,2019-03-20,196262,0,196262
12115,QVQP3B,2019-03-31,2019-05-15,206262,0,206262
12116,QVQP3B,2019-06-30,2019-08-09,206262,0,206262
12117,QVQP3B,2019-09-30,2019-11-14,206262,0,206262
12118,QVQP3B,2019-12-31,2020-03-19,206261901,0,206261901
12119,QVQP3B,2020-03-31,2020-06-01,228361901,0,228361901
12120,QVQP3B,2020-06-30,2020-08-17,228361901,0,228361901
12121,QVQP3B,2020-09-30,2020-11-13,228360991,0,228360991
12122,QVQP3B,2020-12-31,2021-03-04,228361901,0,228361901
12123,BRFS3,2010-12-31,2011-04-13,872473246,0,872473246
12124,BRFS3,2011-03-31,2011-05-13,872473246,0,872473246
12125,BRFS3,2011-06-30,2011-08-11,872473246,0,872473246
12126,BRFS3,2011-09-30,2011-10-27,872473246,0,872473246
12127,BRFS3,2011-12-31,2012-03-22,872473246,0,872473246
12128,BRFS3,2012-03-31,2012-05-11,872473246,0,872473246
12129,BRFS3,2012-06-30,2012-08-13,872473246,0,872473246
12130,BRFS3,2012-09-30,2012-11-12,872473246,0,872473246
12131,BRFS3,2012-12-31,2013-03-04,872473246,0,872473246
12132,BRFS3,2013-03-31,2013-04-29,872473246,0,872473246
12133,BRFS3,2013-06-30,2013-07-29,872473246,0,872473246
12134,BRFS3,2013-09-30,2013-10-28,872473246,0,872473246
12135,BRFS3,2013-12-31,2014-02-27,872473246,0,872473246
12136,BRFS3,2014-03-31,2014-05-05,872473246,0,872473246
12137,BRFS3,2014-06-30,2014-07-31,872473246,0,872473246
12138,BRFS3,2014-09-30,2014-10-30,872473246,0,872473246
12139,BRFS3,2014-12-31,2015-02-26,872473246,0,872473246
12140,BRFS3,2015-03-31,2015-04-28,872473246,0,872473246
12141,BRFS3,2015-06-30,2015-07-30,872473246,0,872473246
12142,BRFS3,2015-09-30,2015-10-29,872473246,0,872473246
12143,BRFS3,2015-12-31,2016-02-25,872473246,0,872473246
12144,BRFS3,2016-03-31,2016-04-28,812473246,0,812473246
12145,BRFS3,2016-06-30,2016-07-28,812473246,0,812473246
12146,BRFS3,2016-09-30,2016-10-27,812473246,0,812473246
12147,BRFS3,2016-12-31,2017-02-23,812473246,0,812473246
12148,BRFS3,2017-03-31,2017-05-11,812473246,0,812473246
12149,BRFS3,2017-06-30,2017-08-10,812473246,0,812473246
12150,BRFS3,2017-09-30,2017-11-09,812473246,0,812473246
12151,BRFS3,2017-12-31,2018-02-22,812473246,0,812473246
12152,BRFS3,2018-03-31,2018-05-11,812473246,0,812473246
12153,BRFS3,2018-06-30,2018-08-10,812473246,0,812473246
12154,BRFS3,2018-09-30,2018-11-08,812473246,0,812473246
12155,BRFS3,2018-12-31,2019-02-28,812473246,0,812473246
12156,BRFS3,2019-03-31,2019-05-10,812473246,0,812473246
12157,BRFS3,2019-06-30,2019-08-09,812473246,0,812473246
12158,BRFS3,2019-09-30,2019-11-08,812473246,0,812473246
12159,BRFS3,2019-12-31,2020-03-03,812473246,0,812473246
12160,BRFS3,2020-03-31,2020-05-10,812473246,0,812473246
12161,BRFS3,2020-06-30,2020-08-14,812473246,0,812473246
12162,BRFS3,2020-09-30,2020-11-16,812473246,0,812473246
12163,BRFS3,2020-12-31,2021-02-25,812473246,0,812473246
12164,RSID3,2010-12-31,2012-10-11,266436388,0,266436388
12165,RSID3,2011-03-31,2012-10-11,266436388,0,266436388
12166,RSID3,2011-06-30,2012-10-11,268339296,0,268339296
12167,RSID3,2011-09-30,2012-11-13,268339296,0,268339296
12168,RSID3,2011-12-31,2012-10-11,268339296,0,268339296
12169,RSID3,2012-03-31,2012-10-12,268339296,0,268339296
12170,RSID3,2012-06-30,2012-10-12,268339296,0,268339296
12171,RSID3,2012-09-30,2012-11-28,268608464,0,268608464
12172,RSID3,2012-12-31,2013-03-26,417555563,0,417555563
12173,RSID3,2013-03-31,2013-08-14,426756464,0,426756464
12174,RSID3,2013-06-30,2013-08-14,428473420,0,428473420
12175,RSID3,2013-09-30,2013-11-13,428473420,0,428473420
12176,RSID3,2013-12-31,2014-03-27,428473420,0,428473420
12177,RSID3,2014-03-31,2014-05-14,428833420,0,428833420
12178,RSID3,2014-06-30,2014-08-15,428833420,0,428833420
12179,RSID3,2014-09-30,2014-11-14,428833420,0,428833420
12180,RSID3,2014-12-31,2015-03-19,85766684,0,85766684
12181,RSID3,2015-03-31,2015-05-14,85766684,0,85766684
12182,RSID3,2015-06-30,2015-08-12,85766684,0,85766684
12183,RSID3,2015-09-30,2015-11-10,85766684,0,85766684
12184,RSID3,2015-12-31,2016-03-30,85766684,0,85766684
12185,RSID3,2016-03-31,2016-05-12,17153337,0,17153337
12186,RSID3,2016-06-30,2016-08-11,17153337,0,17153337
12187,RSID3,2016-09-30,2016-11-10,17153337,0,17153337
12188,RSID3,2016-12-31,2017-03-23,17153337,0,17153337
12189,RSID3,2017-03-31,2017-05-11,17153337,0,17153337
12190,RSID3,2017-06-30,2017-08-14,17153337,0,17153337
12191,RSID3,2017-09-30,2017-11-13,17153337,0,17153337
12192,RSID3,2017-12-31,2018-03-26,17153337,0,17153337
12193,RSID3,2018-03-31,2018-05-14,17153337,0,17153337
12194,RSID3,2018-06-30,2018-08-13,17153337,0,17153337
12195,RSID3,2018-09-30,2018-11-13,17153337,0,17153337
12196,RSID3,2018-12-31,2019-03-27,17153337,0,17153337
12197,RSID3,2019-03-31,2019-05-14,17153337,0,17153337
12198,RSID3,2019-06-30,2019-08-14,17153337,0,17153337
12199,RSID3,2019-09-30,2019-11-13,17153337,0,17153337
12200,RSID3,2019-12-31,2020-03-18,17153337,0,17153337
12201,RSID3,2020-03-31,2020-06-09,17153337,0,17153337
12202,RSID3,2020-06-30,2020-08-12,17153337,0,17153337
12203,RSID3,2020-09-30,2020-11-11,17153337,0,17153337
12204,RSID3,2020-12-31,2021-03-17,17153337,0,17153337
12205,OPTS3B,2010-12-31,2011-03-30,48582043,0,48582043
12206,OPTS3B,2011-03-31,2011-05-16,48582043,0,48582043
12207,OPTS3B,2011-06-30,2011-08-15,48582043,0,48582043
12208,OPTS3B,2011-09-30,2011-11-11,48582043,0,48582043
12209,OPTS3B,2011-12-31,2012-03-30,48582043,0,48582043
12210,OPTS3B,2012-03-31,2012-05-15,48582043,0,48582043
12211,OPTS3B,2012-06-30,2012-08-14,48582043,0,48582043
12212,OPTS3B,2012-09-30,2012-11-14,48582043,0,48582043
12213,OPTS3B,2012-12-31,2013-03-27,48582043,0,48582043
12214,OPTS3B,2013-03-31,2014-04-07,48582043,0,48582043
12215,OPTS3B,2013-06-30,2014-04-07,48582043,0,48582043
12216,OPTS3B,2013-09-30,2014-04-07,48582043,0,48582043
12217,OPTS3B,2013-12-31,2014-03-28,48582043,0,48582043
12218,OPTS3B,2014-03-31,2014-05-13,48582043,0,48582043
12219,OPTS3B,2014-06-30,2014-08-12,45582043,0,45582043
12220,OPTS3B,2014-09-30,2014-11-14,45582043,0,45582043
12221,OPTS3B,2014-12-31,2015-03-30,83596903,0,83596903
12222,OPTS3B,2015-03-31,2015-05-15,83596903,0,83596903
12223,OPTS3B,2015-06-30,2015-08-13,83596903,0,83596903
12224,OPTS3B,2015-09-30,2015-11-13,83596903,0,83596903
12225,OPTS3B,2015-12-31,2016-03-30,83596903,0,83596903
12226,OPTS3B,2016-03-31,2016-05-10,83596903,0,83596903
12227,OPTS3B,2016-06-30,2016-08-12,83596903,0,83596903
12228,OPTS3B,2016-09-30,2016-11-10,83596903,0,83596903
12229,OPTS3B,2016-12-31,2017-03-29,83596903,0,83596903
12230,OPTS3B,2017-03-31,2017-05-22,83596903,0,83596903
12231,OPTS3B,2017-06-30,2017-08-14,83596903,0,83596903
12232,OPTS3B,2017-09-30,2017-11-14,83596903,0,83596903
12233,OPTS3B,2017-12-31,2018-03-29,83596903,0,83596903
12234,OPTS3B,2018-03-31,2018-05-15,83596903,0,83596903
12235,OPTS3B,2018-06-30,2018-08-13,83596903,0,83596903
12236,OPTS3B,2018-09-30,2018-11-12,83596903,0,83596903
12237,OPTS3B,2018-12-31,2019-04-01,83596903,0,83596903
12238,OPTS3B,2019-03-31,2019-05-15,83596903,0,83596903
12239,OPTS3B,2019-06-30,2019-08-14,83596903,0,83596903
12240,OPTS3B,2019-09-30,2019-11-13,83596903,0,83596903
12241,OPTS3B,2019-12-31,2020-03-31,83596903,0,83596903
12242,OPTS3B,2020-03-31,2020-07-21,83596903,0,83596903
12243,OPTS3B,2020-06-30,2020-09-03,83596903,0,83596903
12244,OPTS3B,2020-09-30,2020-11-13,83596903,0,83596903
12245,ECPR3,2010-12-31,2011-04-18,1026,874,1900
12246,ECPR3,2011-03-31,2011-05-16,1026,874,1900
12247,ECPR3,2011-06-30,2011-08-17,1026,874,1900
12248,ECPR3,2011-09-30,2011-11-28,1026,874,1900
12249,ECPR3,2011-12-31,2012-03-30,1026,874,1900
12250,ECPR3,2012-03-31,2012-05-17,1026,874,1900
12251,ECPR3,2012-06-30,2012-08-14,1026,874,1900
12252,ECPR3,2012-09-30,2012-11-14,1026,874,1900
12253,ECPR3,2012-12-31,2013-04-04,1026,874,1900
12254,ECPR3,2013-03-31,2013-05-15,1026,874,1900
12255,ECPR3,2013-06-30,2013-08-14,1026,874,1900
12256,ECPR3,2013-09-30,2013-11-13,1026,874,1900
12257,ECPR3,2013-12-31,2014-03-27,1026,874,1900
12258,ECPR3,2014-03-31,2014-05-15,1026,874,1900
12259,ECPR3,2014-06-30,2014-08-15,1026,874,1900
12260,ECPR3,2014-09-30,2014-11-14,1026,874,1900
12261,ECPR3,2014-12-31,2015-03-30,1026,874,1900
12262,ECPR3,2015-03-31,2015-05-15,1026,874,1900
12263,ECPR3,2015-06-30,2015-08-14,1026,874,1900
12264,ECPR3,2015-09-30,2015-11-16,1026,874,1900
12265,ECPR3,2015-12-31,2016-03-31,1026,874,1900
12266,ECPR3,2016-03-31,2016-05-16,1026,874,1900
12267,ECPR3,2016-06-30,2016-08-15,1026,874,1900
12268,ECPR3,2016-09-30,2016-11-14,1026,874,1900
12269,ECPR3,2016-12-31,2017-04-28,1026,874,1900
12270,ECPR3,2017-03-31,2017-05-19,1026,874,1900
12271,ECPR3,2017-06-30,2017-08-14,1026,874,1900
12272,ECPR3,2017-09-30,2017-11-16,1026,874,1900
12273,ECPR3,2017-12-31,2018-04-16,1026,874,1900
12274,ECPR3,2018-03-31,2018-05-15,1026,874,1900
12275,ECPR3,2018-06-30,2018-08-14,1026,874,1900
12276,ECPR3,2018-09-30,2018-11-19,1026,874,1900
12277,ECPR3,2018-12-31,2019-04-11,1026,874,1900
12278,ECPR3,2019-03-31,2019-05-30,1026,874,1900
12279,ECPR3,2019-06-30,2019-08-15,1026,874,1900
12280,ECPR3,2019-09-30,2019-11-14,1026,874,1900
12281,ECPR3,2019-12-31,2020-04-09,1026,874,1900
12282,ECPR3,2020-03-31,2020-06-29,1026,874,1900
12283,ECPR3,2020-06-30,2020-08-31,1026,874,1900
12284,ECPR3,2020-09-30,2020-11-16,1026,874,1900
12285,ECPR4,2010-12-31,2011-04-18,1026,874,1900
12286,ECPR4,2011-03-31,2011-05-16,1026,874,1900
12287,ECPR4,2011-06-30,2011-08-17,1026,874,1900
12288,ECPR4,2011-09-30,2011-11-28,1026,874,1900
12289,ECPR4,2011-12-31,2012-03-30,1026,874,1900
12290,ECPR4,2012-03-31,2012-05-17,1026,874,1900
12291,ECPR4,2012-06-30,2012-08-14,1026,874,1900
12292,ECPR4,2012-09-30,2012-11-14,1026,874,1900
12293,ECPR4,2012-12-31,2013-04-04,1026,874,1900
12294,ECPR4,2013-03-31,2013-05-15,1026,874,1900
12295,ECPR4,2013-06-30,2013-08-14,1026,874,1900
12296,ECPR4,2013-09-30,2013-11-13,1026,874,1900
12297,ECPR4,2013-12-31,2014-03-27,1026,874,1900
12298,ECPR4,2014-03-31,2014-05-15,1026,874,1900
12299,ECPR4,2014-06-30,2014-08-15,1026,874,1900
12300,ECPR4,2014-09-30,2014-11-14,1026,874,1900
12301,ECPR4,2014-12-31,2015-03-30,1026,874,1900
12302,ECPR4,2015-03-31,2015-05-15,1026,874,1900
12303,ECPR4,2015-06-30,2015-08-14,1026,874,1900
12304,ECPR4,2015-09-30,2015-11-16,1026,874,1900
12305,ECPR4,2015-12-31,2016-03-31,1026,874,1900
12306,ECPR4,2016-03-31,2016-05-16,1026,874,1900
12307,ECPR4,2016-06-30,2016-08-15,1026,874,1900
12308,ECPR4,2016-09-30,2016-11-14,1026,874,1900
12309,ECPR4,2016-12-31,2017-04-28,1026,874,1900
12310,ECPR4,2017-03-31,2017-05-19,1026,874,1900
12311,ECPR4,2017-06-30,2017-08-14,1026,874,1900
12312,ECPR4,2017-09-30,2017-11-16,1026,874,1900
12313,ECPR4,2017-12-31,2018-04-16,1026,874,1900
12314,ECPR4,2018-03-31,2018-05-15,1026,874,1900
12315,ECPR4,2018-06-30,2018-08-14,1026,874,1900
12316,ECPR4,2018-09-30,2018-11-19,1026,874,1900
12317,ECPR4,2018-12-31,2019-04-11,1026,874,1900
12318,ECPR4,2019-03-31,2019-05-30,1026,874,1900
12319,ECPR4,2019-06-30,2019-08-15,1026,874,1900
12320,ECPR4,2019-09-30,2019-11-14,1026,874,1900
12321,ECPR4,2019-12-31,2020-04-09,1026,874,1900
12322,ECPR4,2020-03-31,2020-06-29,1026,874,1900
12323,ECPR4,2020-06-30,2020-08-31,1026,874,1900
12324,ECPR4,2020-09-30,2020-11-16,1026,874,1900
12325,OPSE3B,2010-12-31,2011-03-29,33723324,0,33723324
12326,OPSE3B,2011-03-31,2011-05-16,33798324,0,33798324
12327,OPSE3B,2011-06-30,2011-08-15,33798324,0,33798324
12328,OPSE3B,2011-09-30,2011-11-14,33798324,0,33798324
12329,OPSE3B,2011-12-31,2012-03-27,33798324,0,33798324
12330,OPSE3B,2012-03-31,2012-05-10,33878324,0,33878324
12331,OPSE3B,2012-06-30,2012-07-30,33878324,0,33878324
12332,OPSE3B,2012-09-30,2012-10-23,33878324,0,33878324
12333,OPSE3B,2012-12-31,2013-03-20,41378324,0,41378324
12334,OPSE3B,2013-03-31,2013-05-10,41378324,0,41378324
12335,OPSE3B,2013-06-30,2013-08-01,41378324,0,41378324
12336,OPSE3B,2013-09-30,2013-11-01,41378324,0,41378324
12337,OPSE3B,2013-12-31,2014-02-24,41378324,0,41378324
12338,OPSE3B,2014-03-31,2014-05-08,51378324,0,51378324
12339,OPSE3B,2014-06-30,2014-08-22,51378324,0,51378324
12340,OPSE3B,2014-09-30,2014-11-05,51378324,0,51378324
12341,OPSE3B,2014-12-31,2015-02-26,51378324,0,51378324
12342,OPSE3B,2015-03-31,2015-05-13,59878324,0,59878324
12343,OPSE3B,2015-06-30,2015-08-05,59878324,0,59878324
12344,OPSE3B,2015-09-30,2015-11-09,59878324,0,59878324
12345,OPSE3B,2015-12-31,2016-03-09,59878324,0,59878324
12346,OPSE3B,2016-03-31,2016-05-12,70178324,0,70178324
12347,OPSE3B,2016-06-30,2016-07-20,70178324,0,70178324
12348,OPSE3B,2016-09-30,2016-11-08,70178324,0,70178324
12349,OPSE3B,2016-12-31,2017-03-16,70178324,0,70178324
12350,OPSE3B,2017-03-31,2017-05-15,81178324,0,81178324
12351,OPSE3B,2017-06-30,2017-08-10,81178324,0,81178324
12352,OPSE3B,2017-09-30,2017-11-13,81178324,0,81178324
12353,OPSE3B,2017-12-31,2018-03-27,81178324,0,81178324
12354,OPSE3B,2018-03-31,2018-05-15,93178324,0,93178324
12355,OPSE3B,2018-06-30,2018-08-14,93178324,0,93178324
12356,OPSE3B,2018-09-30,2018-11-13,93178324,0,93178324
12357,OPSE3B,2018-12-31,2019-03-20,93178324,0,93178324
12358,OPSE3B,2019-03-31,2019-05-15,106178324,0,106178324
12359,OPSE3B,2019-06-30,2019-08-15,106178324,0,106178324
12360,OPSE3B,2019-09-30,2019-11-14,106178324,0,106178324
12361,OPSE3B,2019-12-31,2020-03-18,126178324,0,126178324
12362,OPSE3B,2020-03-31,2020-06-01,126178324,0,126178324
12363,OPSE3B,2020-06-30,2020-08-18,126178324,0,126178324
12364,OPSE3B,2020-09-30,2020-11-13,126178324,0,126178324
12365,OPSE3B,2020-12-31,2021-03-08,126178324,0,126178324
12366,ENMA3B,2010-12-31,2011-03-31,161319,2865,164184
12367,ENMA3B,2011-03-31,2011-05-11,161318939,2864960,164183899
12368,ENMA3B,2011-06-30,2011-07-29,161318939,2864960,164183899
12369,ENMA3B,2011-09-30,2011-10-27,161318939,2864960,164183899
12370,ENMA3B,2011-12-31,2013-03-28,161318939,2864960,164183899
12371,ENMA3B,2012-03-31,2012-04-27,161318939,2864960,164183899
12372,ENMA3B,2012-06-30,2012-07-27,161318939,2864960,164183899
12373,ENMA3B,2012-09-30,2012-10-24,161318939,2864960,164183899
12374,ENMA3B,2012-12-31,2013-03-28,161318939,2864960,164183899
12375,ENMA3B,2013-03-31,2013-05-15,161318939,2864960,164183899
12376,ENMA3B,2013-06-30,2013-08-14,161318939,2864960,164183899
12377,ENMA3B,2013-09-30,2013-10-31,161318939,2864960,164183899
12378,ENMA3B,2013-12-31,2014-02-28,161318939,2864960,164183899
12379,ENMA3B,2014-03-31,2014-05-08,161318939,2864960,164183899
12380,ENMA3B,2014-06-30,2014-08-11,161318939,2864960,164183899
12381,ENMA3B,2014-09-30,2014-10-31,161318939,2864960,164183899
12382,ENMA3B,2014-12-31,2015-02-24,161318939,2864960,164183899
12383,ENMA3B,2015-03-31,2015-05-07,161318939,2864960,164183899
12384,ENMA3B,2015-06-30,2015-08-13,161318939,2864960,164183899
12385,ENMA3B,2015-09-30,2015-11-03,161318939,2864960,164183899
12386,ENMA3B,2015-12-31,2016-03-10,161318939,2864960,164183899
12387,ENMA3B,2016-03-31,2016-05-12,161318939,2864960,164183899
12388,ENMA3B,2016-06-30,2016-10-19,161318939,2864960,164183899
12389,ENMA3B,2016-09-30,2016-11-14,161318939,2864960,164183899
12390,ENMA3B,2016-12-31,2017-03-10,161318939,2864960,164183899
12391,ENMA3B,2017-03-31,2017-05-09,161318939,2864960,164183899
12392,ENMA3B,2017-06-30,2017-08-08,161318939,2864960,164183899
12393,ENMA3B,2017-09-30,2017-11-09,161318939,2864960,164183899
12394,ENMA3B,2017-12-31,2018-03-09,161318939,2864960,164183899
12395,ENMA3B,2018-03-31,2018-05-10,161318939,2864960,164183899
12396,ENMA3B,2018-06-30,2018-08-09,161318939,2864960,164183899
12397,ENMA3B,2018-09-30,2018-11-08,161318939,2864960,164183899
12398,ENMA3B,2018-12-31,2019-04-12,161318939,2864960,164183899
12399,ENMA3B,2019-03-31,2019-05-22,161318939,2864960,164183899
12400,ENMA3B,2019-06-30,2019-08-15,161318939,2864960,164183899
12401,ENMA3B,2019-09-30,2019-11-12,161318939,2864960,164183899
12402,ENMA3B,2019-12-31,2020-04-03,161318939,2864960,164183899
12403,ENMA3B,2020-03-31,2020-06-29,161318939,2864960,164183899
12404,ENMA3B,2020-06-30,2020-08-20,161318939,2864960,164183899
12405,ENMA3B,2020-09-30,2020-11-13,161318939,2864960,164183899
12406,ENMA3B,2020-12-31,2021-03-24,161318939,2864960,164183899
12407,EQMA3B,2010-12-31,2011-03-31,161319,2865,164184
12408,EQMA3B,2011-03-31,2011-05-11,161318939,2864960,164183899
12409,EQMA3B,2011-06-30,2011-07-29,161318939,2864960,164183899
12410,EQMA3B,2011-09-30,2011-10-27,161318939,2864960,164183899
12411,EQMA3B,2011-12-31,2013-03-28,161318939,2864960,164183899
12412,EQMA3B,2012-03-31,2012-04-27,161318939,2864960,164183899
12413,EQMA3B,2012-06-30,2012-07-27,161318939,2864960,164183899
12414,EQMA3B,2012-09-30,2012-10-24,161318939,2864960,164183899
12415,EQMA3B,2012-12-31,2013-03-28,161318939,2864960,164183899
12416,EQMA3B,2013-03-31,2013-05-15,161318939,2864960,164183899
12417,EQMA3B,2013-06-30,2013-08-14,161318939,2864960,164183899
12418,EQMA3B,2013-09-30,2013-10-31,161318939,2864960,164183899
12419,EQMA3B,2013-12-31,2014-02-28,161318939,2864960,164183899
12420,EQMA3B,2014-03-31,2014-05-08,161318939,2864960,164183899
12421,EQMA3B,2014-06-30,2014-08-11,161318939,2864960,164183899
12422,EQMA3B,2014-09-30,2014-10-31,161318939,2864960,164183899
12423,EQMA3B,2014-12-31,2015-02-24,161318939,2864960,164183899
12424,EQMA3B,2015-03-31,2015-05-07,161318939,2864960,164183899
12425,EQMA3B,2015-06-30,2015-08-13,161318939,2864960,164183899
12426,EQMA3B,2015-09-30,2015-11-03,161318939,2864960,164183899
12427,EQMA3B,2015-12-31,2016-03-10,161318939,2864960,164183899
12428,EQMA3B,2016-03-31,2016-05-12,161318939,2864960,164183899
12429,EQMA3B,2016-06-30,2016-10-19,161318939,2864960,164183899
12430,EQMA3B,2016-09-30,2016-11-14,161318939,2864960,164183899
12431,EQMA3B,2016-12-31,2017-03-10,161318939,2864960,164183899
12432,EQMA3B,2017-03-31,2017-05-09,161318939,2864960,164183899
12433,EQMA3B,2017-06-30,2017-08-08,161318939,2864960,164183899
12434,EQMA3B,2017-09-30,2017-11-09,161318939,2864960,164183899
12435,EQMA3B,2017-12-31,2018-03-09,161318939,2864960,164183899
12436,EQMA3B,2018-03-31,2018-05-10,161318939,2864960,164183899
12437,EQMA3B,2018-06-30,2018-08-09,161318939,2864960,164183899
12438,EQMA3B,2018-09-30,2018-11-08,161318939,2864960,164183899
12439,EQMA3B,2018-12-31,2019-04-12,161318939,2864960,164183899
12440,EQMA3B,2019-03-31,2019-05-22,161318939,2864960,164183899
12441,EQMA3B,2019-06-30,2019-08-15,161318939,2864960,164183899
12442,EQMA3B,2019-09-30,2019-11-12,161318939,2864960,164183899
12443,EQMA3B,2019-12-31,2020-04-03,161318939,2864960,164183899
12444,EQMA3B,2020-03-31,2020-06-29,161318939,2864960,164183899
12445,EQMA3B,2020-06-30,2020-08-20,161318939,2864960,164183899
12446,EQMA3B,2020-09-30,2020-11-13,161318939,2864960,164183899
12447,EQMA3B,2020-12-31,2021-03-24,161318939,2864960,164183899
12448,EQMA5B,2010-12-31,2011-03-31,161319,2865,164184
12449,EQMA5B,2011-03-31,2011-05-11,161318939,2864960,164183899
12450,EQMA5B,2011-06-30,2011-07-29,161318939,2864960,164183899
12451,EQMA5B,2011-09-30,2011-10-27,161318939,2864960,164183899
12452,EQMA5B,2011-12-31,2013-03-28,161318939,2864960,164183899
12453,EQMA5B,2012-03-31,2012-04-27,161318939,2864960,164183899
12454,EQMA5B,2012-06-30,2012-07-27,161318939,2864960,164183899
12455,EQMA5B,2012-09-30,2012-10-24,161318939,2864960,164183899
12456,EQMA5B,2012-12-31,2013-03-28,161318939,2864960,164183899
12457,EQMA5B,2013-03-31,2013-05-15,161318939,2864960,164183899
12458,EQMA5B,2013-06-30,2013-08-14,161318939,2864960,164183899
12459,EQMA5B,2013-09-30,2013-10-31,161318939,2864960,164183899
12460,EQMA5B,2013-12-31,2014-02-28,161318939,2864960,164183899
12461,EQMA5B,2014-03-31,2014-05-08,161318939,2864960,164183899
12462,EQMA5B,2014-06-30,2014-08-11,161318939,2864960,164183899
12463,EQMA5B,2014-09-30,2014-10-31,161318939,2864960,164183899
12464,EQMA5B,2014-12-31,2015-02-24,161318939,2864960,164183899
12465,EQMA5B,2015-03-31,2015-05-07,161318939,2864960,164183899
12466,EQMA5B,2015-06-30,2015-08-13,161318939,2864960,164183899
12467,EQMA5B,2015-09-30,2015-11-03,161318939,2864960,164183899
12468,EQMA5B,2015-12-31,2016-03-10,161318939,2864960,164183899
12469,EQMA5B,2016-03-31,2016-05-12,161318939,2864960,164183899
12470,EQMA5B,2016-06-30,2016-10-19,161318939,2864960,164183899
12471,EQMA5B,2016-09-30,2016-11-14,161318939,2864960,164183899
12472,EQMA5B,2016-12-31,2017-03-10,161318939,2864960,164183899
12473,EQMA5B,2017-03-31,2017-05-09,161318939,2864960,164183899
12474,EQMA5B,2017-06-30,2017-08-08,161318939,2864960,164183899
12475,EQMA5B,2017-09-30,2017-11-09,161318939,2864960,164183899
12476,EQMA5B,2017-12-31,2018-03-09,161318939,2864960,164183899
12477,EQMA5B,2018-03-31,2018-05-10,161318939,2864960,164183899
12478,EQMA5B,2018-06-30,2018-08-09,161318939,2864960,164183899
12479,EQMA5B,2018-09-30,2018-11-08,161318939,2864960,164183899
12480,EQMA5B,2018-12-31,2019-04-12,161318939,2864960,164183899
12481,EQMA5B,2019-03-31,2019-05-22,161318939,2864960,164183899
12482,EQMA5B,2019-06-30,2019-08-15,161318939,2864960,164183899
12483,EQMA5B,2019-09-30,2019-11-12,161318939,2864960,164183899
12484,EQMA5B,2019-12-31,2020-04-03,161318939,2864960,164183899
12485,EQMA5B,2020-03-31,2020-06-29,161318939,2864960,164183899
12486,EQMA5B,2020-06-30,2020-08-20,161318939,2864960,164183899
12487,EQMA5B,2020-09-30,2020-11-13,161318939,2864960,164183899
12488,EQMA5B,2020-12-31,2021-03-24,161318939,2864960,164183899
12489,EQMA6B,2010-12-31,2011-03-31,161319,2865,164184
12490,EQMA6B,2011-03-31,2011-05-11,161318939,2864960,164183899
12491,EQMA6B,2011-06-30,2011-07-29,161318939,2864960,164183899
12492,EQMA6B,2011-09-30,2011-10-27,161318939,2864960,164183899
12493,EQMA6B,2011-12-31,2013-03-28,161318939,2864960,164183899
12494,EQMA6B,2012-03-31,2012-04-27,161318939,2864960,164183899
12495,EQMA6B,2012-06-30,2012-07-27,161318939,2864960,164183899
12496,EQMA6B,2012-09-30,2012-10-24,161318939,2864960,164183899
12497,EQMA6B,2012-12-31,2013-03-28,161318939,2864960,164183899
12498,EQMA6B,2013-03-31,2013-05-15,161318939,2864960,164183899
12499,EQMA6B,2013-06-30,2013-08-14,161318939,2864960,164183899
12500,EQMA6B,2013-09-30,2013-10-31,161318939,2864960,164183899
12501,EQMA6B,2013-12-31,2014-02-28,161318939,2864960,164183899
12502,EQMA6B,2014-03-31,2014-05-08,161318939,2864960,164183899
12503,EQMA6B,2014-06-30,2014-08-11,161318939,2864960,164183899
12504,EQMA6B,2014-09-30,2014-10-31,161318939,2864960,164183899
12505,EQMA6B,2014-12-31,2015-02-24,161318939,2864960,164183899
12506,EQMA6B,2015-03-31,2015-05-07,161318939,2864960,164183899
12507,EQMA6B,2015-06-30,2015-08-13,161318939,2864960,164183899
12508,EQMA6B,2015-09-30,2015-11-03,161318939,2864960,164183899
12509,EQMA6B,2015-12-31,2016-03-10,161318939,2864960,164183899
12510,EQMA6B,2016-03-31,2016-05-12,161318939,2864960,164183899
12511,EQMA6B,2016-06-30,2016-10-19,161318939,2864960,164183899
12512,EQMA6B,2016-09-30,2016-11-14,161318939,2864960,164183899
12513,EQMA6B,2016-12-31,2017-03-10,161318939,2864960,164183899
12514,EQMA6B,2017-03-31,2017-05-09,161318939,2864960,164183899
12515,EQMA6B,2017-06-30,2017-08-08,161318939,2864960,164183899
12516,EQMA6B,2017-09-30,2017-11-09,161318939,2864960,164183899
12517,EQMA6B,2017-12-31,2018-03-09,161318939,2864960,164183899
12518,EQMA6B,2018-03-31,2018-05-10,161318939,2864960,164183899
12519,EQMA6B,2018-06-30,2018-08-09,161318939,2864960,164183899
12520,EQMA6B,2018-09-30,2018-11-08,161318939,2864960,164183899
12521,EQMA6B,2018-12-31,2019-04-12,161318939,2864960,164183899
12522,EQMA6B,2019-03-31,2019-05-22,161318939,2864960,164183899
12523,EQMA6B,2019-06-30,2019-08-15,161318939,2864960,164183899
12524,EQMA6B,2019-09-30,2019-11-12,161318939,2864960,164183899
12525,EQMA6B,2019-12-31,2020-04-03,161318939,2864960,164183899
12526,EQMA6B,2020-03-31,2020-06-29,161318939,2864960,164183899
12527,EQMA6B,2020-06-30,2020-08-20,161318939,2864960,164183899
12528,EQMA6B,2020-09-30,2020-11-13,161318939,2864960,164183899
12529,EQMA6B,2020-12-31,2021-03-24,161318939,2864960,164183899
12530,CEGR3,2010-12-31,2011-03-30,51927546,0,51927546
12531,CEGR3,2011-03-31,2011-05-13,51927546,0,51927546
12532,CEGR3,2011-06-30,2011-08-12,51927546,0,51927546
12533,CEGR3,2011-09-30,2011-11-10,51927546,0,51927546
12534,CEGR3,2011-12-31,2012-03-28,51927546,0,51927546
12535,CEGR3,2012-03-31,2012-05-11,51927546,0,51927546
12536,CEGR3,2012-06-30,2012-08-10,51927546,0,51927546
12537,CEGR3,2012-09-30,2012-11-12,51927546,0,51927546
12538,CEGR3,2012-12-31,2013-03-26,51927546,0,51927546
12539,CEGR3,2013-03-31,2013-05-10,51927546,0,51927546
12540,CEGR3,2013-06-30,2013-08-09,51927546,0,51927546
12541,CEGR3,2013-09-30,2013-11-12,51927546,0,51927546
12542,CEGR3,2013-12-31,2014-03-28,51927546,0,51927546
12543,CEGR3,2014-03-31,2014-05-14,51927546,0,51927546
12544,CEGR3,2014-06-30,2014-10-20,51927546,0,51927546
12545,CEGR3,2014-09-30,2014-11-13,51927546,0,51927546
12546,CEGR3,2014-12-31,2015-03-30,51927546,0,51927546
12547,CEGR3,2015-03-31,2015-05-13,51927546,0,51927546
12548,CEGR3,2015-06-30,2015-08-24,51927546,0,51927546
12549,CEGR3,2015-09-30,2015-11-11,51927546,0,51927546
12550,CEGR3,2015-12-31,2016-04-27,51927546,0,51927546
12551,CEGR3,2016-03-31,2016-05-12,51927546,0,51927546
12552,CEGR3,2016-06-30,2016-08-11,259638,0,259638
12553,CEGR3,2016-09-30,2016-11-10,259638,0,259638
12554,CEGR3,2016-12-31,2017-03-28,259638,0,259638
12555,CEGR3,2017-03-31,2017-06-05,259638,0,259638
12556,CEGR3,2017-06-30,2017-08-14,259638,0,259638
12557,CEGR3,2017-09-30,2017-11-13,259638,0,259638
12558,CEGR3,2017-12-31,2018-03-28,259638,0,259638
12559,CEGR3,2018-03-31,2018-05-11,259638,0,259638
12560,CEGR3,2018-06-30,2018-08-10,259638,0,259638
12561,CEGR3,2018-09-30,2018-11-12,259638,0,259638
12562,CEGR3,2018-12-31,2019-03-25,259638,0,259638
12563,CEGR3,2019-03-31,2019-05-10,259638,0,259638
12564,CEGR3,2019-06-30,2019-08-12,259638,0,259638
12565,CEGR3,2019-09-30,2019-11-13,259638,0,259638
12566,CEGR3,2019-12-31,2020-03-30,259638,0,259638
12567,CEGR3,2020-03-31,2020-06-29,259638,0,259638
12568,CEGR3,2020-06-30,2020-08-14,259638,0,259638
12569,CEGR3,2020-09-30,2020-11-13,259638,0,259638
12570,UPKP3B,2010-12-31,2011-04-04,52437,0,52437
12571,UPKP3B,2011-03-31,2011-06-22,52437,0,52437
12572,UPKP3B,2011-06-30,2011-08-12,52437,0,52437
12573,UPKP3B,2011-09-30,2011-11-14,52437,0,52437
12574,UPKP3B,2011-12-31,2012-03-29,52437,0,52437
12575,UPKP3B,2012-03-31,2012-05-15,52437,0,52437
12576,UPKP3B,2012-06-30,2012-08-14,52437,0,52437
12577,UPKP3B,2012-09-30,2012-11-14,52437,0,52437
12578,UPKP3B,2012-12-31,2013-03-27,52437,0,52437
12579,UPKP3B,2013-03-31,2013-05-15,52437,0,52437
12580,UPKP3B,2013-06-30,2013-08-20,52437,0,52437
12581,UPKP3B,2013-09-30,2013-11-14,52437,0,52437
12582,UPKP3B,2013-12-31,2014-03-29,52437,0,52437
12583,UPKP3B,2014-03-31,2014-05-16,52437,0,52437
12584,UPKP3B,2014-06-30,2014-08-15,52437,0,52437
12585,UPKP3B,2014-09-30,2014-11-14,52437,0,52437
12586,UPKP3B,2014-12-31,2017-09-13,52437,0,52437
12587,UPKP3B,2015-03-31,2015-05-15,52437,0,52437
12588,UPKP3B,2015-06-30,2015-08-14,52437,0,52437
12589,UPKP3B,2015-09-30,2015-11-18,52437,0,52437
12590,UPKP3B,2015-12-31,2017-09-13,52437,0,52437
12591,UPKP3B,2016-03-31,2016-05-13,52437,0,52437
12592,UPKP3B,2016-06-30,2016-08-11,52437,0,52437
12593,UPKP3B,2016-09-30,2016-11-11,52437,0,52437
12594,UPKP3B,2016-12-31,2017-09-13,52437,0,52437
12595,UPKP3B,2017-03-31,2017-09-13,52437,0,52437
12596,UPKP3B,2017-06-30,2017-08-14,52437,0,52437
12597,UPKP3B,2017-09-30,2017-11-10,52437,0,52437
12598,UPKP3B,2017-12-31,2018-03-22,52437,0,52437
12599,UPKP3B,2018-03-31,2018-05-14,52437,0,52437
12600,UPKP3B,2018-06-30,2018-08-13,52437,0,52437
12601,UPKP3B,2018-09-30,2018-11-13,52437,0,52437
12602,UPKP3B,2018-12-31,2019-03-21,52437,0,52437
12603,UPKP3B,2019-03-31,2019-05-15,52437,0,52437
12604,UPKP3B,2019-06-30,2019-08-13,52437,0,52437
12605,UPKP3B,2019-09-30,2019-11-13,52437,0,52437
12606,UPKP3B,2019-12-31,2020-03-13,52437,0,52437
12607,UPKP3B,2020-03-31,2020-05-15,52437,0,52437
12608,UPKP3B,2020-06-30,2020-08-14,52437,0,52437
12609,UPKP3B,2020-09-30,2020-11-12,52437,0,52437
12610,UPKP3B,2020-12-31,2021-03-26,52437,0,52437
12611,GPCP3,2010-12-31,2011-04-01,104425,0,104425
12612,GPCP3,2011-03-31,2011-05-16,104425,0,104425
12613,GPCP3,2011-06-30,2011-08-12,104425,0,104425
12614,GPCP3,2011-09-30,2011-11-17,104425,0,104425
12615,GPCP3,2011-12-31,2012-04-16,358849702,0,358849702
12616,GPCP3,2012-03-31,2012-05-15,358849702,0,358849702
12617,GPCP3,2012-06-30,2012-08-14,358849702,0,358849702
12618,GPCP3,2012-09-30,2012-11-14,358849702,0,358849702
12619,GPCP3,2012-12-31,2013-04-02,358849702,0,358849702
12620,GPCP3,2013-03-31,2013-06-07,358849702,0,358849702
12621,GPCP3,2013-06-30,2013-08-16,358849702,0,358849702
12622,GPCP3,2013-09-30,2013-11-27,358849702,0,358849702
12623,GPCP3,2013-12-31,2014-03-31,358849702,0,358849702
12624,GPCP3,2014-03-31,2014-05-15,358849702,0,358849702
12625,GPCP3,2014-06-30,2014-08-13,358849702,0,358849702
12626,GPCP3,2014-09-30,2014-11-13,358849702,0,358849702
12627,GPCP3,2014-12-31,2015-03-31,358849702,0,358849702
12628,GPCP3,2015-03-31,2015-05-15,358849702,0,358849702
12629,GPCP3,2015-06-30,2015-08-14,358849702,0,358849702
12630,GPCP3,2015-09-30,2015-11-16,358849702,0,358849702
12631,GPCP3,2015-12-31,2016-05-04,358849702,0,358849702
12632,GPCP3,2016-03-31,2016-05-13,358849702,0,358849702
12633,GPCP3,2016-06-30,2016-08-12,5882782,0,5882782
12634,GPCP3,2016-09-30,2016-11-12,5882782,0,5882782
12635,GPCP3,2016-12-31,2017-03-29,5882782,0,5882782
12636,GPCP3,2017-03-31,2017-05-15,5882782,384787,6267569
12637,GPCP3,2017-06-30,2017-08-11,5882782,384787,6267569
12638,GPCP3,2017-09-30,2017-11-14,5882782,384787,6267569
12639,GPCP3,2017-12-31,2018-04-10,5882782,384787,6267569
12640,GPCP3,2018-03-31,2018-05-14,5882782,384787,6267569
12641,GPCP3,2018-06-30,2018-08-14,5882782,384787,6267569
12642,GPCP3,2018-09-30,2018-11-13,5882782,384787,6267569
12643,GPCP3,2018-12-31,2019-03-29,5882782,384787,6267569
12644,GPCP3,2019-03-31,2019-05-15,5882782,384787,6267569
12645,GPCP3,2019-06-30,2019-08-23,5882782,384787,6267569
12646,GPCP3,2019-09-30,2019-11-14,5882782,384787,6267569
12647,GPCP3,2019-12-31,2020-03-30,5882782,384787,6267569
12648,GPCP3,2020-03-31,2020-05-19,5882782,384787,6267569
12649,GPCP3,2020-06-30,2020-08-31,5882782,384787,6267569
12650,GPCP3,2020-09-30,2020-10-16,29413910,1923935,31337845
12651,GPCP4,2010-12-31,2011-04-01,104425,0,104425
12652,GPCP4,2011-03-31,2011-05-16,104425,0,104425
12653,GPCP4,2011-06-30,2011-08-12,104425,0,104425
12654,GPCP4,2011-09-30,2011-11-17,104425,0,104425
12655,GPCP4,2011-12-31,2012-04-16,358849702,0,358849702
12656,GPCP4,2012-03-31,2012-05-15,358849702,0,358849702
12657,GPCP4,2012-06-30,2012-08-14,358849702,0,358849702
12658,GPCP4,2012-09-30,2012-11-14,358849702,0,358849702
12659,GPCP4,2012-12-31,2013-04-02,358849702,0,358849702
12660,GPCP4,2013-03-31,2013-06-07,358849702,0,358849702
12661,GPCP4,2013-06-30,2013-08-16,358849702,0,358849702
12662,GPCP4,2013-09-30,2013-11-27,358849702,0,358849702
12663,GPCP4,2013-12-31,2014-03-31,358849702,0,358849702
12664,GPCP4,2014-03-31,2014-05-15,358849702,0,358849702
12665,GPCP4,2014-06-30,2014-08-13,358849702,0,358849702
12666,GPCP4,2014-09-30,2014-11-13,358849702,0,358849702
12667,GPCP4,2014-12-31,2015-03-31,358849702,0,358849702
12668,GPCP4,2015-03-31,2015-05-15,358849702,0,358849702
12669,GPCP4,2015-06-30,2015-08-14,358849702,0,358849702
12670,GPCP4,2015-09-30,2015-11-16,358849702,0,358849702
12671,GPCP4,2015-12-31,2016-05-04,358849702,0,358849702
12672,GPCP4,2016-03-31,2016-05-13,358849702,0,358849702
12673,GPCP4,2016-06-30,2016-08-12,5882782,0,5882782
12674,GPCP4,2016-09-30,2016-11-12,5882782,0,5882782
12675,GPCP4,2016-12-31,2017-03-29,5882782,0,5882782
12676,GPCP4,2017-03-31,2017-05-15,5882782,384787,6267569
12677,GPCP4,2017-06-30,2017-08-11,5882782,384787,6267569
12678,GPCP4,2017-09-30,2017-11-14,5882782,384787,6267569
12679,GPCP4,2017-12-31,2018-04-10,5882782,384787,6267569
12680,GPCP4,2018-03-31,2018-05-14,5882782,384787,6267569
12681,GPCP4,2018-06-30,2018-08-14,5882782,384787,6267569
12682,GPCP4,2018-09-30,2018-11-13,5882782,384787,6267569
12683,GPCP4,2018-12-31,2019-03-29,5882782,384787,6267569
12684,GPCP4,2019-03-31,2019-05-15,5882782,384787,6267569
12685,GPCP4,2019-06-30,2019-08-23,5882782,384787,6267569
12686,GPCP4,2019-09-30,2019-11-14,5882782,384787,6267569
12687,GPCP4,2019-12-31,2020-03-30,5882782,384787,6267569
12688,GPCP4,2020-03-31,2020-05-19,5882782,384787,6267569
12689,GPCP4,2020-06-30,2020-08-31,5882782,384787,6267569
12690,GPCP4,2020-09-30,2020-10-16,29413910,1923935,31337845
12691,PSSA3,2010-12-31,2011-03-01,327642,0,327642
12692,PSSA3,2011-03-31,2011-05-03,327642,0,327642
12693,PSSA3,2011-06-30,2011-08-10,327642,0,327642
12694,PSSA3,2011-09-30,2011-11-01,327642,0,327642
12695,PSSA3,2011-12-31,2012-02-27,327642,0,327642
12696,PSSA3,2012-03-31,2012-05-14,324669,0,324669
12697,PSSA3,2012-06-30,2012-08-06,324669,0,324669
12698,PSSA3,2012-09-30,2012-11-12,324669,0,324669
12699,PSSA3,2012-12-31,2013-02-26,324669,0,324669
12700,PSSA3,2013-03-31,2013-05-03,323293,0,323293
12701,PSSA3,2013-06-30,2013-08-09,323293,0,323293
12702,PSSA3,2013-09-30,2013-10-29,323293,0,323293
12703,PSSA3,2013-12-31,2014-02-25,323293,0,323293
12704,PSSA3,2014-03-31,2014-04-30,323293,0,323293
12705,PSSA3,2014-06-30,2014-08-05,323293,0,323293
12706,PSSA3,2014-09-30,2014-11-04,323293,0,323293
12707,PSSA3,2014-12-31,2015-02-25,323293,0,323293
12708,PSSA3,2015-03-31,2015-05-05,323293,0,323293
12709,PSSA3,2015-06-30,2015-08-04,323293,0,323293
12710,PSSA3,2015-09-30,2015-11-04,323293,0,323293
12711,PSSA3,2015-12-31,2016-02-04,323293,0,323293
12712,PSSA3,2016-03-31,2016-05-03,323293,0,323293
12713,PSSA3,2016-06-30,2016-08-05,323293,0,323293
12714,PSSA3,2016-09-30,2016-10-31,323293,0,323293
12715,PSSA3,2016-12-31,2017-02-06,323293,0,323293
12716,PSSA3,2017-03-31,2017-05-02,323293,0,323293
12717,PSSA3,2017-06-30,2017-08-02,323293,0,323293
12718,PSSA3,2017-09-30,2017-10-31,323293,0,323293
12719,PSSA3,2017-12-31,2018-02-05,323293,0,323293
12720,PSSA3,2018-03-31,2018-05-08,323293,0,323293
12721,PSSA3,2018-06-30,2018-11-07,323293,0,323293
12722,PSSA3,2018-09-30,2018-11-05,323293,0,323293
12723,PSSA3,2018-12-31,2019-02-04,323293,0,323293
12724,PSSA3,2019-03-31,2019-05-03,323263,0,323263
12725,PSSA3,2019-06-30,2019-08-02,323293,0,323293
12726,PSSA3,2019-09-30,2019-11-04,323293,0,323293
12727,PSSA3,2019-12-31,2020-02-03,323293,0,323293
12728,PSSA3,2020-03-31,2020-05-04,323293,0,323293
12729,PSSA3,2020-06-30,2020-08-03,323293,0,323293
12730,PSSA3,2020-09-30,2020-11-03,323293,0,323293
12731,PSSA3,2020-12-31,2021-02-25,323293,0,323293
12732,ALEF3B,2010-12-31,2011-03-28,21394000,0,21394000
12733,ALEF3B,2011-03-31,2011-05-16,21394000,0,21394000
12734,ALEF3B,2011-06-30,2011-08-15,21394000,0,21394000
12735,ALEF3B,2011-09-30,2011-11-14,21394000,0,21394000
12736,ALEF3B,2011-12-31,2012-03-27,21394000,0,21394000
12737,ALEF3B,2012-03-31,2012-05-10,21474000,0,21474000
12738,ALEF3B,2012-06-30,2012-07-31,21474000,0,21474000
12739,ALEF3B,2012-09-30,2012-10-23,21474000,0,21474000
12740,ALEF3B,2012-12-31,2013-03-21,26474000,0,26474000
12741,ALEF3B,2013-03-31,2013-05-10,26474000,0,26474000
12742,ALEF3B,2013-06-30,2013-08-01,26474000,0,26474000
12743,ALEF3B,2013-09-30,2013-11-01,26474000,0,26474000
12744,ALEF3B,2013-12-31,2014-02-24,26474000,0,26474000
12745,ALEF3B,2014-03-31,2014-05-07,36474000,0,36474000
12746,ALEF3B,2014-06-30,2014-08-01,36474000,0,36474000
12747,ALEF3B,2014-09-30,2014-11-04,36474000,0,36474000
12748,ALEF3B,2014-12-31,2015-02-23,36474000,0,36474000
12749,ALEF3B,2015-03-31,2015-05-11,44474000,0,44474000
12750,ALEF3B,2015-06-30,2015-08-05,44474000,0,44474000
12751,ALEF3B,2015-09-30,2015-11-03,44474000,0,44474000
12752,ALEF3B,2015-12-31,2016-03-01,44474000,0,44474000
12753,ALEF3B,2016-03-31,2016-05-12,54674000,0,54674000
12754,ALEF3B,2016-06-30,2016-07-20,54674000,0,54674000
12755,ALEF3B,2016-09-30,2016-11-04,54674000,0,54674000
12756,ALEF3B,2016-12-31,2017-03-07,54674000,0,54674000
12757,ALEF3B,2017-03-31,2017-05-12,65674000,0,65674000
12758,ALEF3B,2017-06-30,2017-08-09,65674000,0,65674000
12759,ALEF3B,2017-09-30,2017-11-13,65674000,0,65674000
12760,ALEF3B,2017-12-31,2018-03-26,65674000,0,65674000
12761,ALEF3B,2018-03-31,2018-05-14,78674000,0,78674000
12762,ALEF3B,2018-06-30,2018-08-14,78674000,0,78674000
12763,ALEF3B,2018-09-30,2018-11-14,78674000,0,78674000
12764,ALEF3B,2018-12-31,2019-03-20,78674000,0,78674000
12765,ALEF3B,2019-03-31,2019-05-15,98674000,0,98674000
12766,ALEF3B,2019-06-30,2019-08-09,98674000,0,98674000
12767,ALEF3B,2019-09-30,2019-11-14,98674000,0,98674000
12768,ALEF3B,2019-12-31,2020-03-18,98674000,0,98674000
12769,ALEF3B,2020-03-31,2020-06-01,116574000,0,116574000
12770,ALEF3B,2020-06-30,2020-08-17,116574000,0,116574000
12771,ALEF3B,2020-09-30,2020-11-13,116574000,0,116574000
12772,ALEF3B,2020-12-31,2021-03-03,116574000,0,116574000
12773,CASN3,2010-12-31,2011-04-01,351280,351280,702560
12774,CASN3,2011-03-31,2011-05-17,351280,351280,702560
12775,CASN3,2011-06-30,2011-08-22,351280,351280,702560
12776,CASN3,2011-09-30,2011-11-11,351280,351280,702560
12777,CASN3,2011-12-31,2012-02-27,357547216,357547216,715094432
12778,CASN3,2012-03-31,2012-05-14,357547216,357547216,715094432
12779,CASN3,2012-06-30,2012-09-04,357547216,357547216,715094432
12780,CASN3,2012-09-30,2012-11-08,357547216,357547216,715094432
12781,CASN3,2012-12-31,2013-02-15,357547216,357547216,715094432
12782,CASN3,2013-03-31,2013-05-15,357547216,357547216,715094432
12783,CASN3,2013-06-30,2013-08-13,357547216,357547216,715094432
12784,CASN3,2013-09-30,2013-11-13,357547216,357547216,715094432
12785,CASN3,2013-12-31,2014-03-27,357547216,357547216,715094432
12786,CASN3,2014-03-31,2014-05-08,357547216,357547216,715094432
12787,CASN3,2014-06-30,2014-08-14,357547216,357547216,715094432
12788,CASN3,2014-09-30,2014-11-10,357547216,357547216,715094432
12789,CASN3,2014-12-31,2015-02-27,357547216,357547216,715094432
12790,CASN3,2015-03-31,2015-05-14,357547216,357547216,715094432
12791,CASN3,2015-06-30,2015-08-06,357547216,357547216,715094432
12792,CASN3,2015-09-30,2015-11-12,357547216,357547216,715094432
12793,CASN3,2015-12-31,2016-03-15,357547216,357547216,715094432
12794,CASN3,2016-03-31,2016-05-12,357547216,357547216,715094432
12795,CASN3,2016-06-30,2016-08-12,357547216,357547216,715094432
12796,CASN3,2016-09-30,2016-11-11,357547216,357547216,715094432
12797,CASN3,2016-12-31,2017-04-12,357547216,357547216,715094432
12798,CASN3,2017-03-31,2017-05-11,357547216,357547216,715094432
12799,CASN3,2017-06-30,2017-08-10,357547216,357547216,715094432
12800,CASN3,2017-09-30,2017-11-13,357547216,357547216,715094432
12801,CASN3,2017-12-31,2018-03-27,357547216,357547216,715094432
12802,CASN3,2018-03-31,2018-05-11,357547216,357547216,715094432
12803,CASN3,2018-06-30,2020-11-13,357547216,357547216,715094432
12804,CASN3,2018-09-30,2018-11-13,357547216,357547216,715094432
12805,CASN3,2018-12-31,2019-04-05,357547216,357547216,715094432
12806,CASN3,2019-03-31,2019-05-14,357547216,357547216,715094432
12807,CASN3,2019-06-30,2019-12-18,357547216,357547216,715094432
12808,CASN3,2019-09-30,2019-11-26,357547216,357547216,715094432
12809,CASN3,2019-12-31,2020-03-31,357547216,357547216,715094432
12810,CASN3,2020-03-31,2020-07-13,357547216,357547216,715094432
12811,CASN3,2020-06-30,2020-08-28,357547216,357547216,715094432
12812,CASN3,2020-09-30,2020-11-13,375538169,375792673,751330842
12813,CASN3,2020-12-31,2021-03-26,375538169,375792673,751330842
12814,CASN4,2010-12-31,2011-04-01,351280,351280,702560
12815,CASN4,2011-03-31,2011-05-17,351280,351280,702560
12816,CASN4,2011-06-30,2011-08-22,351280,351280,702560
12817,CASN4,2011-09-30,2011-11-11,351280,351280,702560
12818,CASN4,2011-12-31,2012-02-27,357547216,357547216,715094432
12819,CASN4,2012-03-31,2012-05-14,357547216,357547216,715094432
12820,CASN4,2012-06-30,2012-09-04,357547216,357547216,715094432
12821,CASN4,2012-09-30,2012-11-08,357547216,357547216,715094432
12822,CASN4,2012-12-31,2013-02-15,357547216,357547216,715094432
12823,CASN4,2013-03-31,2013-05-15,357547216,357547216,715094432
12824,CASN4,2013-06-30,2013-08-13,357547216,357547216,715094432
12825,CASN4,2013-09-30,2013-11-13,357547216,357547216,715094432
12826,CASN4,2013-12-31,2014-03-27,357547216,357547216,715094432
12827,CASN4,2014-03-31,2014-05-08,357547216,357547216,715094432
12828,CASN4,2014-06-30,2014-08-14,357547216,357547216,715094432
12829,CASN4,2014-09-30,2014-11-10,357547216,357547216,715094432
12830,CASN4,2014-12-31,2015-02-27,357547216,357547216,715094432
12831,CASN4,2015-03-31,2015-05-14,357547216,357547216,715094432
12832,CASN4,2015-06-30,2015-08-06,357547216,357547216,715094432
12833,CASN4,2015-09-30,2015-11-12,357547216,357547216,715094432
12834,CASN4,2015-12-31,2016-03-15,357547216,357547216,715094432
12835,CASN4,2016-03-31,2016-05-12,357547216,357547216,715094432
12836,CASN4,2016-06-30,2016-08-12,357547216,357547216,715094432
12837,CASN4,2016-09-30,2016-11-11,357547216,357547216,715094432
12838,CASN4,2016-12-31,2017-04-12,357547216,357547216,715094432
12839,CASN4,2017-03-31,2017-05-11,357547216,357547216,715094432
12840,CASN4,2017-06-30,2017-08-10,357547216,357547216,715094432
12841,CASN4,2017-09-30,2017-11-13,357547216,357547216,715094432
12842,CASN4,2017-12-31,2018-03-27,357547216,357547216,715094432
12843,CASN4,2018-03-31,2018-05-11,357547216,357547216,715094432
12844,CASN4,2018-06-30,2020-11-13,357547216,357547216,715094432
12845,CASN4,2018-09-30,2018-11-13,357547216,357547216,715094432
12846,CASN4,2018-12-31,2019-04-05,357547216,357547216,715094432
12847,CASN4,2019-03-31,2019-05-14,357547216,357547216,715094432
12848,CASN4,2019-06-30,2019-12-18,357547216,357547216,715094432
12849,CASN4,2019-09-30,2019-11-26,357547216,357547216,715094432
12850,CASN4,2019-12-31,2020-03-31,357547216,357547216,715094432
12851,CASN4,2020-03-31,2020-07-13,357547216,357547216,715094432
12852,CASN4,2020-06-30,2020-08-28,357547216,357547216,715094432
12853,CASN4,2020-09-30,2020-11-13,375538169,375792673,751330842
12854,CASN4,2020-12-31,2021-03-26,375538169,375792673,751330842
12855,OPHE3B,2010-12-31,2011-03-28,861681921,0,861681921
12856,OPHE3B,2011-03-31,2011-05-16,861682,0,861682
12857,OPHE3B,2011-06-30,2011-08-15,862901,0,862901
12858,OPHE3B,2011-09-30,2011-11-14,862901,0,862901
12859,OPHE3B,2011-12-31,2012-03-27,862603827,0,862603827
12860,OPHE3B,2012-03-31,2012-05-11,862603827,0,862603827
12861,OPHE3B,2012-06-30,2012-07-31,862603827,0,862603827
12862,OPHE3B,2012-09-30,2012-10-25,882703827,0,882703827
12863,OPHE3B,2012-12-31,2013-03-27,882703827,0,882703827
12864,OPHE3B,2013-03-31,2013-05-13,882703827,0,882703827
12865,OPHE3B,2013-06-30,2013-08-08,882703827,0,882703827
12866,OPHE3B,2013-09-30,2013-11-07,882703827,0,882703827
12867,OPHE3B,2013-12-31,2014-03-18,882703827,0,882703827
12868,OPHE3B,2014-03-31,2014-05-08,882703827,0,882703827
12869,OPHE3B,2014-06-30,2014-08-04,896703827,0,896703827
12870,OPHE3B,2014-09-30,2014-11-05,896703827,0,896703827
12871,OPHE3B,2014-12-31,2015-03-11,896703827,0,896703827
12872,OPHE3B,2015-03-31,2015-05-13,1206703827,0,1206703827
12873,OPHE3B,2015-06-30,2015-08-14,1206703827,0,1206703827
12874,OPHE3B,2015-09-30,2015-11-12,1206703827,0,1206703827
12875,OPHE3B,2015-12-31,2016-03-18,1206703827,0,1206703827
12876,OPHE3B,2016-03-31,2016-05-13,1206703827,0,1206703827
12877,OPHE3B,2016-06-30,2016-08-09,1206703827,0,1206703827
12878,OPHE3B,2016-09-30,2016-11-11,1206703827,0,1206703827
12879,OPHE3B,2016-12-31,2017-03-29,1206703827,0,1206703827
12880,OPHE3B,2017-03-31,2017-07-13,1206703827,0,1206703827
12881,OPHE3B,2017-06-30,2017-08-15,1206703827,0,1206703827
12882,OPHE3B,2017-09-30,2017-11-14,1206703827,0,1206703827
12883,OPHE3B,2017-12-31,2018-03-29,1206703827,0,1206703827
12884,OPHE3B,2018-03-31,2018-05-15,1206703827,0,1206703827
12885,OPHE3B,2018-06-30,2018-08-14,1206703827,0,1206703827
12886,OPHE3B,2018-09-30,2018-11-14,1206703827,0,1206703827
12887,OPHE3B,2018-12-31,2019-04-01,1206703827,0,1206703827
12888,OPHE3B,2019-03-31,2019-05-15,1206703827,0,1206703827
12889,OPHE3B,2019-06-30,2019-08-13,1206703827,0,1206703827
12890,OPHE3B,2019-09-30,2019-11-14,1816703827,0,1816703827
12891,OPHE3B,2019-12-31,2020-03-19,1816703827,0,1816703827
12892,OPHE3B,2020-03-31,2020-06-03,1816703827,0,1816703827
12893,OPHE3B,2020-06-30,2020-08-28,1816703827,0,1816703827
12894,OPHE3B,2020-09-30,2020-11-13,1816703827,0,1816703827
12895,OPHE3B,2020-12-31,2021-03-09,1816703827,0,1816703827
12896,EMAE3,2010-12-31,2011-03-31,14705,22242,36947
12897,EMAE3,2011-03-31,2011-05-17,14705,22242,36947
12898,EMAE3,2011-06-30,2011-08-12,14705,22242,36947
12899,EMAE3,2011-09-30,2011-11-11,14705,22242,36947
12900,EMAE3,2011-12-31,2012-03-22,14705,22242,36947
12901,EMAE3,2012-03-31,2012-05-15,14705,22242,36947
12902,EMAE3,2012-06-30,2012-08-14,14705,22242,36947
12903,EMAE3,2012-09-30,2012-11-14,14705,22242,36947
12904,EMAE3,2012-12-31,2013-03-22,14705,22242,36947
12905,EMAE3,2013-03-31,2013-05-14,14705,22242,36947
12906,EMAE3,2013-06-30,2013-08-14,14705,22242,36947
12907,EMAE3,2013-09-30,2013-11-08,14705,22242,36947
12908,EMAE3,2013-12-31,2014-03-25,14705,22242,36947
12909,EMAE3,2014-03-31,2014-05-15,14705,22242,36947
12910,EMAE3,2014-06-30,2014-08-14,14705,22242,36947
12911,EMAE3,2014-09-30,2014-11-10,14705,22242,36947
12912,EMAE3,2014-12-31,2015-03-27,14705,22242,36947
12913,EMAE3,2015-03-31,2015-05-15,14705,22242,36947
12914,EMAE3,2015-06-30,2015-08-14,14705,22242,36947
12915,EMAE3,2015-09-30,2015-11-13,14705,22242,36947
12916,EMAE3,2015-12-31,2016-03-24,14705,22242,36947
12917,EMAE3,2016-03-31,2016-05-13,14705,22242,36947
12918,EMAE3,2016-06-30,2016-08-12,14705,22242,36947
12919,EMAE3,2016-09-30,2016-11-09,14705,22242,36947
12920,EMAE3,2016-12-31,2017-03-24,14705,22242,36947
12921,EMAE3,2017-03-31,2017-05-15,14705,22242,36947
12922,EMAE3,2017-06-30,2017-08-10,14705,22242,36947
12923,EMAE3,2017-09-30,2017-11-09,14705,22242,36947
12924,EMAE3,2017-12-31,2018-03-22,14705,22242,36947
12925,EMAE3,2018-03-31,2018-05-09,14705,22242,36947
12926,EMAE3,2018-06-30,2018-08-09,14705,22242,36947
12927,EMAE3,2018-09-30,2018-11-08,14705,22242,36947
12928,EMAE3,2018-12-31,2019-03-22,14705,22242,36947
12929,EMAE3,2019-03-31,2019-05-15,14705,22242,36947
12930,EMAE3,2019-06-30,2019-08-08,14705,22242,36947
12931,EMAE3,2019-09-30,2019-11-08,14705,22242,36947
12932,EMAE3,2019-12-31,2020-03-20,14705,22242,36947
12933,EMAE3,2020-03-31,2020-06-29,14705,22242,36947
12934,EMAE3,2020-06-30,2020-08-06,14705,22242,36947
12935,EMAE3,2020-09-30,2020-11-10,14705,22242,36947
12936,EMAE3,2020-12-31,2021-03-19,14705,22242,36947
12937,EMAE4,2010-12-31,2011-03-31,14705,22242,36947
12938,EMAE4,2011-03-31,2011-05-17,14705,22242,36947
12939,EMAE4,2011-06-30,2011-08-12,14705,22242,36947
12940,EMAE4,2011-09-30,2011-11-11,14705,22242,36947
12941,EMAE4,2011-12-31,2012-03-22,14705,22242,36947
12942,EMAE4,2012-03-31,2012-05-15,14705,22242,36947
12943,EMAE4,2012-06-30,2012-08-14,14705,22242,36947
12944,EMAE4,2012-09-30,2012-11-14,14705,22242,36947
12945,EMAE4,2012-12-31,2013-03-22,14705,22242,36947
12946,EMAE4,2013-03-31,2013-05-14,14705,22242,36947
12947,EMAE4,2013-06-30,2013-08-14,14705,22242,36947
12948,EMAE4,2013-09-30,2013-11-08,14705,22242,36947
12949,EMAE4,2013-12-31,2014-03-25,14705,22242,36947
12950,EMAE4,2014-03-31,2014-05-15,14705,22242,36947
12951,EMAE4,2014-06-30,2014-08-14,14705,22242,36947
12952,EMAE4,2014-09-30,2014-11-10,14705,22242,36947
12953,EMAE4,2014-12-31,2015-03-27,14705,22242,36947
12954,EMAE4,2015-03-31,2015-05-15,14705,22242,36947
12955,EMAE4,2015-06-30,2015-08-14,14705,22242,36947
12956,EMAE4,2015-09-30,2015-11-13,14705,22242,36947
12957,EMAE4,2015-12-31,2016-03-24,14705,22242,36947
12958,EMAE4,2016-03-31,2016-05-13,14705,22242,36947
12959,EMAE4,2016-06-30,2016-08-12,14705,22242,36947
12960,EMAE4,2016-09-30,2016-11-09,14705,22242,36947
12961,EMAE4,2016-12-31,2017-03-24,14705,22242,36947
12962,EMAE4,2017-03-31,2017-05-15,14705,22242,36947
12963,EMAE4,2017-06-30,2017-08-10,14705,22242,36947
12964,EMAE4,2017-09-30,2017-11-09,14705,22242,36947
12965,EMAE4,2017-12-31,2018-03-22,14705,22242,36947
12966,EMAE4,2018-03-31,2018-05-09,14705,22242,36947
12967,EMAE4,2018-06-30,2018-08-09,14705,22242,36947
12968,EMAE4,2018-09-30,2018-11-08,14705,22242,36947
12969,EMAE4,2018-12-31,2019-03-22,14705,22242,36947
12970,EMAE4,2019-03-31,2019-05-15,14705,22242,36947
12971,EMAE4,2019-06-30,2019-08-08,14705,22242,36947
12972,EMAE4,2019-09-30,2019-11-08,14705,22242,36947
12973,EMAE4,2019-12-31,2020-03-20,14705,22242,36947
12974,EMAE4,2020-03-31,2020-06-29,14705,22242,36947
12975,EMAE4,2020-06-30,2020-08-06,14705,22242,36947
12976,EMAE4,2020-09-30,2020-11-10,14705,22242,36947
12977,EMAE4,2020-12-31,2021-03-19,14705,22242,36947
12978,EGIE3,2010-12-31,2011-04-08,652742192,0,652742192
12979,EGIE3,2011-03-31,2011-04-28,652742192,0,652742192
12980,EGIE3,2011-06-30,2011-07-29,652742192,0,652742192
12981,EGIE3,2011-09-30,2011-11-04,652742192,0,652742192
12982,EGIE3,2011-12-31,2012-02-07,652742192,0,652742192
12983,EGIE3,2012-03-31,2012-05-04,652742192,0,652742192
12984,EGIE3,2012-06-30,2012-07-26,652742192,0,652742192
12985,EGIE3,2012-09-30,2012-10-25,652742192,0,652742192
12986,EGIE3,2012-12-31,2013-02-07,652742192,0,652742192
12987,EGIE3,2013-03-31,2013-04-30,652742192,0,652742192
12988,EGIE3,2013-06-30,2013-07-30,652742192,0,652742192
12989,EGIE3,2013-09-30,2013-10-25,652742192,0,652742192
12990,EGIE3,2013-12-31,2014-02-20,652742192,0,652742192
12991,EGIE3,2014-03-31,2014-04-25,652742192,0,652742192
12992,EGIE3,2014-06-30,2014-07-25,652742192,0,652742192
12993,EGIE3,2014-09-30,2014-10-24,652742192,0,652742192
12994,EGIE3,2014-12-31,2015-03-30,652742192,0,652742192
12995,EGIE3,2015-03-31,2015-04-24,652742192,0,652742192
12996,EGIE3,2015-06-30,2015-07-24,652742192,0,652742192
12997,EGIE3,2015-09-30,2015-11-06,652742192,0,652742192
12998,EGIE3,2015-12-31,2016-02-23,652742192,0,652742192
12999,EGIE3,2016-03-31,2016-05-05,652742192,0,652742192
13000,EGIE3,2016-06-30,2016-07-28,652742192,0,652742192
13001,EGIE3,2016-09-30,2016-10-27,652742192,0,652742192
13002,EGIE3,2016-12-31,2017-02-23,652742192,0,652742192
13003,EGIE3,2017-03-31,2017-04-25,652742192,0,652742192
13004,EGIE3,2017-06-30,2017-07-27,652742192,0,652742192
13005,EGIE3,2017-09-30,2017-10-26,652742192,0,652742192
13006,EGIE3,2017-12-31,2018-02-22,652742192,0,652742192
13007,EGIE3,2018-03-31,2018-04-19,652742192,0,652742192
13008,EGIE3,2018-06-30,2018-08-08,652742192,0,652742192
13009,EGIE3,2018-09-30,2018-10-31,652742192,0,652742192
13010,EGIE3,2018-12-31,2019-02-19,815927740,0,815927740
13011,EGIE3,2019-03-31,2019-05-08,815927740,0,815927740
13012,EGIE3,2019-06-30,2019-08-06,815927740,0,815927740
13013,EGIE3,2019-09-30,2019-11-05,815927740,0,815927740
13014,EGIE3,2019-12-31,2020-02-20,815927740,0,815927740
13015,EGIE3,2020-03-31,2020-06-24,815927740,0,815927740
13016,EGIE3,2020-06-30,2020-07-30,815927740,0,815927740
13017,EGIE3,2020-09-30,2020-11-05,815927740,0,815927740
13018,EGIE3,2020-12-31,2021-02-11,815927740,0,815927740
13019,SPRT3B,2010-12-31,2011-03-29,2121000,0,2121000
13020,SPRT3B,2011-03-31,2011-05-16,4049708,0,4049708
13021,SPRT3B,2011-06-30,2011-08-13,4049708,0,4049708
13022,SPRT3B,2011-09-30,2011-11-09,4049708,0,4049708
13023,SPRT3B,2011-12-31,2012-03-29,4049708,0,4049708
13024,SPRT3B,2012-03-31,2012-05-15,4049708,0,4049708
13025,SPRT3B,2012-06-30,2012-08-14,4049708,0,4049708
13026,SPRT3B,2012-09-30,2012-11-12,4049708,0,4049708
13027,SPRT3B,2012-12-31,2013-03-28,4049708,0,4049708
13028,SPRT3B,2013-03-31,2013-05-15,4049708,0,4049708
13029,SPRT3B,2013-06-30,2013-08-13,4049708,0,4049708
13030,SPRT3B,2013-09-30,2013-11-13,4049708,0,4049708
13031,SPRT3B,2013-12-31,2014-03-28,4049708,0,4049708
13032,SPRT3B,2014-03-31,2014-05-13,4049708,0,4049708
13033,SPRT3B,2014-06-30,2014-08-12,4049708,0,4049708
13034,SPRT3B,2014-09-30,2014-11-13,4049708,0,4049708
13035,SPRT3B,2014-12-31,2015-03-30,4049708,0,4049708
13036,SPRT3B,2015-03-31,2015-05-15,4049708,0,4049708
13037,SPRT3B,2015-06-30,2015-08-14,4049708,0,4049708
13038,SPRT3B,2015-09-30,2015-11-13,4049708,0,4049708
13039,SPRT3B,2015-12-31,2016-03-30,4049708,0,4049708
13040,SPRT3B,2016-03-31,2016-05-13,4049708,0,4049708
13041,SPRT3B,2016-06-30,2016-08-11,4624892,0,4624892
13042,SPRT3B,2016-09-30,2016-11-10,4849892,0,4849892
13043,SPRT3B,2016-12-31,2017-03-29,4849892,0,4849892
13044,SPRT3B,2017-03-31,2017-05-15,4849892,0,4849892
13045,SPRT3B,2017-06-30,2017-08-14,4849892,0,4849892
13046,SPRT3B,2017-09-30,2017-11-14,4849892,0,4849892
13047,SPRT3B,2017-12-31,2018-09-13,4849892,0,4849892
13048,SPRT3B,2018-03-31,2018-05-15,4849892,0,4849892
13049,SPRT3B,2018-06-30,2018-09-11,4849892,0,4849892
13050,SPRT3B,2018-09-30,2019-01-30,4849892,0,4849892
13051,SPRT3B,2018-12-31,2019-03-29,4849892,0,4849892
13052,RAIL3,2010-12-31,2011-04-04,689122312,0,689122312
13053,RAIL3,2011-03-31,2011-05-10,689122,0,689122
13054,RAIL3,2011-06-30,2011-08-09,689122312,0,689122312
13055,RAIL3,2011-09-30,2011-11-08,689122312,0,689122312
13056,RAIL3,2011-12-31,2012-03-06,687664312,0,687664312
13057,RAIL3,2012-03-31,2012-05-14,687664312,0,687664312
13058,RAIL3,2012-06-30,2012-08-14,687664312,0,687664312
13059,RAIL3,2012-09-30,2012-11-13,687664312,0,687664312
13060,RAIL3,2012-12-31,2013-03-06,687664312,0,687664312
13061,RAIL3,2013-03-31,2013-05-07,687664312,0,687664312
13062,RAIL3,2013-06-30,2013-08-07,687664312,0,687664312
13063,RAIL3,2013-09-30,2014-04-10,687664312,0,687664312
13064,RAIL3,2013-12-31,2014-02-26,687664312,0,687664312
13065,RAIL3,2014-03-31,2014-05-06,687664312,0,687664312
13066,RAIL3,2014-06-30,2014-12-22,687664312,0,687664312
13067,RAIL3,2014-09-30,2014-11-04,687664312,0,687664312
13068,RAIL3,2014-12-31,2016-03-01,687664312,0,687664312
13069,RAIL3,2015-03-31,2015-05-11,687664312,0,687664312
13070,RAIL3,2015-06-30,2015-10-01,681995165,0,681995165
13071,RAIL3,2015-09-30,2015-11-13,681995165,0,681995165
13072,RAIL3,2015-12-31,2016-03-30,681995165,0,681995165
13073,RAIL3,2016-03-31,2016-05-12,2616038002,0,2616038002
13074,RAIL3,2016-06-30,2016-08-12,2616038002,0,2616038002
13075,RAIL3,2016-09-30,2016-11-10,2616038002,0,2616038002
13076,RAIL3,2016-12-31,2017-02-20,1339015898,0,1339015898
13077,RAIL3,2017-03-31,2017-05-10,1339015898,0,1339015898
13078,RAIL3,2017-06-30,2017-08-09,1339015898,0,1339015898
13079,RAIL3,2017-09-30,2017-11-08,1339015898,0,1339015898
13080,RAIL3,2017-12-31,2018-02-27,1559015898,0,1559015898
13081,RAIL3,2018-03-31,2018-05-08,1559015898,0,1559015898
13082,RAIL3,2018-06-30,2018-08-13,1559015898,0,1559015898
13083,RAIL3,2018-09-30,2018-11-08,1559015898,0,1559015898
13084,RAIL3,2018-12-31,2019-02-13,1559015898,0,1559015898
13085,RAIL3,2019-03-31,2019-05-09,1559015898,0,1559015898
13086,RAIL3,2019-06-30,2019-08-12,1559015898,0,1559015898
13087,RAIL3,2019-09-30,2019-11-11,1559015898,0,1559015898
13088,RAIL3,2019-12-31,2020-02-13,1559015898,0,1559015898
13089,RAIL3,2020-03-31,2020-05-27,1559015898,0,1559015898
13090,RAIL3,2020-06-30,2020-08-13,1559015898,0,1559015898
13091,RAIL3,2020-09-30,2020-11-11,1853268772,0,1853268772
13092,RAIL3,2020-12-31,2021-02-12,1853268772,0,1853268772
13093,EKTR3,2010-12-31,2011-03-28,91880972,101878293,193759265
13094,EKTR3,2011-03-31,2011-05-13,91880972,101878293,193759265
13095,EKTR3,2011-06-30,2011-08-11,91880972,101878293,193759265
13096,EKTR3,2011-09-30,2011-11-17,91880972,101878293,193759265
13097,EKTR3,2011-12-31,2012-02-14,91880972,101878293,193759265
13098,EKTR3,2012-03-31,2012-04-26,91880972,101878293,193759265
13099,EKTR3,2012-06-30,2012-07-18,91880972,101878293,193759265
13100,EKTR3,2012-09-30,2012-10-19,91880972,101878293,193759265
13101,EKTR3,2012-12-31,2013-02-06,91880972,101878293,193759265
13102,EKTR3,2013-03-31,2013-04-17,91880972,101878293,193759265
13103,EKTR3,2013-06-30,2013-07-17,91880972,101878293,193759265
13104,EKTR3,2013-09-30,2013-10-16,91880972,101878293,193759265
13105,EKTR3,2013-12-31,2014-02-12,91880972,101878293,193759265
13106,EKTR3,2014-03-31,2014-05-13,91880972,101878293,193759265
13107,EKTR3,2014-06-30,2014-08-12,91880972,101878293,193759265
13108,EKTR3,2014-09-30,2014-10-15,91880972,101878293,193759265
13109,EKTR3,2014-12-31,2015-02-24,91880972,101878293,193759265
13110,EKTR3,2015-03-31,2015-04-22,91880972,101878293,193759265
13111,EKTR3,2015-06-30,2015-07-16,91880972,101878293,193759265
13112,EKTR3,2015-09-30,2015-10-27,91880972,101878293,193759265
13113,EKTR3,2015-12-31,2016-02-19,91880972,101878293,193759265
13114,EKTR3,2016-03-31,2016-04-20,91880972,101878293,193759265
13115,EKTR3,2016-06-30,2016-07-13,91880972,101878293,193759265
13116,EKTR3,2016-09-30,2016-10-14,91880972,101878293,193759265
13117,EKTR3,2016-12-31,2017-02-17,91880972,101878293,193759265
13118,EKTR3,2017-03-31,2017-04-20,91880972,101878293,193759265
13119,EKTR3,2017-06-30,2017-07-14,91880972,101878293,193759265
13120,EKTR3,2017-09-30,2017-11-06,91880972,101878293,193759265
13121,EKTR3,2017-12-31,2018-04-11,91880972,101878293,193759265
13122,EKTR3,2018-03-31,2018-04-23,91880972,101878293,193759265
13123,EKTR3,2018-06-30,2018-07-23,91880972,101878293,193759265
13124,EKTR3,2018-09-30,2018-10-22,91880972,101878293,193759265
13125,EKTR3,2018-12-31,2019-02-14,91880972,101878293,193759265
13126,EKTR3,2019-03-31,2019-04-23,91880972,101878293,193759265
13127,EKTR3,2019-06-30,2019-07-24,91880972,101878293,193759265
13128,EKTR3,2019-09-30,2019-10-24,91881,101879,193760
13129,EKTR3,2019-12-31,2020-02-17,91881,101879,193760
13130,EKTR3,2020-03-31,2020-04-27,91881,101879,193760
13131,EKTR3,2020-06-30,2020-07-23,91881,101879,193760
13132,EKTR3,2020-09-30,2020-10-20,91881,101879,193760
13133,EKTR3,2020-12-31,2021-02-09,91881,101878,193759
13134,EKTR4,2010-12-31,2011-03-28,91880972,101878293,193759265
13135,EKTR4,2011-03-31,2011-05-13,91880972,101878293,193759265
13136,EKTR4,2011-06-30,2011-08-11,91880972,101878293,193759265
13137,EKTR4,2011-09-30,2011-11-17,91880972,101878293,193759265
13138,EKTR4,2011-12-31,2012-02-14,91880972,101878293,193759265
13139,EKTR4,2012-03-31,2012-04-26,91880972,101878293,193759265
13140,EKTR4,2012-06-30,2012-07-18,91880972,101878293,193759265
13141,EKTR4,2012-09-30,2012-10-19,91880972,101878293,193759265
13142,EKTR4,2012-12-31,2013-02-06,91880972,101878293,193759265
13143,EKTR4,2013-03-31,2013-04-17,91880972,101878293,193759265
13144,EKTR4,2013-06-30,2013-07-17,91880972,101878293,193759265
13145,EKTR4,2013-09-30,2013-10-16,91880972,101878293,193759265
13146,EKTR4,2013-12-31,2014-02-12,91880972,101878293,193759265
13147,EKTR4,2014-03-31,2014-05-13,91880972,101878293,193759265
13148,EKTR4,2014-06-30,2014-08-12,91880972,101878293,193759265
13149,EKTR4,2014-09-30,2014-10-15,91880972,101878293,193759265
13150,EKTR4,2014-12-31,2015-02-24,91880972,101878293,193759265
13151,EKTR4,2015-03-31,2015-04-22,91880972,101878293,193759265
13152,EKTR4,2015-06-30,2015-07-16,91880972,101878293,193759265
13153,EKTR4,2015-09-30,2015-10-27,91880972,101878293,193759265
13154,EKTR4,2015-12-31,2016-02-19,91880972,101878293,193759265
13155,EKTR4,2016-03-31,2016-04-20,91880972,101878293,193759265
13156,EKTR4,2016-06-30,2016-07-13,91880972,101878293,193759265
13157,EKTR4,2016-09-30,2016-10-14,91880972,101878293,193759265
13158,EKTR4,2016-12-31,2017-02-17,91880972,101878293,193759265
13159,EKTR4,2017-03-31,2017-04-20,91880972,101878293,193759265
13160,EKTR4,2017-06-30,2017-07-14,91880972,101878293,193759265
13161,EKTR4,2017-09-30,2017-11-06,91880972,101878293,193759265
13162,EKTR4,2017-12-31,2018-04-11,91880972,101878293,193759265
13163,EKTR4,2018-03-31,2018-04-23,91880972,101878293,193759265
13164,EKTR4,2018-06-30,2018-07-23,91880972,101878293,193759265
13165,EKTR4,2018-09-30,2018-10-22,91880972,101878293,193759265
13166,EKTR4,2018-12-31,2019-02-14,91880972,101878293,193759265
13167,EKTR4,2019-03-31,2019-04-23,91880972,101878293,193759265
13168,EKTR4,2019-06-30,2019-07-24,91880972,101878293,193759265
13169,EKTR4,2019-09-30,2019-10-24,91881,101879,193760
13170,EKTR4,2019-12-31,2020-02-17,91881,101879,193760
13171,EKTR4,2020-03-31,2020-04-27,91881,101879,193760
13172,EKTR4,2020-06-30,2020-07-23,91881,101879,193760
13173,EKTR4,2020-09-30,2020-10-20,91881,101879,193760
13174,EKTR4,2020-12-31,2021-02-09,91881,101878,193759
13175,CPTP3B,2010-12-31,2011-03-29,8766858,0,8766858
13176,CPTP3B,2011-03-31,2011-05-17,14049398,0,14049398
13177,CPTP3B,2011-06-30,2011-08-13,14049398,0,14049398
13178,CPTP3B,2011-09-30,2011-11-09,14049398,0,14049398
13179,CPTP3B,2011-12-31,2012-03-29,14049398,0,14049398
13180,CPTP3B,2012-03-31,2012-05-15,14049398,0,14049398
13181,CPTP3B,2012-06-30,2012-08-14,14049398,0,14049398
13182,CPTP3B,2012-09-30,2012-11-12,14049398,0,14049398
13183,CPTP3B,2012-12-31,2013-03-28,14049398,0,14049398
13184,CPTP3B,2013-03-31,2013-05-15,14049398,0,14049398
13185,CPTP3B,2013-06-30,2013-08-13,14049398,0,14049398
13186,CPTP3B,2013-09-30,2013-11-13,14049398,0,14049398
13187,CPTP3B,2013-12-31,2014-03-28,14049398,0,14049398
13188,CPTP3B,2014-03-31,2014-05-14,14049398,0,14049398
13189,CPTP3B,2014-06-30,2014-08-13,14049398,0,14049398
13190,CPTP3B,2014-09-30,2014-11-13,14049398,0,14049398
13191,CPTP3B,2014-12-31,2015-03-30,14049398,0,14049398
13192,CPTP3B,2015-03-31,2015-05-15,14049398,0,14049398
13193,CPTP3B,2015-06-30,2015-08-14,14049398,0,14049398
13194,CPTP3B,2015-09-30,2015-11-13,14049398,0,14049398
13195,CPTP3B,2015-12-31,2016-03-30,14049398,0,14049398
13196,CPTP3B,2016-03-31,2016-05-13,14049398,0,14049398
13197,CPTP3B,2016-06-30,2016-08-11,143243,0,143243
13198,CPTP3B,2016-09-30,2016-11-10,143243,0,143243
13199,CPTP3B,2016-12-31,2017-03-29,143243,0,143243
13200,CPTP3B,2017-03-31,2017-05-15,143243,0,143243
13201,CPTP3B,2017-06-30,2017-08-14,143243,0,143243
13202,CPTP3B,2017-09-30,2017-11-14,143243,0,143243
13203,CPTP3B,2017-12-31,2018-09-13,143243,0,143243
13204,CPTP3B,2018-03-31,2018-09-26,143243,0,143243
13205,CPTP3B,2018-06-30,2018-09-26,143243,0,143243
13206,CPTP3B,2018-09-30,2019-01-30,143243,0,143243
13207,CPTP3B,2018-12-31,2019-10-02,143243,0,143243
13208,TIMP3,2010-12-31,2011-03-15,843281477,1632453583,2475735060
13209,TIMP3,2011-03-31,2011-05-02,843281477,1632453583,2475735060
13210,TIMP3,2011-06-30,2011-08-02,843986515,1633818420,2477804935
13211,TIMP3,2011-09-30,2011-10-31,2217374279,0,2217374279
13212,TIMP3,2011-12-31,2012-03-13,2417632647,0,2417632647
13213,TIMP3,2012-03-31,2012-04-26,2417632647,0,2417632647
13214,TIMP3,2012-06-30,2012-07-30,2417632647,0,2417632647
13215,TIMP3,2012-09-30,2012-10-30,2417632647,0,2417632647
13216,TIMP3,2012-12-31,2013-02-06,2417632647,0,2417632647
13217,TIMP3,2013-03-31,2013-04-30,2417632647,0,2417632647
13218,TIMP3,2013-06-30,2013-07-30,2417632647,0,2417632647
13219,TIMP3,2013-09-30,2013-10-29,2417632647,0,2417632647
13220,TIMP3,2013-12-31,2014-02-13,2417632647,0,2417632647
13221,TIMP3,2014-03-31,2014-05-08,2417632647,0,2417632647
13222,TIMP3,2014-06-30,2014-07-31,2417632647,0,2417632647
13223,TIMP3,2014-09-30,2014-11-04,2420136000,0,2420136000
13224,TIMP3,2014-12-31,2015-02-13,2421032479,0,2421032479
13225,TIMP3,2015-03-31,2015-05-05,2421032479,0,2421032479
13226,TIMP3,2015-06-30,2015-08-04,2421032479,0,2421032479
13227,TIMP3,2015-09-30,2015-11-03,2421032479,0,2421032479
13228,TIMP3,2015-12-31,2016-02-04,2421032479,0,2421032479
13229,TIMP3,2016-03-31,2016-05-11,2421032479,0,2421032479
13230,TIMP3,2016-06-30,2016-07-25,2421032479,0,2421032479
13231,TIMP3,2016-09-30,2016-10-31,2421032479,0,2421032479
13232,TIMP3,2016-12-31,2017-02-02,2421032479,0,2421032479
13233,TIMP3,2017-03-31,2017-04-27,2421032479,0,2421032479
13234,TIMP3,2017-06-30,2017-07-25,2421032479,0,2421032479
13235,TIMP3,2017-09-30,2017-11-07,2421032479,0,2421032479
13236,TIMP3,2017-12-31,2018-02-05,2421032479,0,2421032479
13237,TIMP3,2018-03-31,2018-05-08,2421032479,0,2421032479
13238,TIMP3,2018-06-30,2018-07-19,2421032479,0,2421032479
13239,TIMP3,2018-09-30,2018-11-06,2421032479,0,2421032479
13240,TIMP3,2018-12-31,2019-02-19,2421032479,0,2421032479
13241,TIMP3,2019-03-31,2019-05-07,2421032479,0,2421032479
13242,TIMP3,2019-06-30,2019-07-30,2421032479,0,2421032479
13243,TIMP3,2019-09-30,2019-11-05,2421032479,0,2421032479
13244,TIMP3,2019-12-31,2020-02-11,2421032479,0,2421032479
13245,TIMP3,2020-03-31,2020-05-05,2421032479,0,2421032479
13246,TIMP3,2020-06-30,2020-07-29,2421032479,0,2421032479
13247,VIVT3,2010-12-31,2011-02-16,168820,337417,506237
13248,VIVT3,2011-03-31,2011-05-12,168820,337417,506237
13249,VIVT3,2011-06-30,2011-07-27,381587,744015,1125602
13250,VIVT3,2011-09-30,2011-11-10,381587,744015,1125602
13251,VIVT3,2011-12-31,2012-02-16,381587,744015,1125602
13252,VIVT3,2012-03-31,2012-05-10,381587,744015,1125602
13253,VIVT3,2012-06-30,2012-07-25,381587,744015,1125602
13254,VIVT3,2012-09-30,2012-11-06,381587,744015,1125602
13255,VIVT3,2012-12-31,2013-02-25,381587,744015,1125602
13256,VIVT3,2013-03-31,2013-05-07,381587,744015,1125602
13257,VIVT3,2013-06-30,2014-12-23,381587,744015,1125602
13258,VIVT3,2013-09-30,2013-11-07,381587,744015,1125602
13259,VIVT3,2013-12-31,2014-02-26,381587,744015,1125602
13260,VIVT3,2014-03-31,2014-05-08,381587,744015,1125602
13261,VIVT3,2014-06-30,2014-07-30,381587,744015,1125602
13262,VIVT3,2014-09-30,2014-11-11,381587,744015,1125602
13263,VIVT3,2014-12-31,2015-02-24,381587,744015,1125602
13264,VIVT3,2015-03-31,2015-05-13,381335,741934,1123269
13265,VIVT3,2015-06-30,2015-07-29,571644,1119341,1690985
13266,VIVT3,2015-09-30,2015-11-04,571644,1119341,1690985
13267,VIVT3,2015-12-31,2016-02-24,571644,1119341,1690985
13268,VIVT3,2016-03-31,2016-04-27,571644,1119341,1690985
13269,VIVT3,2016-06-30,2016-07-26,571644,1119341,1690985
13270,VIVT3,2016-09-30,2016-10-25,571644,1119341,1690985
13271,VIVT3,2016-12-31,2017-02-21,571644,1119341,1690985
13272,VIVT3,2017-03-31,2017-05-09,571644,1119341,1690985
13273,VIVT3,2017-06-30,2017-07-26,571644,1119341,1690985
13274,VIVT3,2017-09-30,2017-10-25,571644,1119341,1690985
13275,VIVT3,2017-12-31,2018-02-21,571644,1119341,1690985
13276,VIVT3,2018-03-31,2018-04-25,571644,1119341,1690985
13277,VIVT3,2018-06-30,2018-07-25,571644,1119341,1690985
13278,VIVT3,2018-09-30,2018-10-30,571644,1119341,1690985
13279,VIVT3,2018-12-31,2019-02-20,571644,1119341,1690985
13280,VIVT3,2019-03-31,2019-05-09,571644,1119341,1690985
13281,VIVT3,2019-06-30,2019-07-24,571644,1119341,1690985
13282,VIVT3,2019-09-30,2019-11-04,571644,1119341,1690985
13283,VIVT3,2019-12-31,2020-02-19,571644,1119341,1690985
13284,VIVT3,2020-03-31,2020-05-06,571644,1119341,1690985
13285,VIVT3,2020-06-30,2020-07-29,571644,1119341,1690985
13286,VIVT3,2020-09-30,2020-10-27,571644,1119341,1690985
13287,VIVT3,2020-12-31,2021-02-23,1690985,0,1690985
13288,VIVT4,2010-12-31,2011-02-16,168820,337417,506237
13289,VIVT4,2011-03-31,2011-05-12,168820,337417,506237
13290,VIVT4,2011-06-30,2011-07-27,381587,744015,1125602
13291,VIVT4,2011-09-30,2011-11-10,381587,744015,1125602
13292,VIVT4,2011-12-31,2012-02-16,381587,744015,1125602
13293,VIVT4,2012-03-31,2012-05-10,381587,744015,1125602
13294,VIVT4,2012-06-30,2012-07-25,381587,744015,1125602
13295,VIVT4,2012-09-30,2012-11-06,381587,744015,1125602
13296,VIVT4,2012-12-31,2013-02-25,381587,744015,1125602
13297,VIVT4,2013-03-31,2013-05-07,381587,744015,1125602
13298,VIVT4,2013-06-30,2014-12-23,381587,744015,1125602
13299,VIVT4,2013-09-30,2013-11-07,381587,744015,1125602
13300,VIVT4,2013-12-31,2014-02-26,381587,744015,1125602
13301,VIVT4,2014-03-31,2014-05-08,381587,744015,1125602
13302,VIVT4,2014-06-30,2014-07-30,381587,744015,1125602
13303,VIVT4,2014-09-30,2014-11-11,381587,744015,1125602
13304,VIVT4,2014-12-31,2015-02-24,381587,744015,1125602
13305,VIVT4,2015-03-31,2015-05-13,381335,741934,1123269
13306,VIVT4,2015-06-30,2015-07-29,571644,1119341,1690985
13307,VIVT4,2015-09-30,2015-11-04,571644,1119341,1690985
13308,VIVT4,2015-12-31,2016-02-24,571644,1119341,1690985
13309,VIVT4,2016-03-31,2016-04-27,571644,1119341,1690985
13310,VIVT4,2016-06-30,2016-07-26,571644,1119341,1690985
13311,VIVT4,2016-09-30,2016-10-25,571644,1119341,1690985
13312,VIVT4,2016-12-31,2017-02-21,571644,1119341,1690985
13313,VIVT4,2017-03-31,2017-05-09,571644,1119341,1690985
13314,VIVT4,2017-06-30,2017-07-26,571644,1119341,1690985
13315,VIVT4,2017-09-30,2017-10-25,571644,1119341,1690985
13316,VIVT4,2017-12-31,2018-02-21,571644,1119341,1690985
13317,VIVT4,2018-03-31,2018-04-25,571644,1119341,1690985
13318,VIVT4,2018-06-30,2018-07-25,571644,1119341,1690985
13319,VIVT4,2018-09-30,2018-10-30,571644,1119341,1690985
13320,VIVT4,2018-12-31,2019-02-20,571644,1119341,1690985
13321,VIVT4,2019-03-31,2019-05-09,571644,1119341,1690985
13322,VIVT4,2019-06-30,2019-07-24,571644,1119341,1690985
13323,VIVT4,2019-09-30,2019-11-04,571644,1119341,1690985
13324,VIVT4,2019-12-31,2020-02-19,571644,1119341,1690985
13325,VIVT4,2020-03-31,2020-05-06,571644,1119341,1690985
13326,VIVT4,2020-06-30,2020-07-29,571644,1119341,1690985
13327,VIVT4,2020-09-30,2020-10-27,571644,1119341,1690985
13328,VIVT4,2020-12-31,2021-02-23,1690985,0,1690985
13329,BETP3B,2010-12-31,2011-03-30,2761620,0,2761620
13330,BETP3B,2011-03-31,2011-05-16,2761,0,2761
13331,BETP3B,2011-06-30,2011-08-15,2761,0,2761
13332,BETP3B,2011-09-30,2011-11-14,2761,0,2761
13333,BETP3B,2011-12-31,2012-03-27,2761620,0,2761620
13334,BETP3B,2012-03-31,2012-05-11,2761620,0,2761620
13335,BETP3B,2012-06-30,2012-07-30,2761620,0,2761620
13336,BETP3B,2012-09-30,2012-10-25,2761620,0,2761620
13337,BETP3B,2012-12-31,2013-03-27,2761620,0,2761620
13338,BETP3B,2013-03-31,2013-05-13,2761620,0,2761620
13339,BETP3B,2013-06-30,2013-08-08,2761620,0,2761620
13340,BETP3B,2013-09-30,2013-11-07,2761620,0,2761620
13341,BETP3B,2013-12-31,2014-03-19,2761620,0,2761620
13342,BETP3B,2014-03-31,2014-05-08,2761620,0,2761620
13343,BETP3B,2014-06-30,2014-08-04,2761620,0,2761620
13344,BETP3B,2014-09-30,2014-11-05,2761620,0,2761620
13345,BETP3B,2014-12-31,2015-03-12,2761620,0,2761620
13346,BETP3B,2015-03-31,2015-05-13,2761620,0,2761620
13347,BETP3B,2015-06-30,2015-08-13,2761620,0,2761620
13348,BETP3B,2015-09-30,2015-11-06,2761620,0,2761620
13349,BETP3B,2015-12-31,2016-03-09,2761620,0,2761620
13350,BETP3B,2016-03-31,2016-05-12,2761620,0,2761620
13351,BETP3B,2016-06-30,2016-07-21,2761620,0,2761620
13352,BETP3B,2016-09-30,2016-11-08,2761620,0,2761620
13353,BETP3B,2016-12-31,2017-03-23,2761620,0,2761620
13354,BETP3B,2017-03-31,2017-05-15,2761620,0,2761620
13355,BETP3B,2017-06-30,2017-08-11,2761620,0,2761620
13356,BETP3B,2017-09-30,2017-11-14,2761620,0,2761620
13357,BETP3B,2017-12-31,2018-03-27,2761620,0,2761620
13358,BETP3B,2018-03-31,2018-05-15,2761620,0,2761620
13359,BETP3B,2018-06-30,2018-08-14,2761620,0,2761620
13360,BETP3B,2018-09-30,2018-11-14,2761620,0,2761620
13361,BETP3B,2018-12-31,2019-03-22,2761620,0,2761620
13362,BETP3B,2019-03-31,2019-05-15,2761620,0,2761620
13363,BETP3B,2019-06-30,2019-08-12,2761620,0,2761620
13364,BETP3B,2019-09-30,2019-11-14,2761620,0,2761620
13365,BETP3B,2019-12-31,2020-03-20,2761620,0,2761620
13366,BETP3B,2020-03-31,2020-06-04,2761620,0,2761620
13367,BETP3B,2020-06-30,2020-08-17,2761620,0,2761620
13368,BETP3B,2020-09-30,2020-11-13,2761620,0,2761620
13369,BETP3B,2020-12-31,2021-03-08,2761620,0,2761620
13370,STBP3,2010-12-31,2011-02-03,452567,203209,655776
13371,STBP3,2011-03-31,2011-04-27,452862,204387,657249
13372,STBP3,2011-06-30,2011-07-28,453567,207205,660772
13373,STBP3,2011-09-30,2011-11-08,453584,207277,660861
13374,STBP3,2011-12-31,2012-02-02,453584,207277,660861
13375,STBP3,2012-03-31,2012-04-27,454106,209363,663469
13376,STBP3,2012-06-30,2012-07-26,454236,209881,664117
13377,STBP3,2012-09-30,2012-10-29,454244,209917,664161
13378,STBP3,2012-12-31,2013-02-04,454244,209917,664161
13379,STBP3,2013-03-31,2013-04-29,454520,211020,665540
13380,STBP3,2013-06-30,2013-07-25,454629,211457,666086
13381,STBP3,2013-09-30,2013-10-28,454629,211457,666086
13382,STBP3,2013-12-31,2014-02-10,454629,211457,666086
13383,STBP3,2014-03-31,2014-04-29,454629,211457,666086
13384,STBP3,2014-06-30,2014-07-30,454629,211457,666086
13385,STBP3,2014-09-30,2014-10-29,454629,211457,666086
13386,STBP3,2014-12-31,2015-02-09,454629,211457,666086
13387,STBP3,2015-03-31,2015-04-29,454629,211457,666086
13388,STBP3,2015-06-30,2015-08-05,454629,211457,666086
13389,STBP3,2015-09-30,2015-10-28,454629,211457,666086
13390,STBP3,2015-12-31,2016-03-09,454629,211457,666086
13391,STBP3,2016-03-31,2016-05-09,454629,211457,666086
13392,STBP3,2016-06-30,2016-08-03,454629,211457,666086
13393,STBP3,2016-09-30,2016-11-09,666086,0,666086
13394,STBP3,2016-12-31,2017-02-15,666086,0,666086
13395,STBP3,2017-03-31,2017-05-10,666086,0,666086
13396,STBP3,2017-06-30,2017-08-09,666086,0,666086
13397,STBP3,2017-09-30,2017-11-13,666318,0,666318
13398,STBP3,2017-12-31,2018-06-18,666318,0,666318
13399,STBP3,2018-03-31,2018-06-18,666318,0,666318
13400,STBP3,2018-06-30,2018-08-08,666318,0,666318
13401,STBP3,2018-09-30,2018-11-12,666318,0,666318
13402,STBP3,2018-12-31,2019-02-21,666318,0,666318
13403,STBP3,2019-03-31,2019-05-14,667166,0,667166
13404,STBP3,2019-06-30,2019-08-13,667166,0,667166
13405,STBP3,2019-09-30,2019-11-12,669236,0,669236
13406,STBP3,2019-12-31,2020-03-05,669798,0,669798
13407,STBP3,2020-03-31,2020-05-12,669798,0,669798
13408,STBP3,2020-06-30,2020-08-11,669798,0,669798
13409,STBP3,2020-09-30,2020-11-10,862478,0,862478
13410,STBP3,2020-12-31,2021-03-08,862478,0,862478
13411,MMXM3,2010-12-31,2011-03-23,472973,0,472973
13412,MMXM3,2011-03-31,2011-05-10,586207,0,586207
13413,MMXM3,2011-06-30,2011-08-09,619473,0,619473
13414,MMXM3,2011-09-30,2011-11-18,619590,0,619590
13415,MMXM3,2011-12-31,2012-04-10,619761,0,619761
13416,MMXM3,2012-03-31,2012-05-09,619761,0,619761
13417,MMXM3,2012-06-30,2012-08-13,619761,0,619761
13418,MMXM3,2012-09-30,2012-11-07,624324,0,624324
13419,MMXM3,2012-12-31,2013-03-18,624324,0,624324
13420,MMXM3,2013-03-31,2013-04-29,973227,0,973227
13421,MMXM3,2013-06-30,2013-08-14,973227,0,973227
13422,MMXM3,2013-09-30,2013-12-02,973227,0,973227
13423,MMXM3,2013-12-31,2014-03-26,973227,0,973227
13424,MMXM3,2014-03-31,2014-06-24,162205,0,162205
13425,MMXM3,2014-06-30,2014-10-31,162205,0,162205
13426,MMXM3,2014-09-30,2014-12-16,162205,0,162205
13427,MMXM3,2014-12-31,2015-03-30,162205,0,162205
13428,MMXM3,2015-03-31,2015-05-15,162205,0,162205
13429,MMXM3,2015-06-30,2015-08-14,162205,0,162205
13430,MMXM3,2015-09-30,2015-11-13,162205,0,162205
13431,MMXM3,2015-12-31,2016-03-31,162205,0,162205
13432,MMXM3,2016-03-31,2016-05-13,162205,0,162205
13433,MMXM3,2016-06-30,2016-08-29,6488,0,6488
13434,MMXM3,2016-09-30,2016-11-17,6488,0,6488
13435,MMXM3,2016-12-31,2017-03-28,6488,0,6488
13436,MMXM3,2017-03-31,2017-05-15,6488,0,6488
13437,MMXM3,2017-06-30,2017-08-14,6488,0,6488
13438,MMXM3,2017-09-30,2017-11-14,6488,0,6488
13439,MMXM3,2017-12-31,2018-03-28,6488,0,6488
13440,MMXM3,2018-03-31,2018-05-15,6488,0,6488
13441,MMXM3,2018-06-30,2018-08-14,6488,0,6488
13442,MMXM3,2018-09-30,2018-11-14,6488,0,6488
13443,MMXM3,2018-12-31,2019-03-27,6488,0,6488
13444,MMXM3,2019-03-31,2019-05-15,6488,0,6488
13445,MMXM3,2019-06-30,2019-08-14,6488,0,6488
13446,MMXM3,2019-09-30,2019-11-14,6488,0,6488
13447,MMXM3,2019-12-31,2020-03-31,6488,0,6488
13448,MMXM3,2020-03-31,2020-06-29,6488,0,6488
13449,MMXM3,2020-06-30,2020-08-28,6488,0,6488
13450,MMXM3,2020-09-30,2020-11-13,6488,0,6488
13451,MRSA3B,2010-12-31,2011-03-25,188333,151667,340000
13452,MRSA3B,2011-03-31,2011-05-12,188333,151667,340000
13453,MRSA3B,2011-06-30,2011-08-11,188333,151667,340000
13454,MRSA3B,2011-09-30,2011-11-10,188333,151667,340000
13455,MRSA3B,2011-12-31,2012-03-22,188333,151667,340000
13456,MRSA3B,2012-03-31,2012-05-10,188333,151667,340000
13457,MRSA3B,2012-06-30,2012-08-10,188333,151667,340000
13458,MRSA3B,2012-09-30,2012-11-09,188333,151667,340000
13459,MRSA3B,2012-12-31,2013-03-22,188333,151667,340000
13460,MRSA3B,2013-03-31,2013-05-15,188333,151667,340000
13461,MRSA3B,2013-06-30,2013-08-12,188333,151667,340000
13462,MRSA3B,2013-09-30,2013-11-11,188333,151667,340000
13463,MRSA3B,2013-12-31,2014-03-25,188333,151667,340000
13464,MRSA3B,2014-03-31,2014-05-12,188333,151667,340000
13465,MRSA3B,2014-06-30,2014-08-14,188333,151667,340000
13466,MRSA3B,2014-09-30,2014-11-07,188333,151667,340000
13467,MRSA3B,2014-12-31,2015-03-18,188333,151667,340000
13468,MRSA3B,2015-03-31,2015-05-06,188333,151667,340000
13469,MRSA3B,2015-06-30,2015-08-14,188333,151667,340000
13470,MRSA3B,2015-09-30,2015-11-11,188333,151667,340000
13471,MRSA3B,2015-12-31,2016-03-28,188333,151667,340000
13472,MRSA3B,2016-03-31,2016-05-11,188333,151667,340000
13473,MRSA3B,2016-06-30,2016-08-12,188333,151667,340000
13474,MRSA3B,2016-09-30,2016-11-11,188333,151667,340000
13475,MRSA3B,2016-12-31,2017-03-16,188333,151667,340000
13476,MRSA3B,2017-03-31,2017-05-12,188333,151667,340000
13477,MRSA3B,2017-06-30,2017-08-02,188333,151667,340000
13478,MRSA3B,2017-09-30,2017-11-08,188333,151667,340000
13479,MRSA3B,2017-12-31,2018-03-26,188333,151667,340000
13480,MRSA3B,2018-03-31,2018-05-09,188333,151667,340000
13481,MRSA3B,2018-06-30,2018-08-08,188333,151667,340000
13482,MRSA3B,2018-09-30,2018-11-07,188333,151667,340000
13483,MRSA3B,2018-12-31,2019-03-20,188333,151667,340000
13484,MRSA3B,2019-03-31,2019-05-14,188333,151667,340000
13485,MRSA3B,2019-06-30,2019-08-14,188333,151667,340000
13486,MRSA3B,2019-09-30,2019-11-11,188333,151667,340000
13487,MRSA3B,2019-12-31,2020-03-25,188333,151667,340000
13488,MRSA3B,2020-03-31,2020-06-26,188333,151667,340000
13489,MRSA3B,2020-06-30,2020-08-18,188333,151667,340000
13490,MRSA3B,2020-09-30,2020-11-11,188333,151667,340000
13491,MRSA3B,2020-12-31,2021-03-24,188333,151667,340000
13492,MRSA5B,2010-12-31,2011-03-25,188333,151667,340000
13493,MRSA5B,2011-03-31,2011-05-12,188333,151667,340000
13494,MRSA5B,2011-06-30,2011-08-11,188333,151667,340000
13495,MRSA5B,2011-09-30,2011-11-10,188333,151667,340000
13496,MRSA5B,2011-12-31,2012-03-22,188333,151667,340000
13497,MRSA5B,2012-03-31,2012-05-10,188333,151667,340000
13498,MRSA5B,2012-06-30,2012-08-10,188333,151667,340000
13499,MRSA5B,2012-09-30,2012-11-09,188333,151667,340000
13500,MRSA5B,2012-12-31,2013-03-22,188333,151667,340000
13501,MRSA5B,2013-03-31,2013-05-15,188333,151667,340000
13502,MRSA5B,2013-06-30,2013-08-12,188333,151667,340000
13503,MRSA5B,2013-09-30,2013-11-11,188333,151667,340000
13504,MRSA5B,2013-12-31,2014-03-25,188333,151667,340000
13505,MRSA5B,2014-03-31,2014-05-12,188333,151667,340000
13506,MRSA5B,2014-06-30,2014-08-14,188333,151667,340000
13507,MRSA5B,2014-09-30,2014-11-07,188333,151667,340000
13508,MRSA5B,2014-12-31,2015-03-18,188333,151667,340000
13509,MRSA5B,2015-03-31,2015-05-06,188333,151667,340000
13510,MRSA5B,2015-06-30,2015-08-14,188333,151667,340000
13511,MRSA5B,2015-09-30,2015-11-11,188333,151667,340000
13512,MRSA5B,2015-12-31,2016-03-28,188333,151667,340000
13513,MRSA5B,2016-03-31,2016-05-11,188333,151667,340000
13514,MRSA5B,2016-06-30,2016-08-12,188333,151667,340000
13515,MRSA5B,2016-09-30,2016-11-11,188333,151667,340000
13516,MRSA5B,2016-12-31,2017-03-16,188333,151667,340000
13517,MRSA5B,2017-03-31,2017-05-12,188333,151667,340000
13518,MRSA5B,2017-06-30,2017-08-02,188333,151667,340000
13519,MRSA5B,2017-09-30,2017-11-08,188333,151667,340000
13520,MRSA5B,2017-12-31,2018-03-26,188333,151667,340000
13521,MRSA5B,2018-03-31,2018-05-09,188333,151667,340000
13522,MRSA5B,2018-06-30,2018-08-08,188333,151667,340000
13523,MRSA5B,2018-09-30,2018-11-07,188333,151667,340000
13524,MRSA5B,2018-12-31,2019-03-20,188333,151667,340000
13525,MRSA5B,2019-03-31,2019-05-14,188333,151667,340000
13526,MRSA5B,2019-06-30,2019-08-14,188333,151667,340000
13527,MRSA5B,2019-09-30,2019-11-11,188333,151667,340000
13528,MRSA5B,2019-12-31,2020-03-25,188333,151667,340000
13529,MRSA5B,2020-03-31,2020-06-26,188333,151667,340000
13530,MRSA5B,2020-06-30,2020-08-18,188333,151667,340000
13531,MRSA5B,2020-09-30,2020-11-11,188333,151667,340000
13532,MRSA5B,2020-12-31,2021-03-24,188333,151667,340000
13533,MRSA6B,2010-12-31,2011-03-25,188333,151667,340000
13534,MRSA6B,2011-03-31,2011-05-12,188333,151667,340000
13535,MRSA6B,2011-06-30,2011-08-11,188333,151667,340000
13536,MRSA6B,2011-09-30,2011-11-10,188333,151667,340000
13537,MRSA6B,2011-12-31,2012-03-22,188333,151667,340000
13538,MRSA6B,2012-03-31,2012-05-10,188333,151667,340000
13539,MRSA6B,2012-06-30,2012-08-10,188333,151667,340000
13540,MRSA6B,2012-09-30,2012-11-09,188333,151667,340000
13541,MRSA6B,2012-12-31,2013-03-22,188333,151667,340000
13542,MRSA6B,2013-03-31,2013-05-15,188333,151667,340000
13543,MRSA6B,2013-06-30,2013-08-12,188333,151667,340000
13544,MRSA6B,2013-09-30,2013-11-11,188333,151667,340000
13545,MRSA6B,2013-12-31,2014-03-25,188333,151667,340000
13546,MRSA6B,2014-03-31,2014-05-12,188333,151667,340000
13547,MRSA6B,2014-06-30,2014-08-14,188333,151667,340000
13548,MRSA6B,2014-09-30,2014-11-07,188333,151667,340000
13549,MRSA6B,2014-12-31,2015-03-18,188333,151667,340000
13550,MRSA6B,2015-03-31,2015-05-06,188333,151667,340000
13551,MRSA6B,2015-06-30,2015-08-14,188333,151667,340000
13552,MRSA6B,2015-09-30,2015-11-11,188333,151667,340000
13553,MRSA6B,2015-12-31,2016-03-28,188333,151667,340000
13554,MRSA6B,2016-03-31,2016-05-11,188333,151667,340000
13555,MRSA6B,2016-06-30,2016-08-12,188333,151667,340000
13556,MRSA6B,2016-09-30,2016-11-11,188333,151667,340000
13557,MRSA6B,2016-12-31,2017-03-16,188333,151667,340000
13558,MRSA6B,2017-03-31,2017-05-12,188333,151667,340000
13559,MRSA6B,2017-06-30,2017-08-02,188333,151667,340000
13560,MRSA6B,2017-09-30,2017-11-08,188333,151667,340000
13561,MRSA6B,2017-12-31,2018-03-26,188333,151667,340000
13562,MRSA6B,2018-03-31,2018-05-09,188333,151667,340000
13563,MRSA6B,2018-06-30,2018-08-08,188333,151667,340000
13564,MRSA6B,2018-09-30,2018-11-07,188333,151667,340000
13565,MRSA6B,2018-12-31,2019-03-20,188333,151667,340000
13566,MRSA6B,2019-03-31,2019-05-14,188333,151667,340000
13567,MRSA6B,2019-06-30,2019-08-14,188333,151667,340000
13568,MRSA6B,2019-09-30,2019-11-11,188333,151667,340000
13569,MRSA6B,2019-12-31,2020-03-25,188333,151667,340000
13570,MRSA6B,2020-03-31,2020-06-26,188333,151667,340000
13571,MRSA6B,2020-06-30,2020-08-18,188333,151667,340000
13572,MRSA6B,2020-09-30,2020-11-11,188333,151667,340000
13573,MRSA6B,2020-12-31,2021-03-24,188333,151667,340000
13574,OPGM3B,2010-12-31,2011-03-28,14176,0,14176
13575,OPGM3B,2011-03-31,2011-05-16,14176,0,14176
13576,OPGM3B,2011-06-30,2011-08-15,14176,0,14176
13577,OPGM3B,2011-09-30,2011-11-14,14176,0,14176
13578,OPGM3B,2011-12-31,2012-04-04,14176,0,14176
13579,OPGM3B,2012-03-31,2012-05-10,14176,0,14176
13580,OPGM3B,2012-06-30,2012-07-30,14176,0,14176
13581,OPGM3B,2012-09-30,2012-11-06,1936,0,1936
13582,OPGM3B,2012-12-31,2013-04-05,1936,0,1936
13583,OPGM3B,2013-03-31,2013-05-10,1936,0,1936
13584,OPGM3B,2013-06-30,2013-08-01,1936,0,1936
13585,OPGM3B,2013-09-30,2013-11-01,1936,0,1936
13586,OPGM3B,2013-12-31,2014-03-19,1936,0,1936
13587,OPGM3B,2014-03-31,2014-05-12,1936,0,1936
13588,OPGM3B,2014-06-30,2014-08-01,1936,0,1936
13589,OPGM3B,2014-09-30,2014-11-04,1936,0,1936
13590,OPGM3B,2014-12-31,2015-03-10,1936,0,1936
13591,OPGM3B,2015-03-31,2015-05-11,1936,0,1936
13592,OPGM3B,2015-06-30,2015-08-06,1936,0,1936
13593,OPGM3B,2015-09-30,2015-11-03,1936,0,1936
13594,OPGM3B,2015-12-31,2016-03-09,1936,0,1936
13595,OPGM3B,2016-03-31,2016-05-12,1936,0,1936
13596,OPGM3B,2016-06-30,2016-08-09,1936,0,1936
13597,OPGM3B,2016-09-30,2016-11-09,1936,0,1936
13598,OPGM3B,2016-12-31,2017-03-17,1936,0,1936
13599,OPGM3B,2017-03-31,2017-05-15,1936,0,1936
13600,OPGM3B,2017-06-30,2017-08-11,1936,0,1936
13601,OPGM3B,2017-09-30,2017-11-13,1936,0,1936
13602,OPGM3B,2017-12-31,2018-03-27,1936,0,1936
13603,OPGM3B,2018-03-31,2018-05-15,1936,0,1936
13604,OPGM3B,2018-06-30,2018-08-15,1936,0,1936
13605,OPGM3B,2018-09-30,2018-11-13,1936,0,1936
13606,OPGM3B,2018-12-31,2019-03-28,1936,0,1936
13607,OPGM3B,2019-03-31,2019-05-15,1936,0,1936
13608,OPGM3B,2019-06-30,2019-08-09,1936,0,1936
13609,OPGM3B,2019-09-30,2019-11-14,1936,0,1936
13610,OPGM3B,2019-12-31,2020-03-16,1935716,0,1935716
13611,OPGM3B,2020-03-31,2020-06-01,1935716,0,1935716
13612,OPGM3B,2020-06-30,2020-08-17,1935716,0,1935716
13613,OPGM3B,2020-09-30,2020-11-13,1935716,0,1935716
13614,OPGM3B,2020-12-31,2021-03-04,1935716,0,1935716
13615,COGN3,2010-12-31,2011-05-30,234114,232126,466240
13616,COGN3,2011-03-31,2011-05-30,234114,232126,466240
13617,COGN3,2011-06-30,2011-08-10,234114,232126,466240
13618,COGN3,2011-09-30,2011-11-09,252543,342704,595247
13619,COGN3,2011-12-31,2012-03-28,253866,350619,604485
13620,COGN3,2012-03-31,2012-05-14,355090,488231,843321
13621,COGN3,2012-06-30,2012-08-09,355090,488231,843321
13622,COGN3,2012-09-30,2012-11-08,364549,575914,940463
13623,COGN3,2012-12-31,2013-03-20,134352,0,134352
13624,COGN3,2013-03-31,2013-05-14,268704,0,268704
13625,COGN3,2013-06-30,2013-08-08,268704,0,268704
13626,COGN3,2013-09-30,2013-12-05,268704,0,268704
13627,COGN3,2013-12-31,2014-03-18,268704,0,268704
13628,COGN3,2014-03-31,2014-05-13,268704,0,268704
13629,COGN3,2014-06-30,2014-08-14,268703876,0,268703876
13630,COGN3,2014-09-30,2014-11-14,1621377,0,1621377
13631,COGN3,2014-12-31,2015-04-16,1623795559,0,1623795559
13632,COGN3,2015-03-31,2015-05-12,1624948,0,1624948
13633,COGN3,2015-06-30,2015-08-12,1623154,0,1623154
13634,COGN3,2015-09-30,2015-11-12,1614039,0,1614039
13635,COGN3,2015-12-31,2016-03-15,1614707,0,1614707
13636,COGN3,2016-03-31,2016-05-12,1616720,0,1616720
13637,COGN3,2016-06-30,2016-08-15,1618406,0,1618406
13638,COGN3,2016-09-30,2016-11-10,1621839,0,1621839
13639,COGN3,2016-12-31,2017-03-22,1626069778,0,1626069778
13640,COGN3,2017-03-31,2017-05-12,1624847,0,1624847
13641,COGN3,2017-06-30,2017-08-11,1626069778,0,1626069778
13642,COGN3,2017-09-30,2017-11-10,1637455614,0,1637455614
13643,COGN3,2017-12-31,2018-03-16,1640526448,0,1640526448
13644,COGN3,2018-03-31,2018-05-14,1640648206,0,1640648206
13645,COGN3,2018-06-30,2018-08-14,1644248206,0,1644248206
13646,COGN3,2018-09-30,2018-11-09,1644248206,0,1644248206
13647,COGN3,2018-12-31,2019-06-21,1644248206,0,1644248206
13648,COGN3,2019-03-31,2019-05-15,1644248206,0,1644248206
13649,COGN3,2019-06-30,2019-08-27,1644248206,0,1644248206
13650,COGN3,2019-09-30,2019-11-13,1644248206,0,1644248206
13651,COGN3,2019-12-31,2020-03-30,1644248206,0,1644248206
13652,COGN3,2020-03-31,2020-05-21,1876606210,0,1876606210
13653,COGN3,2020-06-30,2020-08-20,1876606210,0,1876606210
13654,COGN3,2020-09-30,2020-11-13,1876606210,0,1876606210
13655,KROT3,2010-12-31,2011-05-30,234114,232126,466240
13656,KROT3,2011-03-31,2011-05-30,234114,232126,466240
13657,KROT3,2011-06-30,2011-08-10,234114,232126,466240
13658,KROT3,2011-09-30,2011-11-09,252543,342704,595247
13659,KROT3,2011-12-31,2012-03-28,253866,350619,604485
13660,KROT3,2012-03-31,2012-05-14,355090,488231,843321
13661,KROT3,2012-06-30,2012-08-09,355090,488231,843321
13662,KROT3,2012-09-30,2012-11-08,364549,575914,940463
13663,KROT3,2012-12-31,2013-03-20,134352,0,134352
13664,KROT3,2013-03-31,2013-05-14,268704,0,268704
13665,KROT3,2013-06-30,2013-08-08,268704,0,268704
13666,KROT3,2013-09-30,2013-12-05,268704,0,268704
13667,KROT3,2013-12-31,2014-03-18,268704,0,268704
13668,KROT3,2014-03-31,2014-05-13,268704,0,268704
13669,KROT3,2014-06-30,2014-08-14,268703876,0,268703876
13670,KROT3,2014-09-30,2014-11-14,1621377,0,1621377
13671,KROT3,2014-12-31,2015-04-16,1623795559,0,1623795559
13672,KROT3,2015-03-31,2015-05-12,1624948,0,1624948
13673,KROT3,2015-06-30,2015-08-12,1623154,0,1623154
13674,KROT3,2015-09-30,2015-11-12,1614039,0,1614039
13675,KROT3,2015-12-31,2016-03-15,1614707,0,1614707
13676,KROT3,2016-03-31,2016-05-12,1616720,0,1616720
13677,KROT3,2016-06-30,2016-08-15,1618406,0,1618406
13678,KROT3,2016-09-30,2016-11-10,1621839,0,1621839
13679,KROT3,2016-12-31,2017-03-22,1626069778,0,1626069778
13680,KROT3,2017-03-31,2017-05-12,1624847,0,1624847
13681,KROT3,2017-06-30,2017-08-11,1626069778,0,1626069778
13682,KROT3,2017-09-30,2017-11-10,1637455614,0,1637455614
13683,KROT3,2017-12-31,2018-03-16,1640526448,0,1640526448
13684,KROT3,2018-03-31,2018-05-14,1640648206,0,1640648206
13685,KROT3,2018-06-30,2018-08-14,1644248206,0,1644248206
13686,KROT3,2018-09-30,2018-11-09,1644248206,0,1644248206
13687,KROT3,2018-12-31,2019-06-21,1644248206,0,1644248206
13688,KROT3,2019-03-31,2019-05-15,1644248206,0,1644248206
13689,KROT3,2019-06-30,2019-08-27,1644248206,0,1644248206
13690,KROT3,2019-09-30,2019-11-13,1644248206,0,1644248206
13691,KROT3,2019-12-31,2020-03-30,1644248206,0,1644248206
13692,KROT3,2020-03-31,2020-05-21,1876606210,0,1876606210
13693,KROT3,2020-06-30,2020-08-20,1876606210,0,1876606210
13694,KROT3,2020-09-30,2020-11-13,1876606210,0,1876606210
13695,CSRN3,2010-12-31,2011-02-18,129746,38328,168074
13696,CSRN3,2011-03-31,2011-05-13,129746,38328,168074
13697,CSRN3,2011-06-30,2011-07-29,129746,38328,168074
13698,CSRN3,2011-09-30,2011-10-31,129746,38328,168074
13699,CSRN3,2011-12-31,2012-02-07,129746,38328,168074
13700,CSRN3,2012-03-31,2012-05-04,129746,38328,168074
13701,CSRN3,2012-06-30,2012-07-27,129746,38328,168074
13702,CSRN3,2012-09-30,2012-11-14,129746,38328,168074
13703,CSRN3,2012-12-31,2013-03-25,129746,38328,168074
13704,CSRN3,2013-03-31,2013-05-15,129746,38328,168074
13705,CSRN3,2013-06-30,2013-08-16,129746,38328,168074
13706,CSRN3,2013-09-30,2013-11-08,129746,38328,168074
13707,CSRN3,2013-12-31,2014-03-24,129746,38328,168074
13708,CSRN3,2014-03-31,2014-05-15,129746,38328,168074
13709,CSRN3,2014-06-30,2014-08-14,129746,38328,168074
13710,CSRN3,2014-09-30,2014-11-17,129746,38328,168074
13711,CSRN3,2014-12-31,2017-07-25,129746,38328,168074
13712,CSRN3,2015-03-31,2015-05-14,129746,38328,168074
13713,CSRN3,2015-06-30,2015-08-13,129746,38328,168074
13714,CSRN3,2015-09-30,2015-11-12,129746,38328,168074
13715,CSRN3,2015-12-31,2017-07-25,129746,38328,168074
13716,CSRN3,2016-03-31,2016-05-13,129746,38328,168074
13717,CSRN3,2016-06-30,2016-08-11,129746,38328,168074
13718,CSRN3,2016-09-30,2016-11-11,129746,38328,168074
13719,CSRN3,2016-12-31,2017-07-25,129746,38328,168074
13720,CSRN3,2017-03-31,2017-08-10,129746,38328,168074
13721,CSRN3,2017-06-30,2017-08-10,129746,38328,168074
13722,CSRN3,2017-09-30,2017-11-05,129746,38328,168074
13723,CSRN3,2017-12-31,2018-02-19,129746,38328,168074
13724,CSRN3,2018-03-31,2018-04-23,129746,38328,168074
13725,CSRN3,2018-06-30,2018-07-23,129746,38328,168074
13726,CSRN3,2018-09-30,2018-10-22,129746,38328,168074
13727,CSRN3,2018-12-31,2019-02-14,129746,38328,168074
13728,CSRN3,2019-03-31,2019-04-23,129746,38328,168074
13729,CSRN3,2019-06-30,2019-10-24,129746,38328,168074
13730,CSRN3,2019-09-30,2019-10-24,129746,38328,168074
13731,CSRN3,2019-12-31,2020-02-17,129746,38328,168074
13732,CSRN3,2020-03-31,2020-04-27,129746,38328,168074
13733,CSRN3,2020-06-30,2020-07-23,129746,38328,168074
13734,CSRN3,2020-09-30,2020-10-20,129746,38328,168074
13735,CSRN3,2020-12-31,2021-02-11,129746,38328,168074
13736,CSRN3,2020-12-31,2021-02-09,129746,38328,168074
13737,CSRN5,2010-12-31,2011-02-18,129746,38328,168074
13738,CSRN5,2011-03-31,2011-05-13,129746,38328,168074
13739,CSRN5,2011-06-30,2011-07-29,129746,38328,168074
13740,CSRN5,2011-09-30,2011-10-31,129746,38328,168074
13741,CSRN5,2011-12-31,2012-02-07,129746,38328,168074
13742,CSRN5,2012-03-31,2012-05-04,129746,38328,168074
13743,CSRN5,2012-06-30,2012-07-27,129746,38328,168074
13744,CSRN5,2012-09-30,2012-11-14,129746,38328,168074
13745,CSRN5,2012-12-31,2013-03-25,129746,38328,168074
13746,CSRN5,2013-03-31,2013-05-15,129746,38328,168074
13747,CSRN5,2013-06-30,2013-08-16,129746,38328,168074
13748,CSRN5,2013-09-30,2013-11-08,129746,38328,168074
13749,CSRN5,2013-12-31,2014-03-24,129746,38328,168074
13750,CSRN5,2014-03-31,2014-05-15,129746,38328,168074
13751,CSRN5,2014-06-30,2014-08-14,129746,38328,168074
13752,CSRN5,2014-09-30,2014-11-17,129746,38328,168074
13753,CSRN5,2014-12-31,2017-07-25,129746,38328,168074
13754,CSRN5,2015-03-31,2015-05-14,129746,38328,168074
13755,CSRN5,2015-06-30,2015-08-13,129746,38328,168074
13756,CSRN5,2015-09-30,2015-11-12,129746,38328,168074
13757,CSRN5,2015-12-31,2017-07-25,129746,38328,168074
13758,CSRN5,2016-03-31,2016-05-13,129746,38328,168074
13759,CSRN5,2016-06-30,2016-08-11,129746,38328,168074
13760,CSRN5,2016-09-30,2016-11-11,129746,38328,168074
13761,CSRN5,2016-12-31,2017-07-25,129746,38328,168074
13762,CSRN5,2017-03-31,2017-08-10,129746,38328,168074
13763,CSRN5,2017-06-30,2017-08-10,129746,38328,168074
13764,CSRN5,2017-09-30,2017-11-05,129746,38328,168074
13765,CSRN5,2017-12-31,2018-02-19,129746,38328,168074
13766,CSRN5,2018-03-31,2018-04-23,129746,38328,168074
13767,CSRN5,2018-06-30,2018-07-23,129746,38328,168074
13768,CSRN5,2018-09-30,2018-10-22,129746,38328,168074
13769,CSRN5,2018-12-31,2019-02-14,129746,38328,168074
13770,CSRN5,2019-03-31,2019-04-23,129746,38328,168074
13771,CSRN5,2019-06-30,2019-10-24,129746,38328,168074
13772,CSRN5,2019-09-30,2019-10-24,129746,38328,168074
13773,CSRN5,2019-12-31,2020-02-17,129746,38328,168074
13774,CSRN5,2020-03-31,2020-04-27,129746,38328,168074
13775,CSRN5,2020-06-30,2020-07-23,129746,38328,168074
13776,CSRN5,2020-09-30,2020-10-20,129746,38328,168074
13777,CSRN5,2020-12-31,2021-02-11,129746,38328,168074
13778,CSRN5,2020-12-31,2021-02-09,129746,38328,168074
13779,CSRN6,2010-12-31,2011-02-18,129746,38328,168074
13780,CSRN6,2011-03-31,2011-05-13,129746,38328,168074
13781,CSRN6,2011-06-30,2011-07-29,129746,38328,168074
13782,CSRN6,2011-09-30,2011-10-31,129746,38328,168074
13783,CSRN6,2011-12-31,2012-02-07,129746,38328,168074
13784,CSRN6,2012-03-31,2012-05-04,129746,38328,168074
13785,CSRN6,2012-06-30,2012-07-27,129746,38328,168074
13786,CSRN6,2012-09-30,2012-11-14,129746,38328,168074
13787,CSRN6,2012-12-31,2013-03-25,129746,38328,168074
13788,CSRN6,2013-03-31,2013-05-15,129746,38328,168074
13789,CSRN6,2013-06-30,2013-08-16,129746,38328,168074
13790,CSRN6,2013-09-30,2013-11-08,129746,38328,168074
13791,CSRN6,2013-12-31,2014-03-24,129746,38328,168074
13792,CSRN6,2014-03-31,2014-05-15,129746,38328,168074
13793,CSRN6,2014-06-30,2014-08-14,129746,38328,168074
13794,CSRN6,2014-09-30,2014-11-17,129746,38328,168074
13795,CSRN6,2014-12-31,2017-07-25,129746,38328,168074
13796,CSRN6,2015-03-31,2015-05-14,129746,38328,168074
13797,CSRN6,2015-06-30,2015-08-13,129746,38328,168074
13798,CSRN6,2015-09-30,2015-11-12,129746,38328,168074
13799,CSRN6,2015-12-31,2017-07-25,129746,38328,168074
13800,CSRN6,2016-03-31,2016-05-13,129746,38328,168074
13801,CSRN6,2016-06-30,2016-08-11,129746,38328,168074
13802,CSRN6,2016-09-30,2016-11-11,129746,38328,168074
13803,CSRN6,2016-12-31,2017-07-25,129746,38328,168074
13804,CSRN6,2017-03-31,2017-08-10,129746,38328,168074
13805,CSRN6,2017-06-30,2017-08-10,129746,38328,168074
13806,CSRN6,2017-09-30,2017-11-05,129746,38328,168074
13807,CSRN6,2017-12-31,2018-02-19,129746,38328,168074
13808,CSRN6,2018-03-31,2018-04-23,129746,38328,168074
13809,CSRN6,2018-06-30,2018-07-23,129746,38328,168074
13810,CSRN6,2018-09-30,2018-10-22,129746,38328,168074
13811,CSRN6,2018-12-31,2019-02-14,129746,38328,168074
13812,CSRN6,2019-03-31,2019-04-23,129746,38328,168074
13813,CSRN6,2019-06-30,2019-10-24,129746,38328,168074
13814,CSRN6,2019-09-30,2019-10-24,129746,38328,168074
13815,CSRN6,2019-12-31,2020-02-17,129746,38328,168074
13816,CSRN6,2020-03-31,2020-04-27,129746,38328,168074
13817,CSRN6,2020-06-30,2020-07-23,129746,38328,168074
13818,CSRN6,2020-09-30,2020-10-20,129746,38328,168074
13819,CSRN6,2020-12-31,2021-02-11,129746,38328,168074
13820,CSRN6,2020-12-31,2021-02-09,129746,38328,168074
13821,CELP3,2010-12-31,2011-03-28,59398,4453,63851
13822,CELP3,2011-03-31,2011-05-07,59398,4453,63851
13823,CELP3,2011-06-30,2011-08-15,59398,4453,63851
13824,CELP3,2011-09-30,2011-11-10,59398,4453,63851
13825,CELP3,2011-12-31,2012-03-30,59398,4453,63851
13826,CELP3,2012-03-31,2012-05-15,59398,4453,63851
13827,CELP3,2012-06-30,2012-08-14,59398,4453,63851
13828,CELP3,2012-09-30,2012-11-23,59398,4453,63851
13829,CELP3,2012-12-31,2013-04-04,59397496,4453438,63850934
13830,CELP3,2013-03-31,2013-05-15,59397496,4453438,63850934
13831,CELP3,2013-06-30,2013-08-15,1902996369,4453438,1907449807
13832,CELP3,2013-09-30,2013-10-31,1902996369,4453438,1907449807
13833,CELP3,2013-12-31,2014-03-11,1902996369,4453438,1907449807
13834,CELP3,2014-03-31,2014-05-07,1902996369,4453438,1907449807
13835,CELP3,2014-06-30,2014-08-08,1902996369,4453438,1907449807
13836,CELP3,2014-09-30,2014-10-31,1902996369,4453438,1907449807
13837,CELP3,2014-12-31,2015-02-13,1902996369,4453438,1907449807
13838,CELP3,2015-03-31,2015-05-07,1902996369,4453438,1907449807
13839,CELP3,2015-06-30,2015-08-13,1902996369,4453438,1907449807
13840,CELP3,2015-09-30,2015-11-03,2204620569,4453438,2209074007
13841,CELP3,2015-12-31,2016-03-10,2204620569,4453438,2209074007
13842,CELP3,2016-03-31,2016-05-12,2204620569,4453438,2209074007
13843,CELP3,2016-06-30,2016-08-10,2204620569,4453438,2209074007
13844,CELP3,2016-09-30,2016-12-14,2204620569,4453438,2209074007
13845,CELP3,2016-12-31,2017-03-10,2204620569,4453438,2209074007
13846,CELP3,2017-03-31,2017-05-09,2204620569,4453438,2209074007
13847,CELP3,2017-06-30,2017-08-08,2204620569,4453438,2209074007
13848,CELP3,2017-09-30,2017-11-09,2204620569,4453438,2209074007
13849,CELP3,2017-12-31,2018-03-09,2204620569,4453438,2209074007
13850,CELP3,2018-03-31,2018-05-10,2204620569,4453438,2209074007
13851,CELP3,2018-06-30,2018-08-09,2204620569,4453438,2209074007
13852,CELP3,2018-09-30,2018-11-08,2204620569,4453438,2209074007
13853,CELP3,2018-12-31,2019-04-12,2204620569,4453438,2209074007
13854,CELP3,2019-03-31,2019-05-22,2204620569,4453438,2209074007
13855,CELP3,2019-06-30,2019-08-15,2204620569,4453438,2209074007
13856,CELP3,2019-09-30,2019-11-14,2204620569,4453438,2209074007
13857,CELP3,2019-12-31,2020-04-27,2204620569,4453438,2209074007
13858,CELP3,2020-03-31,2020-06-29,2204620569,4453438,2209074007
13859,CELP3,2020-06-30,2020-08-20,2204620569,4453438,2209074007
13860,CELP3,2020-09-30,2020-11-13,2204620569,4453438,2209074007
13861,CELP3,2020-12-31,2021-03-25,2204620569,4453438,2209074007
13862,CELP5,2010-12-31,2011-03-28,59398,4453,63851
13863,CELP5,2011-03-31,2011-05-07,59398,4453,63851
13864,CELP5,2011-06-30,2011-08-15,59398,4453,63851
13865,CELP5,2011-09-30,2011-11-10,59398,4453,63851
13866,CELP5,2011-12-31,2012-03-30,59398,4453,63851
13867,CELP5,2012-03-31,2012-05-15,59398,4453,63851
13868,CELP5,2012-06-30,2012-08-14,59398,4453,63851
13869,CELP5,2012-09-30,2012-11-23,59398,4453,63851
13870,CELP5,2012-12-31,2013-04-04,59397496,4453438,63850934
13871,CELP5,2013-03-31,2013-05-15,59397496,4453438,63850934
13872,CELP5,2013-06-30,2013-08-15,1902996369,4453438,1907449807
13873,CELP5,2013-09-30,2013-10-31,1902996369,4453438,1907449807
13874,CELP5,2013-12-31,2014-03-11,1902996369,4453438,1907449807
13875,CELP5,2014-03-31,2014-05-07,1902996369,4453438,1907449807
13876,CELP5,2014-06-30,2014-08-08,1902996369,4453438,1907449807
13877,CELP5,2014-09-30,2014-10-31,1902996369,4453438,1907449807
13878,CELP5,2014-12-31,2015-02-13,1902996369,4453438,1907449807
13879,CELP5,2015-03-31,2015-05-07,1902996369,4453438,1907449807
13880,CELP5,2015-06-30,2015-08-13,1902996369,4453438,1907449807
13881,CELP5,2015-09-30,2015-11-03,2204620569,4453438,2209074007
13882,CELP5,2015-12-31,2016-03-10,2204620569,4453438,2209074007
13883,CELP5,2016-03-31,2016-05-12,2204620569,4453438,2209074007
13884,CELP5,2016-06-30,2016-08-10,2204620569,4453438,2209074007
13885,CELP5,2016-09-30,2016-12-14,2204620569,4453438,2209074007
13886,CELP5,2016-12-31,2017-03-10,2204620569,4453438,2209074007
13887,CELP5,2017-03-31,2017-05-09,2204620569,4453438,2209074007
13888,CELP5,2017-06-30,2017-08-08,2204620569,4453438,2209074007
13889,CELP5,2017-09-30,2017-11-09,2204620569,4453438,2209074007
13890,CELP5,2017-12-31,2018-03-09,2204620569,4453438,2209074007
13891,CELP5,2018-03-31,2018-05-10,2204620569,4453438,2209074007
13892,CELP5,2018-06-30,2018-08-09,2204620569,4453438,2209074007
13893,CELP5,2018-09-30,2018-11-08,2204620569,4453438,2209074007
13894,CELP5,2018-12-31,2019-04-12,2204620569,4453438,2209074007
13895,CELP5,2019-03-31,2019-05-22,2204620569,4453438,2209074007
13896,CELP5,2019-06-30,2019-08-15,2204620569,4453438,2209074007
13897,CELP5,2019-09-30,2019-11-14,2204620569,4453438,2209074007
13898,CELP5,2019-12-31,2020-04-27,2204620569,4453438,2209074007
13899,CELP5,2020-03-31,2020-06-29,2204620569,4453438,2209074007
13900,CELP5,2020-06-30,2020-08-20,2204620569,4453438,2209074007
13901,CELP5,2020-09-30,2020-11-13,2204620569,4453438,2209074007
13902,CELP5,2020-12-31,2021-03-25,2204620569,4453438,2209074007
13903,CELP6,2010-12-31,2011-03-28,59398,4453,63851
13904,CELP6,2011-03-31,2011-05-07,59398,4453,63851
13905,CELP6,2011-06-30,2011-08-15,59398,4453,63851
13906,CELP6,2011-09-30,2011-11-10,59398,4453,63851
13907,CELP6,2011-12-31,2012-03-30,59398,4453,63851
13908,CELP6,2012-03-31,2012-05-15,59398,4453,63851
13909,CELP6,2012-06-30,2012-08-14,59398,4453,63851
13910,CELP6,2012-09-30,2012-11-23,59398,4453,63851
13911,CELP6,2012-12-31,2013-04-04,59397496,4453438,63850934
13912,CELP6,2013-03-31,2013-05-15,59397496,4453438,63850934
13913,CELP6,2013-06-30,2013-08-15,1902996369,4453438,1907449807
13914,CELP6,2013-09-30,2013-10-31,1902996369,4453438,1907449807
13915,CELP6,2013-12-31,2014-03-11,1902996369,4453438,1907449807
13916,CELP6,2014-03-31,2014-05-07,1902996369,4453438,1907449807
13917,CELP6,2014-06-30,2014-08-08,1902996369,4453438,1907449807
13918,CELP6,2014-09-30,2014-10-31,1902996369,4453438,1907449807
13919,CELP6,2014-12-31,2015-02-13,1902996369,4453438,1907449807
13920,CELP6,2015-03-31,2015-05-07,1902996369,4453438,1907449807
13921,CELP6,2015-06-30,2015-08-13,1902996369,4453438,1907449807
13922,CELP6,2015-09-30,2015-11-03,2204620569,4453438,2209074007
13923,CELP6,2015-12-31,2016-03-10,2204620569,4453438,2209074007
13924,CELP6,2016-03-31,2016-05-12,2204620569,4453438,2209074007
13925,CELP6,2016-06-30,2016-08-10,2204620569,4453438,2209074007
13926,CELP6,2016-09-30,2016-12-14,2204620569,4453438,2209074007
13927,CELP6,2016-12-31,2017-03-10,2204620569,4453438,2209074007
13928,CELP6,2017-03-31,2017-05-09,2204620569,4453438,2209074007
13929,CELP6,2017-06-30,2017-08-08,2204620569,4453438,2209074007
13930,CELP6,2017-09-30,2017-11-09,2204620569,4453438,2209074007
13931,CELP6,2017-12-31,2018-03-09,2204620569,4453438,2209074007
13932,CELP6,2018-03-31,2018-05-10,2204620569,4453438,2209074007
13933,CELP6,2018-06-30,2018-08-09,2204620569,4453438,2209074007
13934,CELP6,2018-09-30,2018-11-08,2204620569,4453438,2209074007
13935,CELP6,2018-12-31,2019-04-12,2204620569,4453438,2209074007
13936,CELP6,2019-03-31,2019-05-22,2204620569,4453438,2209074007
13937,CELP6,2019-06-30,2019-08-15,2204620569,4453438,2209074007
13938,CELP6,2019-09-30,2019-11-14,2204620569,4453438,2209074007
13939,CELP6,2019-12-31,2020-04-27,2204620569,4453438,2209074007
13940,CELP6,2020-03-31,2020-06-29,2204620569,4453438,2209074007
13941,CELP6,2020-06-30,2020-08-20,2204620569,4453438,2209074007
13942,CELP6,2020-09-30,2020-11-13,2204620569,4453438,2209074007
13943,CELP6,2020-12-31,2021-03-25,2204620569,4453438,2209074007
13944,CELP7,2010-12-31,2011-03-28,59398,4453,63851
13945,CELP7,2011-03-31,2011-05-07,59398,4453,63851
13946,CELP7,2011-06-30,2011-08-15,59398,4453,63851
13947,CELP7,2011-09-30,2011-11-10,59398,4453,63851
13948,CELP7,2011-12-31,2012-03-30,59398,4453,63851
13949,CELP7,2012-03-31,2012-05-15,59398,4453,63851
13950,CELP7,2012-06-30,2012-08-14,59398,4453,63851
13951,CELP7,2012-09-30,2012-11-23,59398,4453,63851
13952,CELP7,2012-12-31,2013-04-04,59397496,4453438,63850934
13953,CELP7,2013-03-31,2013-05-15,59397496,4453438,63850934
13954,CELP7,2013-06-30,2013-08-15,1902996369,4453438,1907449807
13955,CELP7,2013-09-30,2013-10-31,1902996369,4453438,1907449807
13956,CELP7,2013-12-31,2014-03-11,1902996369,4453438,1907449807
13957,CELP7,2014-03-31,2014-05-07,1902996369,4453438,1907449807
13958,CELP7,2014-06-30,2014-08-08,1902996369,4453438,1907449807
13959,CELP7,2014-09-30,2014-10-31,1902996369,4453438,1907449807
13960,CELP7,2014-12-31,2015-02-13,1902996369,4453438,1907449807
13961,CELP7,2015-03-31,2015-05-07,1902996369,4453438,1907449807
13962,CELP7,2015-06-30,2015-08-13,1902996369,4453438,1907449807
13963,CELP7,2015-09-30,2015-11-03,2204620569,4453438,2209074007
13964,CELP7,2015-12-31,2016-03-10,2204620569,4453438,2209074007
13965,CELP7,2016-03-31,2016-05-12,2204620569,4453438,2209074007
13966,CELP7,2016-06-30,2016-08-10,2204620569,4453438,2209074007
13967,CELP7,2016-09-30,2016-12-14,2204620569,4453438,2209074007
13968,CELP7,2016-12-31,2017-03-10,2204620569,4453438,2209074007
13969,CELP7,2017-03-31,2017-05-09,2204620569,4453438,2209074007
13970,CELP7,2017-06-30,2017-08-08,2204620569,4453438,2209074007
13971,CELP7,2017-09-30,2017-11-09,2204620569,4453438,2209074007
13972,CELP7,2017-12-31,2018-03-09,2204620569,4453438,2209074007
13973,CELP7,2018-03-31,2018-05-10,2204620569,4453438,2209074007
13974,CELP7,2018-06-30,2018-08-09,2204620569,4453438,2209074007
13975,CELP7,2018-09-30,2018-11-08,2204620569,4453438,2209074007
13976,CELP7,2018-12-31,2019-04-12,2204620569,4453438,2209074007
13977,CELP7,2019-03-31,2019-05-22,2204620569,4453438,2209074007
13978,CELP7,2019-06-30,2019-08-15,2204620569,4453438,2209074007
13979,CELP7,2019-09-30,2019-11-14,2204620569,4453438,2209074007
13980,CELP7,2019-12-31,2020-04-27,2204620569,4453438,2209074007
13981,CELP7,2020-03-31,2020-06-29,2204620569,4453438,2209074007
13982,CELP7,2020-06-30,2020-08-20,2204620569,4453438,2209074007
13983,CELP7,2020-09-30,2020-11-13,2204620569,4453438,2209074007
13984,CELP7,2020-12-31,2021-03-25,2204620569,4453438,2209074007
13985,EQPA3,2010-12-31,2011-03-28,59398,4453,63851
13986,EQPA3,2011-03-31,2011-05-07,59398,4453,63851
13987,EQPA3,2011-06-30,2011-08-15,59398,4453,63851
13988,EQPA3,2011-09-30,2011-11-10,59398,4453,63851
13989,EQPA3,2011-12-31,2012-03-30,59398,4453,63851
13990,EQPA3,2012-03-31,2012-05-15,59398,4453,63851
13991,EQPA3,2012-06-30,2012-08-14,59398,4453,63851
13992,EQPA3,2012-09-30,2012-11-23,59398,4453,63851
13993,EQPA3,2012-12-31,2013-04-04,59397496,4453438,63850934
13994,EQPA3,2013-03-31,2013-05-15,59397496,4453438,63850934
13995,EQPA3,2013-06-30,2013-08-15,1902996369,4453438,1907449807
13996,EQPA3,2013-09-30,2013-10-31,1902996369,4453438,1907449807
13997,EQPA3,2013-12-31,2014-03-11,1902996369,4453438,1907449807
13998,EQPA3,2014-03-31,2014-05-07,1902996369,4453438,1907449807
13999,EQPA3,2014-06-30,2014-08-08,1902996369,4453438,1907449807
14000,EQPA3,2014-09-30,2014-10-31,1902996369,4453438,1907449807
14001,EQPA3,2014-12-31,2015-02-13,1902996369,4453438,1907449807
14002,EQPA3,2015-03-31,2015-05-07,1902996369,4453438,1907449807
14003,EQPA3,2015-06-30,2015-08-13,1902996369,4453438,1907449807
14004,EQPA3,2015-09-30,2015-11-03,2204620569,4453438,2209074007
14005,EQPA3,2015-12-31,2016-03-10,2204620569,4453438,2209074007
14006,EQPA3,2016-03-31,2016-05-12,2204620569,4453438,2209074007
14007,EQPA3,2016-06-30,2016-08-10,2204620569,4453438,2209074007
14008,EQPA3,2016-09-30,2016-12-14,2204620569,4453438,2209074007
14009,EQPA3,2016-12-31,2017-03-10,2204620569,4453438,2209074007
14010,EQPA3,2017-03-31,2017-05-09,2204620569,4453438,2209074007
14011,EQPA3,2017-06-30,2017-08-08,2204620569,4453438,2209074007
14012,EQPA3,2017-09-30,2017-11-09,2204620569,4453438,2209074007
14013,EQPA3,2017-12-31,2018-03-09,2204620569,4453438,2209074007
14014,EQPA3,2018-03-31,2018-05-10,2204620569,4453438,2209074007
14015,EQPA3,2018-06-30,2018-08-09,2204620569,4453438,2209074007
14016,EQPA3,2018-09-30,2018-11-08,2204620569,4453438,2209074007
14017,EQPA3,2018-12-31,2019-04-12,2204620569,4453438,2209074007
14018,EQPA3,2019-03-31,2019-05-22,2204620569,4453438,2209074007
14019,EQPA3,2019-06-30,2019-08-15,2204620569,4453438,2209074007
14020,EQPA3,2019-09-30,2019-11-14,2204620569,4453438,2209074007
14021,EQPA3,2019-12-31,2020-04-27,2204620569,4453438,2209074007
14022,EQPA3,2020-03-31,2020-06-29,2204620569,4453438,2209074007
14023,EQPA3,2020-06-30,2020-08-20,2204620569,4453438,2209074007
14024,EQPA3,2020-09-30,2020-11-13,2204620569,4453438,2209074007
14025,EQPA3,2020-12-31,2021-03-25,2204620569,4453438,2209074007
14026,EQPA5,2010-12-31,2011-03-28,59398,4453,63851
14027,EQPA5,2011-03-31,2011-05-07,59398,4453,63851
14028,EQPA5,2011-06-30,2011-08-15,59398,4453,63851
14029,EQPA5,2011-09-30,2011-11-10,59398,4453,63851
14030,EQPA5,2011-12-31,2012-03-30,59398,4453,63851
14031,EQPA5,2012-03-31,2012-05-15,59398,4453,63851
14032,EQPA5,2012-06-30,2012-08-14,59398,4453,63851
14033,EQPA5,2012-09-30,2012-11-23,59398,4453,63851
14034,EQPA5,2012-12-31,2013-04-04,59397496,4453438,63850934
14035,EQPA5,2013-03-31,2013-05-15,59397496,4453438,63850934
14036,EQPA5,2013-06-30,2013-08-15,1902996369,4453438,1907449807
14037,EQPA5,2013-09-30,2013-10-31,1902996369,4453438,1907449807
14038,EQPA5,2013-12-31,2014-03-11,1902996369,4453438,1907449807
14039,EQPA5,2014-03-31,2014-05-07,1902996369,4453438,1907449807
14040,EQPA5,2014-06-30,2014-08-08,1902996369,4453438,1907449807
14041,EQPA5,2014-09-30,2014-10-31,1902996369,4453438,1907449807
14042,EQPA5,2014-12-31,2015-02-13,1902996369,4453438,1907449807
14043,EQPA5,2015-03-31,2015-05-07,1902996369,4453438,1907449807
14044,EQPA5,2015-06-30,2015-08-13,1902996369,4453438,1907449807
14045,EQPA5,2015-09-30,2015-11-03,2204620569,4453438,2209074007
14046,EQPA5,2015-12-31,2016-03-10,2204620569,4453438,2209074007
14047,EQPA5,2016-03-31,2016-05-12,2204620569,4453438,2209074007
14048,EQPA5,2016-06-30,2016-08-10,2204620569,4453438,2209074007
14049,EQPA5,2016-09-30,2016-12-14,2204620569,4453438,2209074007
14050,EQPA5,2016-12-31,2017-03-10,2204620569,4453438,2209074007
14051,EQPA5,2017-03-31,2017-05-09,2204620569,4453438,2209074007
14052,EQPA5,2017-06-30,2017-08-08,2204620569,4453438,2209074007
14053,EQPA5,2017-09-30,2017-11-09,2204620569,4453438,2209074007
14054,EQPA5,2017-12-31,2018-03-09,2204620569,4453438,2209074007
14055,EQPA5,2018-03-31,2018-05-10,2204620569,4453438,2209074007
14056,EQPA5,2018-06-30,2018-08-09,2204620569,4453438,2209074007
14057,EQPA5,2018-09-30,2018-11-08,2204620569,4453438,2209074007
14058,EQPA5,2018-12-31,2019-04-12,2204620569,4453438,2209074007
14059,EQPA5,2019-03-31,2019-05-22,2204620569,4453438,2209074007
14060,EQPA5,2019-06-30,2019-08-15,2204620569,4453438,2209074007
14061,EQPA5,2019-09-30,2019-11-14,2204620569,4453438,2209074007
14062,EQPA5,2019-12-31,2020-04-27,2204620569,4453438,2209074007
14063,EQPA5,2020-03-31,2020-06-29,2204620569,4453438,2209074007
14064,EQPA5,2020-06-30,2020-08-20,2204620569,4453438,2209074007
14065,EQPA5,2020-09-30,2020-11-13,2204620569,4453438,2209074007
14066,EQPA5,2020-12-31,2021-03-25,2204620569,4453438,2209074007
14067,EQPA6,2010-12-31,2011-03-28,59398,4453,63851
14068,EQPA6,2011-03-31,2011-05-07,59398,4453,63851
14069,EQPA6,2011-06-30,2011-08-15,59398,4453,63851
14070,EQPA6,2011-09-30,2011-11-10,59398,4453,63851
14071,EQPA6,2011-12-31,2012-03-30,59398,4453,63851
14072,EQPA6,2012-03-31,2012-05-15,59398,4453,63851
14073,EQPA6,2012-06-30,2012-08-14,59398,4453,63851
14074,EQPA6,2012-09-30,2012-11-23,59398,4453,63851
14075,EQPA6,2012-12-31,2013-04-04,59397496,4453438,63850934
14076,EQPA6,2013-03-31,2013-05-15,59397496,4453438,63850934
14077,EQPA6,2013-06-30,2013-08-15,1902996369,4453438,1907449807
14078,EQPA6,2013-09-30,2013-10-31,1902996369,4453438,1907449807
14079,EQPA6,2013-12-31,2014-03-11,1902996369,4453438,1907449807
14080,EQPA6,2014-03-31,2014-05-07,1902996369,4453438,1907449807
14081,EQPA6,2014-06-30,2014-08-08,1902996369,4453438,1907449807
14082,EQPA6,2014-09-30,2014-10-31,1902996369,4453438,1907449807
14083,EQPA6,2014-12-31,2015-02-13,1902996369,4453438,1907449807
14084,EQPA6,2015-03-31,2015-05-07,1902996369,4453438,1907449807
14085,EQPA6,2015-06-30,2015-08-13,1902996369,4453438,1907449807
14086,EQPA6,2015-09-30,2015-11-03,2204620569,4453438,2209074007
14087,EQPA6,2015-12-31,2016-03-10,2204620569,4453438,2209074007
14088,EQPA6,2016-03-31,2016-05-12,2204620569,4453438,2209074007
14089,EQPA6,2016-06-30,2016-08-10,2204620569,4453438,2209074007
14090,EQPA6,2016-09-30,2016-12-14,2204620569,4453438,2209074007
14091,EQPA6,2016-12-31,2017-03-10,2204620569,4453438,2209074007
14092,EQPA6,2017-03-31,2017-05-09,2204620569,4453438,2209074007
14093,EQPA6,2017-06-30,2017-08-08,2204620569,4453438,2209074007
14094,EQPA6,2017-09-30,2017-11-09,2204620569,4453438,2209074007
14095,EQPA6,2017-12-31,2018-03-09,2204620569,4453438,2209074007
14096,EQPA6,2018-03-31,2018-05-10,2204620569,4453438,2209074007
14097,EQPA6,2018-06-30,2018-08-09,2204620569,4453438,2209074007
14098,EQPA6,2018-09-30,2018-11-08,2204620569,4453438,2209074007
14099,EQPA6,2018-12-31,2019-04-12,2204620569,4453438,2209074007
14100,EQPA6,2019-03-31,2019-05-22,2204620569,4453438,2209074007
14101,EQPA6,2019-06-30,2019-08-15,2204620569,4453438,2209074007
14102,EQPA6,2019-09-30,2019-11-14,2204620569,4453438,2209074007
14103,EQPA6,2019-12-31,2020-04-27,2204620569,4453438,2209074007
14104,EQPA6,2020-03-31,2020-06-29,2204620569,4453438,2209074007
14105,EQPA6,2020-06-30,2020-08-20,2204620569,4453438,2209074007
14106,EQPA6,2020-09-30,2020-11-13,2204620569,4453438,2209074007
14107,EQPA6,2020-12-31,2021-03-25,2204620569,4453438,2209074007
14108,EQPA7,2010-12-31,2011-03-28,59398,4453,63851
14109,EQPA7,2011-03-31,2011-05-07,59398,4453,63851
14110,EQPA7,2011-06-30,2011-08-15,59398,4453,63851
14111,EQPA7,2011-09-30,2011-11-10,59398,4453,63851
14112,EQPA7,2011-12-31,2012-03-30,59398,4453,63851
14113,EQPA7,2012-03-31,2012-05-15,59398,4453,63851
14114,EQPA7,2012-06-30,2012-08-14,59398,4453,63851
14115,EQPA7,2012-09-30,2012-11-23,59398,4453,63851
14116,EQPA7,2012-12-31,2013-04-04,59397496,4453438,63850934
14117,EQPA7,2013-03-31,2013-05-15,59397496,4453438,63850934
14118,EQPA7,2013-06-30,2013-08-15,1902996369,4453438,1907449807
14119,EQPA7,2013-09-30,2013-10-31,1902996369,4453438,1907449807
14120,EQPA7,2013-12-31,2014-03-11,1902996369,4453438,1907449807
14121,EQPA7,2014-03-31,2014-05-07,1902996369,4453438,1907449807
14122,EQPA7,2014-06-30,2014-08-08,1902996369,4453438,1907449807
14123,EQPA7,2014-09-30,2014-10-31,1902996369,4453438,1907449807
14124,EQPA7,2014-12-31,2015-02-13,1902996369,4453438,1907449807
14125,EQPA7,2015-03-31,2015-05-07,1902996369,4453438,1907449807
14126,EQPA7,2015-06-30,2015-08-13,1902996369,4453438,1907449807
14127,EQPA7,2015-09-30,2015-11-03,2204620569,4453438,2209074007
14128,EQPA7,2015-12-31,2016-03-10,2204620569,4453438,2209074007
14129,EQPA7,2016-03-31,2016-05-12,2204620569,4453438,2209074007
14130,EQPA7,2016-06-30,2016-08-10,2204620569,4453438,2209074007
14131,EQPA7,2016-09-30,2016-12-14,2204620569,4453438,2209074007
14132,EQPA7,2016-12-31,2017-03-10,2204620569,4453438,2209074007
14133,EQPA7,2017-03-31,2017-05-09,2204620569,4453438,2209074007
14134,EQPA7,2017-06-30,2017-08-08,2204620569,4453438,2209074007
14135,EQPA7,2017-09-30,2017-11-09,2204620569,4453438,2209074007
14136,EQPA7,2017-12-31,2018-03-09,2204620569,4453438,2209074007
14137,EQPA7,2018-03-31,2018-05-10,2204620569,4453438,2209074007
14138,EQPA7,2018-06-30,2018-08-09,2204620569,4453438,2209074007
14139,EQPA7,2018-09-30,2018-11-08,2204620569,4453438,2209074007
14140,EQPA7,2018-12-31,2019-04-12,2204620569,4453438,2209074007
14141,EQPA7,2019-03-31,2019-05-22,2204620569,4453438,2209074007
14142,EQPA7,2019-06-30,2019-08-15,2204620569,4453438,2209074007
14143,EQPA7,2019-09-30,2019-11-14,2204620569,4453438,2209074007
14144,EQPA7,2019-12-31,2020-04-27,2204620569,4453438,2209074007
14145,EQPA7,2020-03-31,2020-06-29,2204620569,4453438,2209074007
14146,EQPA7,2020-06-30,2020-08-20,2204620569,4453438,2209074007
14147,EQPA7,2020-09-30,2020-11-13,2204620569,4453438,2209074007
14148,EQPA7,2020-12-31,2021-03-25,2204620569,4453438,2209074007
14149,PRPT3B,2010-12-31,2011-03-29,11300000,0,11300000
14150,PRPT3B,2011-03-31,2011-05-16,11375000,0,11375000
14151,PRPT3B,2011-06-30,2011-08-15,11375000,0,11375000
14152,PRPT3B,2011-09-30,2011-11-14,11375000,0,11375000
14153,PRPT3B,2011-12-31,2012-03-27,11375000,0,11375000
14154,PRPT3B,2012-03-31,2012-05-10,11494403,0,11494403
14155,PRPT3B,2012-06-30,2012-07-31,11494403,0,11494403
14156,PRPT3B,2012-09-30,2012-10-23,11494403,0,11494403
14157,PRPT3B,2012-12-31,2013-03-21,19494403,0,19494403
14158,PRPT3B,2013-03-31,2013-05-10,19494403,0,19494403
14159,PRPT3B,2013-06-30,2013-08-01,19494403,0,19494403
14160,PRPT3B,2013-09-30,2013-11-01,19494403,0,19494403
14161,PRPT3B,2013-12-31,2014-02-24,19494403,0,19494403
14162,PRPT3B,2014-03-31,2014-05-07,29494403,0,29494403
14163,PRPT3B,2014-06-30,2014-08-01,29494403,0,29494403
14164,PRPT3B,2014-09-30,2014-11-05,29494403,0,29494403
14165,PRPT3B,2014-12-31,2015-02-26,29494403,0,29494403
14166,PRPT3B,2015-03-31,2015-05-13,38994403,0,38994403
14167,PRPT3B,2015-06-30,2015-08-05,40615795,0,40615795
14168,PRPT3B,2015-09-30,2015-11-09,40615795,0,40615795
14169,PRPT3B,2015-12-31,2016-03-09,40615795,0,40615795
14170,PRPT3B,2016-03-31,2016-05-12,40615795,0,40615795
14171,PRPT3B,2016-06-30,2016-07-20,51815796,0,51815796
14172,PRPT3B,2016-09-30,2016-11-08,51815796,0,51815796
14173,PRPT3B,2016-12-31,2017-03-15,51815796,0,51815796
14174,PRPT3B,2017-03-31,2017-05-15,51815796,0,51815796
14175,PRPT3B,2017-06-30,2017-08-11,61815796,0,61815796
14176,PRPT3B,2017-09-30,2017-11-13,61815796,0,61815796
14177,PRPT3B,2017-12-31,2018-03-27,61815796,0,61815796
14178,PRPT3B,2018-03-31,2018-05-15,72815796,0,72815796
14179,PRPT3B,2018-06-30,2018-08-14,72815796,0,72815796
14180,PRPT3B,2018-09-30,2018-11-14,72815796,0,72815796
14181,PRPT3B,2018-12-31,2019-03-21,72815796,0,72815796
14182,PRPT3B,2019-03-31,2019-05-15,86815796,0,86815796
14183,PRPT3B,2019-06-30,2019-08-12,86815796,0,86815796
14184,PRPT3B,2019-09-30,2019-11-14,86815796,0,86815796
14185,PRPT3B,2019-12-31,2020-03-20,106815796,0,106815796
14186,PRPT3B,2020-03-31,2020-06-01,106815796,0,106815796
14187,PRPT3B,2020-06-30,2020-08-18,106815796,0,106815796
14188,PRPT3B,2020-09-30,2020-11-16,106815796,0,106815796
14189,PRPT3B,2020-12-31,2021-03-10,106815796,0,106815796
14190,GEPA3,2010-12-31,2011-03-28,31478,62955,94433
14191,GEPA3,2011-03-31,2011-05-13,31478,62955,94433
14192,GEPA3,2011-06-30,2011-08-11,31478,62955,94433
14193,GEPA3,2011-09-30,2011-11-09,31478,62955,94433
14194,GEPA3,2011-12-31,2012-03-26,31478,62955,94433
14195,GEPA3,2012-03-31,2012-05-14,31478,62955,94433
14196,GEPA3,2012-06-30,2012-08-14,31478,62955,94433
14197,GEPA3,2012-09-30,2012-11-13,31478,62955,94433
14198,GEPA3,2012-12-31,2013-03-25,31478,62955,94433
14199,GEPA3,2013-03-31,2013-05-09,31478,62955,94433
14200,GEPA3,2013-06-30,2013-08-13,31478,62955,94433
14201,GEPA3,2013-09-30,2013-11-13,31478,62955,94433
14202,GEPA3,2013-12-31,2014-03-25,31478,62955,94433
14203,GEPA3,2014-03-31,2014-05-07,31478,62955,94433
14204,GEPA3,2014-06-30,2014-08-12,31478,62955,94433
14205,GEPA3,2014-09-30,2014-11-12,31478,62955,94433
14206,GEPA3,2014-12-31,2015-03-19,31478,62955,94433
14207,GEPA3,2015-03-31,2015-05-13,31478,62955,94433
14208,GEPA3,2015-06-30,2015-08-13,31478,62955,94433
14209,GEPA3,2015-09-30,2015-11-11,31478,62955,94433
14210,GEPA3,2015-12-31,2016-03-28,31478,62955,94433
14211,GEPA3,2016-03-31,2016-05-12,31478,62955,94433
14212,GEPA3,2016-06-30,2016-08-11,31478,62955,94433
14213,GEPA3,2016-09-30,2016-11-10,31478,62955,94433
14214,GEPA3,2016-12-31,2017-03-27,31478,62955,94433
14215,GEPA3,2017-03-31,2017-05-11,31478,62955,94433
14216,GEPA3,2017-06-30,2017-08-10,31478,62955,94433
14217,GEPA3,2017-09-30,2017-11-09,31478,62955,94433
14218,GEPA3,2017-12-31,2018-03-15,31478,62955,94433
14219,GEPA3,2018-03-31,2018-05-15,31478,62955,94433
14220,GEPA3,2018-06-30,2018-08-14,31478,62955,94433
14221,GEPA3,2018-09-30,2018-11-12,31478,62955,94433
14222,GEPA3,2018-12-31,2019-03-12,31478,62955,94433
14223,GEPA3,2019-03-31,2019-05-13,31478,62955,94433
14224,GEPA3,2019-06-30,2019-08-14,31478,62955,94433
14225,GEPA3,2019-09-30,2019-11-13,31478,62955,94433
14226,GEPA3,2019-12-31,2020-03-26,31478,62955,94433
14227,GEPA3,2020-03-31,2020-05-13,31478,62955,94433
14228,GEPA3,2020-06-30,2020-08-13,31478,62955,94433
14229,GEPA3,2020-09-30,2020-11-12,31478,62955,94433
14230,GEPA4,2010-12-31,2011-03-28,31478,62955,94433
14231,GEPA4,2011-03-31,2011-05-13,31478,62955,94433
14232,GEPA4,2011-06-30,2011-08-11,31478,62955,94433
14233,GEPA4,2011-09-30,2011-11-09,31478,62955,94433
14234,GEPA4,2011-12-31,2012-03-26,31478,62955,94433
14235,GEPA4,2012-03-31,2012-05-14,31478,62955,94433
14236,GEPA4,2012-06-30,2012-08-14,31478,62955,94433
14237,GEPA4,2012-09-30,2012-11-13,31478,62955,94433
14238,GEPA4,2012-12-31,2013-03-25,31478,62955,94433
14239,GEPA4,2013-03-31,2013-05-09,31478,62955,94433
14240,GEPA4,2013-06-30,2013-08-13,31478,62955,94433
14241,GEPA4,2013-09-30,2013-11-13,31478,62955,94433
14242,GEPA4,2013-12-31,2014-03-25,31478,62955,94433
14243,GEPA4,2014-03-31,2014-05-07,31478,62955,94433
14244,GEPA4,2014-06-30,2014-08-12,31478,62955,94433
14245,GEPA4,2014-09-30,2014-11-12,31478,62955,94433
14246,GEPA4,2014-12-31,2015-03-19,31478,62955,94433
14247,GEPA4,2015-03-31,2015-05-13,31478,62955,94433
14248,GEPA4,2015-06-30,2015-08-13,31478,62955,94433
14249,GEPA4,2015-09-30,2015-11-11,31478,62955,94433
14250,GEPA4,2015-12-31,2016-03-28,31478,62955,94433
14251,GEPA4,2016-03-31,2016-05-12,31478,62955,94433
14252,GEPA4,2016-06-30,2016-08-11,31478,62955,94433
14253,GEPA4,2016-09-30,2016-11-10,31478,62955,94433
14254,GEPA4,2016-12-31,2017-03-27,31478,62955,94433
14255,GEPA4,2017-03-31,2017-05-11,31478,62955,94433
14256,GEPA4,2017-06-30,2017-08-10,31478,62955,94433
14257,GEPA4,2017-09-30,2017-11-09,31478,62955,94433
14258,GEPA4,2017-12-31,2018-03-15,31478,62955,94433
14259,GEPA4,2018-03-31,2018-05-15,31478,62955,94433
14260,GEPA4,2018-06-30,2018-08-14,31478,62955,94433
14261,GEPA4,2018-09-30,2018-11-12,31478,62955,94433
14262,GEPA4,2018-12-31,2019-03-12,31478,62955,94433
14263,GEPA4,2019-03-31,2019-05-13,31478,62955,94433
14264,GEPA4,2019-06-30,2019-08-14,31478,62955,94433
14265,GEPA4,2019-09-30,2019-11-13,31478,62955,94433
14266,GEPA4,2019-12-31,2020-03-26,31478,62955,94433
14267,GEPA4,2020-03-31,2020-05-13,31478,62955,94433
14268,GEPA4,2020-06-30,2020-08-13,31478,62955,94433
14269,GEPA4,2020-09-30,2020-11-12,31478,62955,94433
14270,TRPL3,2010-12-31,2011-04-20,63861,87968,151829
14271,TRPL3,2011-03-31,2011-08-19,63861,87968,151829
14272,TRPL3,2011-06-30,2011-08-15,63861,87968,151829
14273,TRPL3,2011-09-30,2011-11-14,63861,87968,151829
14274,TRPL3,2011-12-31,2012-03-15,64484,88177,152661
14275,TRPL3,2012-03-31,2012-05-14,64484,88177,152661
14276,TRPL3,2012-06-30,2012-08-13,64484,88177,152661
14277,TRPL3,2012-09-30,2012-11-12,64484,88177,152661
14278,TRPL3,2012-12-31,2013-02-26,64484433,88177132,152661565
14279,TRPL3,2013-03-31,2013-05-16,64484,88177,152661
14280,TRPL3,2013-06-30,2013-08-14,64484,88177,152661
14281,TRPL3,2013-09-30,2013-10-28,64484,88177,152661
14282,TRPL3,2013-12-31,2014-02-27,64484,88177,152661
14283,TRPL3,2014-03-31,2014-05-15,64484,88177,152661
14284,TRPL3,2014-06-30,2014-07-30,64484,88177,152661
14285,TRPL3,2014-09-30,2014-10-30,64484433,96775022,161259455
14286,TRPL3,2014-12-31,2015-02-26,64484433,96775022,161259455
14287,TRPL3,2015-03-31,2015-04-29,64484433,96775022,161259455
14288,TRPL3,2015-06-30,2015-07-30,64484433,96775022,161259455
14289,TRPL3,2015-09-30,2015-10-26,64484433,96775022,161259455
14290,TRPL3,2015-12-31,2016-04-20,64484433,96775022,161259455
14291,TRPL3,2016-03-31,2016-04-28,64484433,96775022,161259455
14292,TRPL3,2016-06-30,2016-09-08,64484433,100236393,164720826
14293,TRPL3,2016-09-30,2016-10-28,64484433,100236393,164720826
14294,TRPL3,2016-12-31,2017-02-23,64484433,100236393,164720826
14295,TRPL3,2017-03-31,2017-04-27,64484433,100236393,164720826
14296,TRPL3,2017-06-30,2017-08-01,64484433,100236393,164720826
14297,TRPL3,2017-09-30,2017-10-30,64484433,100236393,164720826
14298,TRPL3,2017-12-31,2018-02-26,64484433,100236393,164720826
14299,TRPL3,2018-03-31,2018-05-15,64484433,100236393,164720826
14300,TRPL3,2018-06-30,2018-07-31,64484433,100236393,164720826
14301,TRPL3,2018-09-30,2018-10-29,64484433,100236393,164720826
14302,TRPL3,2018-12-31,2019-02-28,64484433,100236393,164720826
14303,TRPL3,2019-03-31,2019-04-29,64484433,100236393,164720826
14304,TRPL3,2019-06-30,2019-07-30,257937732,400945572,658883304
14305,TRPL3,2019-09-30,2019-11-05,257937732,400945572,658883304
14306,TRPL3,2019-12-31,2020-03-04,257937732,400945572,658883304
14307,TRPL3,2020-03-31,2020-04-29,257937732,400945572,658883304
14308,TRPL3,2020-06-30,2020-07-30,257937732,400945572,658883304
14309,TRPL3,2020-09-30,2020-10-29,257937732,400945572,658883304
14310,TRPL3,2020-12-31,2021-02-22,257937732,400945572,658883304
14311,TRPL4,2010-12-31,2011-04-20,63861,87968,151829
14312,TRPL4,2011-03-31,2011-08-19,63861,87968,151829
14313,TRPL4,2011-06-30,2011-08-15,63861,87968,151829
14314,TRPL4,2011-09-30,2011-11-14,63861,87968,151829
14315,TRPL4,2011-12-31,2012-03-15,64484,88177,152661
14316,TRPL4,2012-03-31,2012-05-14,64484,88177,152661
14317,TRPL4,2012-06-30,2012-08-13,64484,88177,152661
14318,TRPL4,2012-09-30,2012-11-12,64484,88177,152661
14319,TRPL4,2012-12-31,2013-02-26,64484433,88177132,152661565
14320,TRPL4,2013-03-31,2013-05-16,64484,88177,152661
14321,TRPL4,2013-06-30,2013-08-14,64484,88177,152661
14322,TRPL4,2013-09-30,2013-10-28,64484,88177,152661
14323,TRPL4,2013-12-31,2014-02-27,64484,88177,152661
14324,TRPL4,2014-03-31,2014-05-15,64484,88177,152661
14325,TRPL4,2014-06-30,2014-07-30,64484,88177,152661
14326,TRPL4,2014-09-30,2014-10-30,64484433,96775022,161259455
14327,TRPL4,2014-12-31,2015-02-26,64484433,96775022,161259455
14328,TRPL4,2015-03-31,2015-04-29,64484433,96775022,161259455
14329,TRPL4,2015-06-30,2015-07-30,64484433,96775022,161259455
14330,TRPL4,2015-09-30,2015-10-26,64484433,96775022,161259455
14331,TRPL4,2015-12-31,2016-04-20,64484433,96775022,161259455
14332,TRPL4,2016-03-31,2016-04-28,64484433,96775022,161259455
14333,TRPL4,2016-06-30,2016-09-08,64484433,100236393,164720826
14334,TRPL4,2016-09-30,2016-10-28,64484433,100236393,164720826
14335,TRPL4,2016-12-31,2017-02-23,64484433,100236393,164720826
14336,TRPL4,2017-03-31,2017-04-27,64484433,100236393,164720826
14337,TRPL4,2017-06-30,2017-08-01,64484433,100236393,164720826
14338,TRPL4,2017-09-30,2017-10-30,64484433,100236393,164720826
14339,TRPL4,2017-12-31,2018-02-26,64484433,100236393,164720826
14340,TRPL4,2018-03-31,2018-05-15,64484433,100236393,164720826
14341,TRPL4,2018-06-30,2018-07-31,64484433,100236393,164720826
14342,TRPL4,2018-09-30,2018-10-29,64484433,100236393,164720826
14343,TRPL4,2018-12-31,2019-02-28,64484433,100236393,164720826
14344,TRPL4,2019-03-31,2019-04-29,64484433,100236393,164720826
14345,TRPL4,2019-06-30,2019-07-30,257937732,400945572,658883304
14346,TRPL4,2019-09-30,2019-11-05,257937732,400945572,658883304
14347,TRPL4,2019-12-31,2020-03-04,257937732,400945572,658883304
14348,TRPL4,2020-03-31,2020-04-29,257937732,400945572,658883304
14349,TRPL4,2020-06-30,2020-07-30,257937732,400945572,658883304
14350,TRPL4,2020-09-30,2020-10-29,257937732,400945572,658883304
14351,TRPL4,2020-12-31,2021-02-22,257937732,400945572,658883304
14352,IDNT3,2010-12-31,2011-04-25,115381,0,115381
14353,IDNT3,2011-03-31,2011-05-14,115928,0,115928
14354,IDNT3,2011-06-30,2011-08-17,115928,0,115928
14355,IDNT3,2011-09-30,2011-11-11,115953,0,115953
14356,IDNT3,2011-12-31,2013-01-07,115928,0,115928
14357,IDNT3,2012-03-31,2013-01-24,115928,0,115928
14358,IDNT3,2012-06-30,2012-08-14,115928,0,115928
14359,IDNT3,2012-09-30,2013-01-07,115928,0,115928
14360,IDNT3,2012-12-31,2013-03-28,115928,0,115928
14361,IDNT3,2013-03-31,2013-05-24,115928,0,115928
14362,IDNT3,2013-06-30,2013-08-14,122270,0,122270
14363,IDNT3,2013-09-30,2013-11-14,103030,0,103030
14364,IDNT3,2013-12-31,2014-03-28,122270,0,122270
14365,IDNT3,2014-03-31,2014-05-15,122270,0,122270
14366,IDNT3,2014-06-30,2014-08-14,122270,0,122270
14367,IDNT3,2014-09-30,2014-11-14,122270,0,122270
14368,IDNT3,2014-12-31,2015-03-30,122270,0,122270
14369,IDNT3,2015-03-31,2015-05-15,122270,0,122270
14370,IDNT3,2015-06-30,2015-08-14,163436,0,163436
14371,IDNT3,2015-09-30,2015-11-13,16344,0,16344
14372,IDNT3,2015-12-31,2016-03-18,16344,0,16344
14373,IDNT3,2016-03-31,2016-05-13,16344,0,16344
14374,IDNT3,2016-06-30,2016-08-15,16344,0,16344
14375,IDNT3,2016-09-30,2016-11-14,16344,0,16344
14376,IDNT3,2016-12-31,2017-03-28,16344,0,16344
14377,IDNT3,2017-03-31,2017-05-16,16344,0,16344
14378,IDNT3,2017-06-30,2017-08-14,16344,0,16344
14379,IDNT3,2017-09-30,2017-11-14,16344,0,16344
14380,IDNT3,2017-12-31,2018-03-22,16344,0,16344
14381,IDNT3,2018-03-31,2018-05-15,16344,0,16344
14382,IDNT3,2018-06-30,2018-08-14,16344,0,16344
14383,IDNT3,2018-09-30,2018-11-16,16344,0,16344
14384,IDNT3,2018-12-31,2019-03-22,16344,0,16344
14385,IDNT3,2019-03-31,2019-05-15,16344,0,16344
14386,IDNT3,2019-06-30,2019-08-14,16344,0,16344
14387,IDNT3,2019-09-30,2019-11-12,16344,0,16344
14388,IDNT3,2019-12-31,2020-03-24,16344,0,16344
14389,IDNT3,2020-03-31,2020-05-20,16344,0,16344
14390,IDNT3,2020-06-30,2020-08-14,78450,0,78450
14391,IDNT3,2020-09-30,2020-11-23,78450,0,78450
14392,IDNT3,2020-12-31,2021-02-11,78450,0,78450
14393,PDTC3,2010-12-31,2011-04-25,115381,0,115381
14394,PDTC3,2011-03-31,2011-05-14,115928,0,115928
14395,PDTC3,2011-06-30,2011-08-17,115928,0,115928
14396,PDTC3,2011-09-30,2011-11-11,115953,0,115953
14397,PDTC3,2011-12-31,2013-01-07,115928,0,115928
14398,PDTC3,2012-03-31,2013-01-24,115928,0,115928
14399,PDTC3,2012-06-30,2012-08-14,115928,0,115928
14400,PDTC3,2012-09-30,2013-01-07,115928,0,115928
14401,PDTC3,2012-12-31,2013-03-28,115928,0,115928
14402,PDTC3,2013-03-31,2013-05-24,115928,0,115928
14403,PDTC3,2013-06-30,2013-08-14,122270,0,122270
14404,PDTC3,2013-09-30,2013-11-14,103030,0,103030
14405,PDTC3,2013-12-31,2014-03-28,122270,0,122270
14406,PDTC3,2014-03-31,2014-05-15,122270,0,122270
14407,PDTC3,2014-06-30,2014-08-14,122270,0,122270
14408,PDTC3,2014-09-30,2014-11-14,122270,0,122270
14409,PDTC3,2014-12-31,2015-03-30,122270,0,122270
14410,PDTC3,2015-03-31,2015-05-15,122270,0,122270
14411,PDTC3,2015-06-30,2015-08-14,163436,0,163436
14412,PDTC3,2015-09-30,2015-11-13,16344,0,16344
14413,PDTC3,2015-12-31,2016-03-18,16344,0,16344
14414,PDTC3,2016-03-31,2016-05-13,16344,0,16344
14415,PDTC3,2016-06-30,2016-08-15,16344,0,16344
14416,PDTC3,2016-09-30,2016-11-14,16344,0,16344
14417,PDTC3,2016-12-31,2017-03-28,16344,0,16344
14418,PDTC3,2017-03-31,2017-05-16,16344,0,16344
14419,PDTC3,2017-06-30,2017-08-14,16344,0,16344
14420,PDTC3,2017-09-30,2017-11-14,16344,0,16344
14421,PDTC3,2017-12-31,2018-03-22,16344,0,16344
14422,PDTC3,2018-03-31,2018-05-15,16344,0,16344
14423,PDTC3,2018-06-30,2018-08-14,16344,0,16344
14424,PDTC3,2018-09-30,2018-11-16,16344,0,16344
14425,PDTC3,2018-12-31,2019-03-22,16344,0,16344
14426,PDTC3,2019-03-31,2019-05-15,16344,0,16344
14427,PDTC3,2019-06-30,2019-08-14,16344,0,16344
14428,PDTC3,2019-09-30,2019-11-12,16344,0,16344
14429,PDTC3,2019-12-31,2020-03-24,16344,0,16344
14430,PDTC3,2020-03-31,2020-05-20,16344,0,16344
14431,PDTC3,2020-06-30,2020-08-14,78450,0,78450
14432,PDTC3,2020-09-30,2020-11-23,78450,0,78450
14433,PDTC3,2020-12-31,2021-02-11,78450,0,78450
14434,UGPA3,2010-12-31,2011-02-24,197719588,346664408,544383996
14435,UGPA3,2011-03-31,2011-05-12,197719588,346664408,544383996
14436,UGPA3,2011-06-30,2011-08-10,197719588,346664408,544383996
14437,UGPA3,2011-09-30,2011-11-09,544383996,0,544383996
14438,UGPA3,2011-12-31,2012-02-16,544383996,0,544383996
14439,UGPA3,2012-03-31,2012-05-02,544383996,0,544383996
14440,UGPA3,2012-06-30,2012-08-01,544383996,0,544383996
14441,UGPA3,2012-09-30,2012-11-08,544383996,0,544383996
14442,UGPA3,2012-12-31,2013-02-20,544383996,0,544383996
14443,UGPA3,2013-03-31,2013-05-15,544383996,0,544383996
14444,UGPA3,2013-06-30,2013-07-31,544383996,0,544383996
14445,UGPA3,2013-09-30,2013-11-06,544383996,0,544383996
14446,UGPA3,2013-12-31,2014-02-19,544383996,0,544383996
14447,UGPA3,2014-03-31,2014-05-14,556405096,0,556405096
14448,UGPA3,2014-06-30,2014-08-06,556405096,0,556405096
14449,UGPA3,2014-09-30,2014-11-05,556405096,0,556405096
14450,UGPA3,2014-12-31,2015-02-25,556405096,0,556405096
14451,UGPA3,2015-03-31,2015-05-06,556405096,0,556405096
14452,UGPA3,2015-06-30,2015-08-05,556405096,0,556405096
14453,UGPA3,2015-09-30,2015-11-04,556405096,0,556405096
14454,UGPA3,2015-12-31,2016-02-17,556405096,0,556405096
14455,UGPA3,2016-03-31,2016-05-11,556405096,0,556405096
14456,UGPA3,2016-06-30,2016-08-10,556405096,0,556405096
14457,UGPA3,2016-09-30,2016-11-09,556405096,0,556405096
14458,UGPA3,2016-12-31,2017-02-22,556405096,0,556405096
14459,UGPA3,2017-03-31,2017-05-10,556405096,0,556405096
14460,UGPA3,2017-06-30,2017-08-09,556405096,0,556405096
14461,UGPA3,2017-09-30,2017-11-08,556405096,0,556405096
14462,UGPA3,2017-12-31,2018-02-21,556405096,0,556405096
14463,UGPA3,2018-03-31,2018-05-02,556405096,0,556405096
14464,UGPA3,2018-06-30,2018-08-02,556405096,0,556405096
14465,UGPA3,2018-09-30,2018-11-07,556405096,0,556405096
14466,UGPA3,2018-12-31,2019-02-20,556405096,0,556405096
14467,UGPA3,2019-03-31,2019-05-15,556405096,0,556405096
14468,UGPA3,2019-06-30,2019-08-14,1112810192,0,1112810192
14469,UGPA3,2019-09-30,2019-11-06,1112810192,0,1112810192
14470,UGPA3,2019-12-31,2020-03-16,1112810192,0,1112810192
14471,UGPA3,2020-03-31,2020-05-13,1114918734,0,1114918734
14472,UGPA3,2020-06-30,2020-08-12,1114918734,0,1114918734
14473,UGPA3,2020-09-30,2020-11-04,1115005712,0,1115005712
14474,UGPA3,2020-12-31,2021-02-25,1115005712,0,1115005712
14475,MNZC3B,2010-12-31,2011-03-04,526310,0,526310
14476,MNZC3B,2011-03-31,2011-05-13,526313,0,526313
14477,MNZC3B,2011-06-30,2011-08-09,526310,0,526310
14478,MNZC3B,2011-09-30,2011-11-11,526309,0,526309
14479,MNZC3B,2011-12-31,2012-03-08,526309,0,526309
14480,MNZC3B,2012-03-31,2012-05-10,526313,0,526313
14481,MNZC3B,2012-06-30,2012-07-20,526313,0,526313
14482,MNZC3B,2012-09-30,2012-11-05,526309,0,526309
14483,MNZC3B,2012-12-31,2013-03-08,526313,0,526313
14484,MNZC3B,2013-03-31,2013-05-14,526313,0,526313
14485,MNZC3B,2013-06-30,2013-08-12,526313,0,526313
14486,MNZC3B,2013-09-30,2013-11-12,526313,0,526313
14487,MNZC3B,2013-12-31,2014-02-26,526312,0,526312
14488,MNZC3B,2014-03-31,2014-05-09,526308,0,526308
14489,MNZC3B,2014-06-30,2014-08-13,526308,0,526308
14490,MNZC3B,2014-09-30,2014-11-10,526308,0,526308
14491,MNZC3B,2014-12-31,2015-02-12,526308,0,526308
14492,MNZC3B,2015-03-31,2015-05-15,526308,0,526308
14493,MNZC3B,2015-06-30,2015-08-11,526306,0,526306
14494,MNZC3B,2015-09-30,2015-10-29,526306,0,526306
14495,MNZC3B,2015-12-31,2016-02-25,526308,0,526308
14496,MNZC3B,2016-03-31,2016-04-28,526308,0,526308
14497,MNZC3B,2016-06-30,2016-07-28,526308,0,526308
14498,MNZC3B,2016-09-30,2016-11-01,526306,0,526306
14499,MNZC3B,2016-12-31,2017-02-24,526308,0,526308
14500,MNZC3B,2017-03-31,2017-05-02,526308,0,526308
14501,MNZC3B,2017-06-30,2017-07-25,526308,0,526308
14502,MNZC3B,2017-09-30,2017-10-31,526308,0,526308
14503,MNZC3B,2017-12-31,2018-03-16,526308,0,526308
14504,MNZC3B,2018-03-31,2018-05-04,526308,0,526308
14505,MNZC3B,2018-06-30,2018-08-09,526308,0,526308
14506,MNZC3B,2018-09-30,2018-11-07,526308,0,526308
14507,MNZC3B,2018-12-31,2019-02-28,526308,0,526308
14508,MNZC3B,2019-03-31,2019-05-02,526308,0,526308
14509,MNZC3B,2019-06-30,2019-08-12,526308,0,526308
14510,MNZC3B,2019-09-30,2019-11-07,526308,0,526308
14511,MNZC3B,2019-12-31,2020-03-10,526308,0,526308
14512,MNZC3B,2020-03-31,2020-06-26,526308,0,526308
14513,MNZC3B,2020-06-30,2020-08-28,526308,0,526308
14514,MNZC3B,2020-09-30,2020-11-03,526308,0,526308
14515,MNZC3B,2020-12-31,2021-03-17,526308,0,526308
14516,DTCY3,2010-12-31,2011-03-30,52882,3247,56129
14517,DTCY3,2011-03-31,2011-05-13,52884310,3247500,56131810
14518,DTCY3,2011-06-30,2011-08-15,52884310,3247500,56131810
14519,DTCY3,2011-09-30,2011-11-11,52884310,3247500,56131810
14520,DTCY3,2011-12-31,2013-03-28,52884310,3247500,56131810
14521,DTCY3,2012-03-31,2013-03-28,52884310,3247500,56131810
14522,DTCY3,2012-06-30,2013-04-01,52884310,3247500,56131810
14523,DTCY3,2012-09-30,2013-03-28,52884310,3247500,56131810
14524,DTCY3,2012-12-31,2013-04-01,52884310,3247500,56131810
14525,DTCY3,2013-03-31,2013-05-16,52884310,3247500,56131810
14526,DTCY3,2013-06-30,2013-08-14,52884310,3247500,56131810
14527,DTCY3,2013-09-30,2013-11-14,52884310,3247500,56131810
14528,DTCY3,2013-12-31,2014-03-28,52884310,3247500,56131810
14529,DTCY3,2014-03-31,2014-05-13,52884310,3247500,56131810
14530,DTCY3,2014-06-30,2014-08-13,52884310,3247500,56131810
14531,DTCY3,2014-09-30,2014-11-14,52884310,3247500,56131810
14532,DTCY3,2014-12-31,2015-03-30,52884310,3247500,56131810
14533,DTCY3,2015-03-31,2015-05-15,52884310,3247500,56131810
14534,DTCY3,2015-06-30,2015-08-14,52884310,3247500,56131810
14535,DTCY3,2015-09-30,2015-11-13,52884310,3247500,56131810
14536,DTCY3,2015-12-31,2016-03-29,52884310,3247500,56131810
14537,DTCY3,2016-03-31,2016-05-13,52884310,3247500,56131810
14538,DTCY3,2016-06-30,2016-08-12,5288431,324750,5613181
14539,DTCY3,2016-09-30,2016-11-11,7338756,450655,7789411
14540,DTCY3,2016-12-31,2017-03-28,7338756,450655,7789411
14541,DTCY3,2017-03-31,2017-05-16,7338756,450655,7789411
14542,DTCY3,2017-06-30,2017-08-18,7338756,450655,7789411
14543,DTCY3,2017-09-30,2018-04-18,7338756,450655,7789411
14544,DTCY3,2017-12-31,2018-05-15,7338756,450655,7789411
14545,DTCY3,2018-03-31,2018-05-15,7338756,450655,7789411
14546,DTCY3,2018-06-30,2018-09-12,7338756,450655,7789411
14547,DTCY3,2018-09-30,2018-11-16,7338756,450655,7789411
14548,DTCY3,2018-12-31,2019-03-29,7338756,450655,7789411
14549,DTCY3,2019-03-31,2019-05-16,7338756,450655,7789411
14550,DTCY3,2019-06-30,2019-08-15,7338756,450655,7789411
14551,DTCY3,2019-09-30,2019-11-14,7338756,450655,7789411
14552,DTCY3,2019-12-31,2020-03-31,7338756,450655,7789411
14553,DTCY3,2020-03-31,2020-06-29,7338756,450655,7789411
14554,DTCY3,2020-06-30,2020-08-31,7338756,450655,7789411
14555,DTCY3,2020-09-30,2020-11-16,7338756,450655,7789411
14556,DTCY4,2010-12-31,2011-03-30,52882,3247,56129
14557,DTCY4,2011-03-31,2011-05-13,52884310,3247500,56131810
14558,DTCY4,2011-06-30,2011-08-15,52884310,3247500,56131810
14559,DTCY4,2011-09-30,2011-11-11,52884310,3247500,56131810
14560,DTCY4,2011-12-31,2013-03-28,52884310,3247500,56131810
14561,DTCY4,2012-03-31,2013-03-28,52884310,3247500,56131810
14562,DTCY4,2012-06-30,2013-04-01,52884310,3247500,56131810
14563,DTCY4,2012-09-30,2013-03-28,52884310,3247500,56131810
14564,DTCY4,2012-12-31,2013-04-01,52884310,3247500,56131810
14565,DTCY4,2013-03-31,2013-05-16,52884310,3247500,56131810
14566,DTCY4,2013-06-30,2013-08-14,52884310,3247500,56131810
14567,DTCY4,2013-09-30,2013-11-14,52884310,3247500,56131810
14568,DTCY4,2013-12-31,2014-03-28,52884310,3247500,56131810
14569,DTCY4,2014-03-31,2014-05-13,52884310,3247500,56131810
14570,DTCY4,2014-06-30,2014-08-13,52884310,3247500,56131810
14571,DTCY4,2014-09-30,2014-11-14,52884310,3247500,56131810
14572,DTCY4,2014-12-31,2015-03-30,52884310,3247500,56131810
14573,DTCY4,2015-03-31,2015-05-15,52884310,3247500,56131810
14574,DTCY4,2015-06-30,2015-08-14,52884310,3247500,56131810
14575,DTCY4,2015-09-30,2015-11-13,52884310,3247500,56131810
14576,DTCY4,2015-12-31,2016-03-29,52884310,3247500,56131810
14577,DTCY4,2016-03-31,2016-05-13,52884310,3247500,56131810
14578,DTCY4,2016-06-30,2016-08-12,5288431,324750,5613181
14579,DTCY4,2016-09-30,2016-11-11,7338756,450655,7789411
14580,DTCY4,2016-12-31,2017-03-28,7338756,450655,7789411
14581,DTCY4,2017-03-31,2017-05-16,7338756,450655,7789411
14582,DTCY4,2017-06-30,2017-08-18,7338756,450655,7789411
14583,DTCY4,2017-09-30,2018-04-18,7338756,450655,7789411
14584,DTCY4,2017-12-31,2018-05-15,7338756,450655,7789411
14585,DTCY4,2018-03-31,2018-05-15,7338756,450655,7789411
14586,DTCY4,2018-06-30,2018-09-12,7338756,450655,7789411
14587,DTCY4,2018-09-30,2018-11-16,7338756,450655,7789411
14588,DTCY4,2018-12-31,2019-03-29,7338756,450655,7789411
14589,DTCY4,2019-03-31,2019-05-16,7338756,450655,7789411
14590,DTCY4,2019-06-30,2019-08-15,7338756,450655,7789411
14591,DTCY4,2019-09-30,2019-11-14,7338756,450655,7789411
14592,DTCY4,2019-12-31,2020-03-31,7338756,450655,7789411
14593,DTCY4,2020-03-31,2020-06-29,7338756,450655,7789411
14594,DTCY4,2020-06-30,2020-08-31,7338756,450655,7789411
14595,DTCY4,2020-09-30,2020-11-16,7338756,450655,7789411
14596,SAPR11,2010-12-31,2011-03-25,289836870,124245312,414082182
14597,SAPR11,2011-03-31,2011-05-11,289836870,124245312,414082182
14598,SAPR11,2011-06-30,2011-08-10,289836870,124245312,414082182
14599,SAPR11,2011-09-30,2011-11-09,289836870,124245312,414082182
14600,SAPR11,2011-12-31,2014-03-28,289836870,124245312,414082182
14601,SAPR11,2012-03-31,2012-05-14,289836870,124245312,414082182
14602,SAPR11,2012-06-30,2012-08-10,289836870,124245312,414082182
14603,SAPR11,2012-09-30,2012-11-08,289836870,124245312,414082182
14604,SAPR11,2012-12-31,2014-02-25,289836870,124245312,414082182
14605,SAPR11,2013-03-31,2013-05-09,289836870,124245312,414082182
14606,SAPR11,2013-06-30,2013-08-08,289836870,124245312,414082182
14607,SAPR11,2013-09-30,2013-11-07,289836870,124245312,414082182
14608,SAPR11,2013-12-31,2014-02-25,289836870,186783336,476620206
14609,SAPR11,2014-03-31,2014-05-14,289836870,186783336,476620206
14610,SAPR11,2014-06-30,2014-08-12,231967956,244652250,476620206
14611,SAPR11,2014-09-30,2014-10-30,231967956,244652250,476620206
14612,SAPR11,2014-12-31,2016-10-18,231967956,244652250,476620206
14613,SAPR11,2015-03-31,2015-05-14,231967956,244652250,476620206
14614,SAPR11,2015-06-30,2015-08-13,231967956,244652250,476620206
14615,SAPR11,2015-09-30,2015-11-11,231967956,244652250,476620206
14616,SAPR11,2015-12-31,2016-03-22,231967956,244652250,476620206
14617,SAPR11,2016-03-31,2016-05-12,231967956,244652250,476620206
14618,SAPR11,2016-06-30,2016-08-03,231967956,244652250,476620206
14619,SAPR11,2016-09-30,2016-12-14,231967956,244652250,476620206
14620,SAPR11,2016-12-31,2017-02-21,167911724,335823449,503735173
14621,SAPR11,2017-03-31,2017-05-09,167911724,335823449,503735173
14622,SAPR11,2017-06-30,2017-08-08,167911724,335823449,503735173
14623,SAPR11,2017-09-30,2017-11-29,167911724,335823449,503735173
14624,SAPR11,2017-12-31,2018-02-06,167911753,335823420,503735173
14625,SAPR11,2018-03-31,2018-05-08,167911753,335823420,503735173
14626,SAPR11,2018-06-30,2018-08-07,167911753,335823420,503735173
14627,SAPR11,2018-09-30,2018-11-06,167911753,335823420,503735173
14628,SAPR11,2018-12-31,2019-02-21,167911753,335823420,503735173
14629,SAPR11,2019-03-31,2019-05-07,167911753,335823420,503735173
14630,SAPR11,2019-06-30,2019-08-13,167911753,335823420,503735173
14631,SAPR11,2019-09-30,2019-11-11,167911753,335823420,503735173
14632,SAPR11,2019-12-31,2020-02-06,167911753,335823420,503735173
14633,SAPR11,2020-03-31,2020-05-07,503735259,1007470260,1511205519
14634,SAPR11,2020-06-30,2020-08-07,503735259,1007470260,1511205519
14635,SAPR11,2020-09-30,2020-11-13,503735259,1007470260,1511205519
14636,SAPR11,2020-12-31,2021-02-11,503735259,1007470260,1511205519
14637,SAPR3,2010-12-31,2011-03-25,289836870,124245312,414082182
14638,SAPR3,2011-03-31,2011-05-11,289836870,124245312,414082182
14639,SAPR3,2011-06-30,2011-08-10,289836870,124245312,414082182
14640,SAPR3,2011-09-30,2011-11-09,289836870,124245312,414082182
14641,SAPR3,2011-12-31,2014-03-28,289836870,124245312,414082182
14642,SAPR3,2012-03-31,2012-05-14,289836870,124245312,414082182
14643,SAPR3,2012-06-30,2012-08-10,289836870,124245312,414082182
14644,SAPR3,2012-09-30,2012-11-08,289836870,124245312,414082182
14645,SAPR3,2012-12-31,2014-02-25,289836870,124245312,414082182
14646,SAPR3,2013-03-31,2013-05-09,289836870,124245312,414082182
14647,SAPR3,2013-06-30,2013-08-08,289836870,124245312,414082182
14648,SAPR3,2013-09-30,2013-11-07,289836870,124245312,414082182
14649,SAPR3,2013-12-31,2014-02-25,289836870,186783336,476620206
14650,SAPR3,2014-03-31,2014-05-14,289836870,186783336,476620206
14651,SAPR3,2014-06-30,2014-08-12,231967956,244652250,476620206
14652,SAPR3,2014-09-30,2014-10-30,231967956,244652250,476620206
14653,SAPR3,2014-12-31,2016-10-18,231967956,244652250,476620206
14654,SAPR3,2015-03-31,2015-05-14,231967956,244652250,476620206
14655,SAPR3,2015-06-30,2015-08-13,231967956,244652250,476620206
14656,SAPR3,2015-09-30,2015-11-11,231967956,244652250,476620206
14657,SAPR3,2015-12-31,2016-03-22,231967956,244652250,476620206
14658,SAPR3,2016-03-31,2016-05-12,231967956,244652250,476620206
14659,SAPR3,2016-06-30,2016-08-03,231967956,244652250,476620206
14660,SAPR3,2016-09-30,2016-12-14,231967956,244652250,476620206
14661,SAPR3,2016-12-31,2017-02-21,167911724,335823449,503735173
14662,SAPR3,2017-03-31,2017-05-09,167911724,335823449,503735173
14663,SAPR3,2017-06-30,2017-08-08,167911724,335823449,503735173
14664,SAPR3,2017-09-30,2017-11-29,167911724,335823449,503735173
14665,SAPR3,2017-12-31,2018-02-06,167911753,335823420,503735173
14666,SAPR3,2018-03-31,2018-05-08,167911753,335823420,503735173
14667,SAPR3,2018-06-30,2018-08-07,167911753,335823420,503735173
14668,SAPR3,2018-09-30,2018-11-06,167911753,335823420,503735173
14669,SAPR3,2018-12-31,2019-02-21,167911753,335823420,503735173
14670,SAPR3,2019-03-31,2019-05-07,167911753,335823420,503735173
14671,SAPR3,2019-06-30,2019-08-13,167911753,335823420,503735173
14672,SAPR3,2019-09-30,2019-11-11,167911753,335823420,503735173
14673,SAPR3,2019-12-31,2020-02-06,167911753,335823420,503735173
14674,SAPR3,2020-03-31,2020-05-07,503735259,1007470260,1511205519
14675,SAPR3,2020-06-30,2020-08-07,503735259,1007470260,1511205519
14676,SAPR3,2020-09-30,2020-11-13,503735259,1007470260,1511205519
14677,SAPR3,2020-12-31,2021-02-11,503735259,1007470260,1511205519
14678,SAPR4,2010-12-31,2011-03-25,289836870,124245312,414082182
14679,SAPR4,2011-03-31,2011-05-11,289836870,124245312,414082182
14680,SAPR4,2011-06-30,2011-08-10,289836870,124245312,414082182
14681,SAPR4,2011-09-30,2011-11-09,289836870,124245312,414082182
14682,SAPR4,2011-12-31,2014-03-28,289836870,124245312,414082182
14683,SAPR4,2012-03-31,2012-05-14,289836870,124245312,414082182
14684,SAPR4,2012-06-30,2012-08-10,289836870,124245312,414082182
14685,SAPR4,2012-09-30,2012-11-08,289836870,124245312,414082182
14686,SAPR4,2012-12-31,2014-02-25,289836870,124245312,414082182
14687,SAPR4,2013-03-31,2013-05-09,289836870,124245312,414082182
14688,SAPR4,2013-06-30,2013-08-08,289836870,124245312,414082182
14689,SAPR4,2013-09-30,2013-11-07,289836870,124245312,414082182
14690,SAPR4,2013-12-31,2014-02-25,289836870,186783336,476620206
14691,SAPR4,2014-03-31,2014-05-14,289836870,186783336,476620206
14692,SAPR4,2014-06-30,2014-08-12,231967956,244652250,476620206
14693,SAPR4,2014-09-30,2014-10-30,231967956,244652250,476620206
14694,SAPR4,2014-12-31,2016-10-18,231967956,244652250,476620206
14695,SAPR4,2015-03-31,2015-05-14,231967956,244652250,476620206
14696,SAPR4,2015-06-30,2015-08-13,231967956,244652250,476620206
14697,SAPR4,2015-09-30,2015-11-11,231967956,244652250,476620206
14698,SAPR4,2015-12-31,2016-03-22,231967956,244652250,476620206
14699,SAPR4,2016-03-31,2016-05-12,231967956,244652250,476620206
14700,SAPR4,2016-06-30,2016-08-03,231967956,244652250,476620206
14701,SAPR4,2016-09-30,2016-12-14,231967956,244652250,476620206
14702,SAPR4,2016-12-31,2017-02-21,167911724,335823449,503735173
14703,SAPR4,2017-03-31,2017-05-09,167911724,335823449,503735173
14704,SAPR4,2017-06-30,2017-08-08,167911724,335823449,503735173
14705,SAPR4,2017-09-30,2017-11-29,167911724,335823449,503735173
14706,SAPR4,2017-12-31,2018-02-06,167911753,335823420,503735173
14707,SAPR4,2018-03-31,2018-05-08,167911753,335823420,503735173
14708,SAPR4,2018-06-30,2018-08-07,167911753,335823420,503735173
14709,SAPR4,2018-09-30,2018-11-06,167911753,335823420,503735173
14710,SAPR4,2018-12-31,2019-02-21,167911753,335823420,503735173
14711,SAPR4,2019-03-31,2019-05-07,167911753,335823420,503735173
14712,SAPR4,2019-06-30,2019-08-13,167911753,335823420,503735173
14713,SAPR4,2019-09-30,2019-11-11,167911753,335823420,503735173
14714,SAPR4,2019-12-31,2020-02-06,167911753,335823420,503735173
14715,SAPR4,2020-03-31,2020-05-07,503735259,1007470260,1511205519
14716,SAPR4,2020-06-30,2020-08-07,503735259,1007470260,1511205519
14717,SAPR4,2020-09-30,2020-11-13,503735259,1007470260,1511205519
14718,SAPR4,2020-12-31,2021-02-11,503735259,1007470260,1511205519
14719,CPFE3,2010-12-31,2011-03-28,481137130,0,481137130
14720,CPFE3,2011-03-31,2011-05-11,481137130,0,481137130
14721,CPFE3,2011-06-30,2011-08-10,962274260,0,962274260
14722,CPFE3,2011-09-30,2011-11-10,962274260,0,962274260
14723,CPFE3,2011-12-31,2012-03-12,962274260,0,962274260
14724,CPFE3,2012-03-31,2012-05-07,962274260,0,962274260
14725,CPFE3,2012-06-30,2012-08-06,962274260,0,962274260
14726,CPFE3,2012-09-30,2012-11-05,962274260,0,962274260
14727,CPFE3,2012-12-31,2013-03-13,962274260,0,962274260
14728,CPFE3,2013-03-31,2013-05-09,962274260,0,962274260
14729,CPFE3,2013-06-30,2013-08-14,962274260,0,962274260
14730,CPFE3,2013-09-30,2013-11-13,962274260,0,962274260
14731,CPFE3,2013-12-31,2014-03-27,962274260,0,962274260
14732,CPFE3,2014-03-31,2014-05-12,962274260,0,962274260
14733,CPFE3,2014-06-30,2014-08-14,962274260,0,962274260
14734,CPFE3,2014-09-30,2014-11-13,962274260,0,962274260
14735,CPFE3,2014-12-31,2015-03-26,962274260,0,962274260
14736,CPFE3,2015-03-31,2015-05-08,962274260,0,962274260
14737,CPFE3,2015-06-30,2015-08-13,993014215,0,993014215
14738,CPFE3,2015-09-30,2015-11-12,993014215,0,993014215
14739,CPFE3,2015-12-31,2016-03-21,993014215,0,993014215
14740,CPFE3,2016-03-31,2016-05-12,993014215,0,993014215
14741,CPFE3,2016-06-30,2016-08-11,1017914746,0,1017914746
14742,CPFE3,2016-09-30,2016-11-10,1017914746,0,1017914746
14743,CPFE3,2016-12-31,2017-03-23,1017914746,0,1017914746
14744,CPFE3,2017-03-31,2017-08-07,1017914746,0,1017914746
14745,CPFE3,2017-06-30,2017-08-10,1017914746,0,1017914746
14746,CPFE3,2017-09-30,2017-11-13,1017917746,0,1017917746
14747,CPFE3,2017-12-31,2018-03-27,1017914746,0,1017914746
14748,CPFE3,2018-03-31,2018-05-15,1017914746,0,1017914746
14749,CPFE3,2018-06-30,2018-08-14,1017914746,0,1017914746
14750,CPFE3,2018-09-30,2018-11-12,1017914746,0,1017914746
14751,CPFE3,2018-12-31,2019-03-28,1017914746,0,1017914746
14752,CPFE3,2019-03-31,2019-05-08,1017914746,0,1017914746
14753,CPFE3,2019-06-30,2019-08-13,1152254440,0,1152254440
14754,CPFE3,2019-09-30,2019-11-12,1152254440,0,1152254440
14755,CPFE3,2019-12-31,2020-03-09,1152254440,0,1152254440
14756,CPFE3,2020-03-31,2020-05-14,1152254440,0,1152254440
14757,CPFE3,2020-06-30,2020-08-13,1152254440,0,1152254440
14758,CPFE3,2020-09-30,2020-11-12,1152254440,0,1152254440
14759,CPFE3,2020-12-31,2021-03-25,1152254440,0,1152254440
14760,PEAB3,2010-12-31,2011-04-15,6425139,6425139,12850278
14761,PEAB3,2011-03-31,2011-05-16,6425139,6425139,12850278
14762,PEAB3,2011-06-30,2011-08-15,6425139,6425139,12850278
14763,PEAB3,2011-09-30,2011-11-14,6425139,6425139,12850278
14764,PEAB3,2011-12-31,2012-03-30,6425,6425,12850
14765,PEAB3,2012-03-31,2012-05-15,6425139,6425139,12850278
14766,PEAB3,2012-06-30,2012-08-14,6425139,6425139,12850278
14767,PEAB3,2012-09-30,2012-11-19,6425139,6425139,12850278
14768,PEAB3,2012-12-31,2013-03-27,6425,6425,12850
14769,PEAB3,2013-03-31,2013-05-14,6425139,6425139,12850278
14770,PEAB3,2013-06-30,2013-08-13,6425139,6425139,12850278
14771,PEAB3,2013-09-30,2013-12-10,6425139,6425139,12850278
14772,PEAB3,2013-12-31,2014-03-31,6425,6425,12850
14773,PEAB3,2014-03-31,2014-05-14,6425139,6425139,12850278
14774,PEAB3,2014-06-30,2014-08-12,6425139,6425139,12850278
14775,PEAB3,2014-09-30,2014-11-12,6425139,6425139,12850278
14776,PEAB3,2014-12-31,2015-03-27,6425,6425,12850
14777,PEAB3,2015-03-31,2015-05-12,6425139,6425139,12850278
14778,PEAB3,2015-06-30,2015-08-12,6425139,6425139,12850278
14779,PEAB3,2015-09-30,2015-11-12,6425139,6425139,12850278
14780,PEAB3,2015-12-31,2016-03-29,6425,6425,12850
14781,PEAB3,2016-03-31,2016-05-11,6425139,6425139,12850278
14782,PEAB3,2016-06-30,2016-08-11,6425139,6425139,12850278
14783,PEAB3,2016-09-30,2016-11-14,6425139,6425139,12850278
14784,PEAB3,2016-12-31,2017-03-28,6425,6425,12850
14785,PEAB3,2017-03-31,2017-05-12,6425139,6425139,12850278
14786,PEAB3,2017-06-30,2017-08-15,6425139,6425139,12850278
14787,PEAB3,2017-09-30,2017-11-09,6425139,6425139,12850278
14788,PEAB3,2017-12-31,2018-03-22,6425139,6425139,12850278
14789,PEAB3,2018-03-31,2018-05-10,6425139,6425139,12850278
14790,PEAB3,2018-06-30,2018-08-10,6425139,6425139,12850278
14791,PEAB3,2018-09-30,2018-11-09,6425139,6425139,12850278
14792,PEAB3,2018-12-31,2019-03-22,6425139,6425139,12850278
14793,PEAB3,2019-03-31,2019-05-15,6425139,6425139,12850278
14794,PEAB3,2019-06-30,2019-08-14,6425139,6425139,12850278
14795,PEAB3,2019-09-30,2019-11-13,6425139,6425139,12850278
14796,PEAB3,2019-12-31,2020-03-27,6425139,6425139,12850278
14797,PEAB3,2020-03-31,2020-06-23,6425139,6425139,12850278
14798,PEAB3,2020-06-30,2020-09-14,6425139,6425139,12850278
14799,PEAB3,2020-09-30,2020-11-13,6425139,6425139,12850278
14800,PEAB4,2010-12-31,2011-04-15,6425139,6425139,12850278
14801,PEAB4,2011-03-31,2011-05-16,6425139,6425139,12850278
14802,PEAB4,2011-06-30,2011-08-15,6425139,6425139,12850278
14803,PEAB4,2011-09-30,2011-11-14,6425139,6425139,12850278
14804,PEAB4,2011-12-31,2012-03-30,6425,6425,12850
14805,PEAB4,2012-03-31,2012-05-15,6425139,6425139,12850278
14806,PEAB4,2012-06-30,2012-08-14,6425139,6425139,12850278
14807,PEAB4,2012-09-30,2012-11-19,6425139,6425139,12850278
14808,PEAB4,2012-12-31,2013-03-27,6425,6425,12850
14809,PEAB4,2013-03-31,2013-05-14,6425139,6425139,12850278
14810,PEAB4,2013-06-30,2013-08-13,6425139,6425139,12850278
14811,PEAB4,2013-09-30,2013-12-10,6425139,6425139,12850278
14812,PEAB4,2013-12-31,2014-03-31,6425,6425,12850
14813,PEAB4,2014-03-31,2014-05-14,6425139,6425139,12850278
14814,PEAB4,2014-06-30,2014-08-12,6425139,6425139,12850278
14815,PEAB4,2014-09-30,2014-11-12,6425139,6425139,12850278
14816,PEAB4,2014-12-31,2015-03-27,6425,6425,12850
14817,PEAB4,2015-03-31,2015-05-12,6425139,6425139,12850278
14818,PEAB4,2015-06-30,2015-08-12,6425139,6425139,12850278
14819,PEAB4,2015-09-30,2015-11-12,6425139,6425139,12850278
14820,PEAB4,2015-12-31,2016-03-29,6425,6425,12850
14821,PEAB4,2016-03-31,2016-05-11,6425139,6425139,12850278
14822,PEAB4,2016-06-30,2016-08-11,6425139,6425139,12850278
14823,PEAB4,2016-09-30,2016-11-14,6425139,6425139,12850278
14824,PEAB4,2016-12-31,2017-03-28,6425,6425,12850
14825,PEAB4,2017-03-31,2017-05-12,6425139,6425139,12850278
14826,PEAB4,2017-06-30,2017-08-15,6425139,6425139,12850278
14827,PEAB4,2017-09-30,2017-11-09,6425139,6425139,12850278
14828,PEAB4,2017-12-31,2018-03-22,6425139,6425139,12850278
14829,PEAB4,2018-03-31,2018-05-10,6425139,6425139,12850278
14830,PEAB4,2018-06-30,2018-08-10,6425139,6425139,12850278
14831,PEAB4,2018-09-30,2018-11-09,6425139,6425139,12850278
14832,PEAB4,2018-12-31,2019-03-22,6425139,6425139,12850278
14833,PEAB4,2019-03-31,2019-05-15,6425139,6425139,12850278
14834,PEAB4,2019-06-30,2019-08-14,6425139,6425139,12850278
14835,PEAB4,2019-09-30,2019-11-13,6425139,6425139,12850278
14836,PEAB4,2019-12-31,2020-03-27,6425139,6425139,12850278
14837,PEAB4,2020-03-31,2020-06-23,6425139,6425139,12850278
14838,PEAB4,2020-06-30,2020-09-14,6425139,6425139,12850278
14839,PEAB4,2020-09-30,2020-11-13,6425139,6425139,12850278
14840,BRAP3,2010-12-31,2011-03-25,122523,227025,349548
14841,BRAP3,2011-03-31,2011-05-13,122523,227025,349548
14842,BRAP3,2011-06-30,2011-08-12,122523,227025,349548
14843,BRAP3,2011-09-30,2011-11-14,122523,227025,349548
14844,BRAP3,2011-12-31,2012-03-16,122523,227025,349548
14845,BRAP3,2012-03-31,2012-05-15,122523,227025,349548
14846,BRAP3,2012-06-30,2012-08-14,122523,227025,349548
14847,BRAP3,2012-09-30,2012-11-14,122523,227025,349548
14848,BRAP3,2012-12-31,2013-03-20,122523,227025,349548
14849,BRAP3,2013-03-31,2013-05-15,122523,227025,349548
14850,BRAP3,2013-06-30,2013-08-14,122523,227025,349548
14851,BRAP3,2013-09-30,2013-11-14,122523,227025,349548
14852,BRAP3,2013-12-31,2014-03-20,122523,227025,349548
14853,BRAP3,2014-03-31,2014-05-15,122523,227025,349548
14854,BRAP3,2014-06-30,2014-08-14,122523,227025,349548
14855,BRAP3,2014-09-30,2014-11-12,122523,227025,349548
14856,BRAP3,2014-12-31,2015-03-19,122523,227025,349548
14857,BRAP3,2015-03-31,2015-05-13,122523,227025,349548
14858,BRAP3,2015-06-30,2015-08-12,122523,227025,349548
14859,BRAP3,2015-09-30,2015-11-12,122523,227025,349548
14860,BRAP3,2015-12-31,2016-03-21,122523,227025,349548
14861,BRAP3,2016-03-31,2016-05-12,122523,227025,349548
14862,BRAP3,2016-06-30,2016-08-12,122523,227025,349548
14863,BRAP3,2016-09-30,2016-11-11,122523,227025,349548
14864,BRAP3,2016-12-31,2017-03-21,122523,227025,349548
14865,BRAP3,2017-03-31,2017-05-12,122523,227025,349548
14866,BRAP3,2017-06-30,2017-08-11,122523,227025,349548
14867,BRAP3,2017-09-30,2017-11-13,122523,227025,349548
14868,BRAP3,2017-12-31,2018-03-21,122523,227025,349548
14869,BRAP3,2018-03-31,2018-05-14,122523,227025,349548
14870,BRAP3,2018-06-30,2018-08-13,122171,225863,348034
14871,BRAP3,2018-09-30,2018-11-13,122171,225863,348034
14872,BRAP3,2018-12-31,2019-03-28,122171,225863,348034
14873,BRAP3,2019-03-31,2019-05-14,122171,225863,348034
14874,BRAP3,2019-06-30,2019-08-13,122171,225863,348034
14875,BRAP3,2019-09-30,2019-11-13,122171,225863,348034
14876,BRAP3,2019-12-31,2020-03-26,122171,225863,348034
14877,BRAP3,2020-03-31,2020-05-14,122171,225863,348034
14878,BRAP3,2020-06-30,2020-08-13,122171,225863,348034
14879,BRAP3,2020-09-30,2020-11-12,122171,225863,348034
14880,BRAP3,2020-12-31,2021-03-25,122171,225863,348034
14881,BRAP4,2010-12-31,2011-03-25,122523,227025,349548
14882,BRAP4,2011-03-31,2011-05-13,122523,227025,349548
14883,BRAP4,2011-06-30,2011-08-12,122523,227025,349548
14884,BRAP4,2011-09-30,2011-11-14,122523,227025,349548
14885,BRAP4,2011-12-31,2012-03-16,122523,227025,349548
14886,BRAP4,2012-03-31,2012-05-15,122523,227025,349548
14887,BRAP4,2012-06-30,2012-08-14,122523,227025,349548
14888,BRAP4,2012-09-30,2012-11-14,122523,227025,349548
14889,BRAP4,2012-12-31,2013-03-20,122523,227025,349548
14890,BRAP4,2013-03-31,2013-05-15,122523,227025,349548
14891,BRAP4,2013-06-30,2013-08-14,122523,227025,349548
14892,BRAP4,2013-09-30,2013-11-14,122523,227025,349548
14893,BRAP4,2013-12-31,2014-03-20,122523,227025,349548
14894,BRAP4,2014-03-31,2014-05-15,122523,227025,349548
14895,BRAP4,2014-06-30,2014-08-14,122523,227025,349548
14896,BRAP4,2014-09-30,2014-11-12,122523,227025,349548
14897,BRAP4,2014-12-31,2015-03-19,122523,227025,349548
14898,BRAP4,2015-03-31,2015-05-13,122523,227025,349548
14899,BRAP4,2015-06-30,2015-08-12,122523,227025,349548
14900,BRAP4,2015-09-30,2015-11-12,122523,227025,349548
14901,BRAP4,2015-12-31,2016-03-21,122523,227025,349548
14902,BRAP4,2016-03-31,2016-05-12,122523,227025,349548
14903,BRAP4,2016-06-30,2016-08-12,122523,227025,349548
14904,BRAP4,2016-09-30,2016-11-11,122523,227025,349548
14905,BRAP4,2016-12-31,2017-03-21,122523,227025,349548
14906,BRAP4,2017-03-31,2017-05-12,122523,227025,349548
14907,BRAP4,2017-06-30,2017-08-11,122523,227025,349548
14908,BRAP4,2017-09-30,2017-11-13,122523,227025,349548
14909,BRAP4,2017-12-31,2018-03-21,122523,227025,349548
14910,BRAP4,2018-03-31,2018-05-14,122523,227025,349548
14911,BRAP4,2018-06-30,2018-08-13,122171,225863,348034
14912,BRAP4,2018-09-30,2018-11-13,122171,225863,348034
14913,BRAP4,2018-12-31,2019-03-28,122171,225863,348034
14914,BRAP4,2019-03-31,2019-05-14,122171,225863,348034
14915,BRAP4,2019-06-30,2019-08-13,122171,225863,348034
14916,BRAP4,2019-09-30,2019-11-13,122171,225863,348034
14917,BRAP4,2019-12-31,2020-03-26,122171,225863,348034
14918,BRAP4,2020-03-31,2020-05-14,122171,225863,348034
14919,BRAP4,2020-06-30,2020-08-13,122171,225863,348034
14920,BRAP4,2020-09-30,2020-11-12,122171,225863,348034
14921,BRAP4,2020-12-31,2021-03-25,122171,225863,348034
14922,IVPR3B,2010-12-31,2011-03-30,91099784,182199568,273299352
14923,IVPR3B,2011-03-31,2011-05-15,91099784,182199568,273299352
14924,IVPR3B,2011-06-30,2011-08-12,91099784,182199568,273299352
14925,IVPR3B,2011-09-30,2011-11-11,94744746,189489492,284234238
14926,IVPR3B,2011-12-31,2012-03-29,99229,198459,297688
14927,IVPR3B,2012-03-31,2012-05-15,143057124,286114248,429171372
14928,IVPR3B,2012-06-30,2012-08-15,143057124,286114248,429171372
14929,IVPR3B,2012-09-30,2012-11-14,143057124,286114248,429171372
14930,IVPR3B,2012-12-31,2013-03-27,143057,286114,429171
14931,IVPR3B,2013-03-31,2013-05-20,143057124,286114248,429171372
14932,IVPR3B,2013-06-30,2013-08-13,143057124,286114248,429171372
14933,IVPR3B,2013-09-30,2013-11-11,143057124,286114248,429171372
14934,IVPR3B,2013-12-31,2014-05-26,143057,286114,429171
14935,IVPR3B,2014-03-31,2014-05-20,143057124,286114248,429171372
14936,IVPR3B,2014-06-30,2014-08-14,143057124,286114248,429171372
14937,IVPR3B,2014-09-30,2014-11-14,143057124,286114248,429171372
14938,IVPR3B,2014-12-31,2015-03-30,143057124,286114248,429171372
14939,IVPR3B,2015-03-31,2015-05-15,143057124,286114248,429171372
14940,IVPR3B,2015-06-30,2015-12-18,143057124,286114248,429171372
14941,IVPR3B,2015-09-30,2015-11-13,143057124,286114248,429171372
14942,IVPR3B,2015-12-31,2016-04-27,143057124,286114248,429171372
14943,IVPR3B,2016-03-31,2016-05-13,143057124,286114248,429171372
14944,IVPR3B,2016-06-30,2016-08-16,143057124,286114248,429171372
14945,IVPR3B,2016-09-30,2016-11-12,143057124,286114248,429171372
14946,IVPR3B,2016-12-31,2018-03-08,143057124,286114248,429171372
14947,IVPR3B,2017-03-31,2017-05-15,143057124,286114248,429171372
14948,IVPR3B,2017-06-30,2017-08-14,143057124,286114248,429171372
14949,IVPR3B,2017-09-30,2017-11-14,143057124,286114248,429171372
14950,IVPR3B,2017-12-31,2018-03-20,143057124,286114248,429171372
14951,IVPR3B,2018-03-31,2018-05-11,143057124,286114248,429171372
14952,IVPR3B,2018-06-30,2018-08-09,143057124,286114248,429171372
14953,IVPR3B,2018-09-30,2018-11-08,143057124,286114248,429171372
14954,IVPR3B,2018-12-31,2019-03-28,143057124,286114248,429171372
14955,IVPR3B,2019-03-31,2019-05-15,143057124,286114248,429171372
14956,IVPR3B,2019-06-30,2019-08-12,143057124,286114248,429171372
14957,IVPR3B,2019-09-30,2019-11-14,143057124,286114248,429171372
14958,IVPR3B,2019-12-31,2020-03-24,143057124,286114248,429171372
14959,IVPR3B,2020-03-31,2020-06-26,143057124,286114248,429171372
14960,IVPR3B,2020-06-30,2020-08-12,143057124,286114248,429171372
14961,IVPR3B,2020-09-30,2020-11-12,143057124,286114248,429171372
14962,IVPR4B,2010-12-31,2011-03-30,91099784,182199568,273299352
14963,IVPR4B,2011-03-31,2011-05-15,91099784,182199568,273299352
14964,IVPR4B,2011-06-30,2011-08-12,91099784,182199568,273299352
14965,IVPR4B,2011-09-30,2011-11-11,94744746,189489492,284234238
14966,IVPR4B,2011-12-31,2012-03-29,99229,198459,297688
14967,IVPR4B,2012-03-31,2012-05-15,143057124,286114248,429171372
14968,IVPR4B,2012-06-30,2012-08-15,143057124,286114248,429171372
14969,IVPR4B,2012-09-30,2012-11-14,143057124,286114248,429171372
14970,IVPR4B,2012-12-31,2013-03-27,143057,286114,429171
14971,IVPR4B,2013-03-31,2013-05-20,143057124,286114248,429171372
14972,IVPR4B,2013-06-30,2013-08-13,143057124,286114248,429171372
14973,IVPR4B,2013-09-30,2013-11-11,143057124,286114248,429171372
14974,IVPR4B,2013-12-31,2014-05-26,143057,286114,429171
14975,IVPR4B,2014-03-31,2014-05-20,143057124,286114248,429171372
14976,IVPR4B,2014-06-30,2014-08-14,143057124,286114248,429171372
14977,IVPR4B,2014-09-30,2014-11-14,143057124,286114248,429171372
14978,IVPR4B,2014-12-31,2015-03-30,143057124,286114248,429171372
14979,IVPR4B,2015-03-31,2015-05-15,143057124,286114248,429171372
14980,IVPR4B,2015-06-30,2015-12-18,143057124,286114248,429171372
14981,IVPR4B,2015-09-30,2015-11-13,143057124,286114248,429171372
14982,IVPR4B,2015-12-31,2016-04-27,143057124,286114248,429171372
14983,IVPR4B,2016-03-31,2016-05-13,143057124,286114248,429171372
14984,IVPR4B,2016-06-30,2016-08-16,143057124,286114248,429171372
14985,IVPR4B,2016-09-30,2016-11-12,143057124,286114248,429171372
14986,IVPR4B,2016-12-31,2018-03-08,143057124,286114248,429171372
14987,IVPR4B,2017-03-31,2017-05-15,143057124,286114248,429171372
14988,IVPR4B,2017-06-30,2017-08-14,143057124,286114248,429171372
14989,IVPR4B,2017-09-30,2017-11-14,143057124,286114248,429171372
14990,IVPR4B,2017-12-31,2018-03-20,143057124,286114248,429171372
14991,IVPR4B,2018-03-31,2018-05-11,143057124,286114248,429171372
14992,IVPR4B,2018-06-30,2018-08-09,143057124,286114248,429171372
14993,IVPR4B,2018-09-30,2018-11-08,143057124,286114248,429171372
14994,IVPR4B,2018-12-31,2019-03-28,143057124,286114248,429171372
14995,IVPR4B,2019-03-31,2019-05-15,143057124,286114248,429171372
14996,IVPR4B,2019-06-30,2019-08-12,143057124,286114248,429171372
14997,IVPR4B,2019-09-30,2019-11-14,143057124,286114248,429171372
14998,IVPR4B,2019-12-31,2020-03-24,143057124,286114248,429171372
14999,IVPR4B,2020-03-31,2020-06-26,143057124,286114248,429171372
15000,IVPR4B,2020-06-30,2020-08-12,143057124,286114248,429171372
15001,IVPR4B,2020-09-30,2020-11-12,143057124,286114248,429171372
15002,CCRO3,2010-12-31,2011-03-17,441396800,0,441396800
15003,CCRO3,2011-03-31,2011-05-16,441396800,0,441396800
15004,CCRO3,2011-06-30,2011-08-11,441396800,0,441396800
15005,CCRO3,2011-09-30,2011-11-10,441396800,0,441396800
15006,CCRO3,2011-12-31,2012-03-07,1765587200,0,1765587200
15007,CCRO3,2012-03-31,2012-05-15,1765587200,0,1765587200
15008,CCRO3,2012-06-30,2012-08-13,1765587200,0,1765587200
15009,CCRO3,2012-09-30,2012-11-13,1765587200,0,1765587200
15010,CCRO3,2012-12-31,2013-03-18,1765587200,0,1765587200
15011,CCRO3,2013-03-31,2013-05-14,1765587200,0,1765587200
15012,CCRO3,2013-06-30,2013-08-12,1765587200,0,1765587200
15013,CCRO3,2013-09-30,2013-10-28,1765587200,0,1765587200
15014,CCRO3,2013-12-31,2014-03-12,1765587200,0,1765587200
15015,CCRO3,2014-03-31,2014-05-12,1765587200,0,1765587200
15016,CCRO3,2014-06-30,2014-08-11,1765587200,0,1765587200
15017,CCRO3,2014-09-30,2014-10-28,1765587200,0,1765587200
15018,CCRO3,2014-12-31,2015-04-02,1765587200,0,1765587200
15019,CCRO3,2015-03-31,2015-05-14,1765587200,0,1765587200
15020,CCRO3,2015-06-30,2015-08-10,1765587200,0,1765587200
15021,CCRO3,2015-09-30,2015-10-27,1765587200,0,1765587200
15022,CCRO3,2015-12-31,2016-02-25,1765587200,0,1765587200
15023,CCRO3,2016-03-31,2016-05-10,1765587200,0,1765587200
15024,CCRO3,2016-06-30,2016-08-11,1765587200,0,1765587200
15025,CCRO3,2016-09-30,2016-11-03,1765587200,0,1765587200
15026,CCRO3,2016-12-31,2017-03-06,1765587200,0,1765587200
15027,CCRO3,2017-03-31,2017-05-11,2020000000,0,2020000000
15028,CCRO3,2017-06-30,2017-08-14,2020000000,0,2020000000
15029,CCRO3,2017-09-30,2017-10-26,2020000000,0,2020000000
15030,CCRO3,2017-12-31,2018-02-27,2020000000,0,2020000000
15031,CCRO3,2018-03-31,2018-05-10,2020000000,0,2020000000
15032,CCRO3,2018-06-30,2018-08-14,2020000000,0,2020000000
15033,CCRO3,2018-09-30,2018-10-25,2020000000,0,2020000000
15034,CCRO3,2018-12-31,2019-03-21,2020000000,0,2020000000
15035,CCRO3,2019-03-31,2019-04-29,2020000000,0,2020000000
15036,CCRO3,2019-06-30,2019-08-08,2020000000,0,2020000000
15037,CCRO3,2019-09-30,2019-10-28,2020000000,0,2020000000
15038,CCRO3,2019-12-31,2020-03-05,2020000000,0,2020000000
15039,CCRO3,2020-03-31,2020-05-14,2020000000,0,2020000000
15040,CCRO3,2020-06-30,2020-08-13,2020000000,0,2020000000
15041,CCRO3,2020-09-30,2020-11-11,2020000000,0,2020000000
15042,CCRO3,2020-12-31,2021-03-04,2020000000,0,2020000000
15043,TIET11,2010-12-31,2011-03-28,600000001,50000007,650000008
15044,TIET11,2011-03-31,2011-05-12,600000,50000,650000
15045,TIET11,2011-06-30,2011-08-11,600000,50000,650000
15046,TIET11,2011-09-30,2011-11-10,600000,50000,650000
15047,TIET11,2011-12-31,2012-03-14,600000,50000,650000
15048,TIET11,2012-03-31,2012-05-10,600000,50000,650000
15049,TIET11,2012-06-30,2012-09-18,600000,50000,650000
15050,TIET11,2012-09-30,2012-11-07,600000,50000,650000
15051,TIET11,2012-12-31,2013-02-28,600000,50000,650000
15052,TIET11,2013-03-31,2013-05-10,600000,50000,650000
15053,TIET11,2013-06-30,2013-08-09,600000,50000,650000
15054,TIET11,2013-09-30,2013-11-08,300000,350000,650000
15055,TIET11,2013-12-31,2014-02-28,600000,50000,650000
15056,TIET11,2014-03-31,2014-05-07,600000,50000,650000
15057,TIET11,2014-06-30,2014-08-06,600000,50000,650000
15058,TIET11,2014-09-30,2014-11-06,600000,50000,650000
15059,TIET11,2014-12-31,2015-02-25,600000,50000,650000
15060,TIET11,2015-03-31,2015-05-08,600000,50000,650000
15061,TIET11,2015-06-30,2015-08-07,600000,50000,650000
15062,TIET11,2015-09-30,2015-11-04,600000,50000,650000
15063,TIET11,2015-12-31,2016-02-24,751094,1155174,1906268
15064,TIET11,2016-03-31,2016-05-06,751094,1155174,1906268
15065,TIET11,2016-06-30,2016-08-04,751094,1155174,1906268
15066,TIET11,2016-09-30,2016-11-03,775175,1192210,1967385
15067,TIET11,2016-12-31,2017-02-24,775175,1192210,1967385
15068,TIET11,2017-03-31,2017-05-05,775175,1192210,1967385
15069,TIET11,2017-06-30,2017-08-07,775175,1192210,1967385
15070,TIET11,2017-09-30,2017-11-01,775144,1192089,1967233
15071,TIET11,2017-12-31,2018-02-27,775155,1192131,1967286
15072,TIET11,2018-03-31,2018-05-07,775175,1192210,1967385
15073,TIET11,2018-06-30,2018-08-06,775175,1192210,1967385
15074,TIET11,2018-09-30,2018-11-05,775175,1192210,1967385
15075,TIET11,2018-12-31,2019-02-26,775175,1192210,1967385
15076,TIET11,2019-03-31,2019-05-06,775175,1192210,1967385
15077,TIET11,2019-06-30,2019-08-05,775175,1192210,1967385
15078,TIET11,2019-09-30,2019-11-05,786265,1209267,1995532
15079,TIET11,2019-12-31,2020-02-29,786265,1209267,1995532
15080,TIET11,2020-03-31,2020-05-07,786265,1209267,1995532
15081,TIET11,2020-06-30,2020-08-05,786265,1209267,1995532
15082,TIET11,2020-09-30,2020-11-05,786265,1209267,1995532
15083,TIET11,2020-12-31,2021-03-11,786265,1209267,1995532
15084,TIET3,2010-12-31,2011-03-28,600000001,50000007,650000008
15085,TIET3,2011-03-31,2011-05-12,600000,50000,650000
15086,TIET3,2011-06-30,2011-08-11,600000,50000,650000
15087,TIET3,2011-09-30,2011-11-10,600000,50000,650000
15088,TIET3,2011-12-31,2012-03-14,600000,50000,650000
15089,TIET3,2012-03-31,2012-05-10,600000,50000,650000
15090,TIET3,2012-06-30,2012-09-18,600000,50000,650000
15091,TIET3,2012-09-30,2012-11-07,600000,50000,650000
15092,TIET3,2012-12-31,2013-02-28,600000,50000,650000
15093,TIET3,2013-03-31,2013-05-10,600000,50000,650000
15094,TIET3,2013-06-30,2013-08-09,600000,50000,650000
15095,TIET3,2013-09-30,2013-11-08,300000,350000,650000
15096,TIET3,2013-12-31,2014-02-28,600000,50000,650000
15097,TIET3,2014-03-31,2014-05-07,600000,50000,650000
15098,TIET3,2014-06-30,2014-08-06,600000,50000,650000
15099,TIET3,2014-09-30,2014-11-06,600000,50000,650000
15100,TIET3,2014-12-31,2015-02-25,600000,50000,650000
15101,TIET3,2015-03-31,2015-05-08,600000,50000,650000
15102,TIET3,2015-06-30,2015-08-07,600000,50000,650000
15103,TIET3,2015-09-30,2015-11-04,600000,50000,650000
15104,TIET3,2015-12-31,2016-02-24,751094,1155174,1906268
15105,TIET3,2016-03-31,2016-05-06,751094,1155174,1906268
15106,TIET3,2016-06-30,2016-08-04,751094,1155174,1906268
15107,TIET3,2016-09-30,2016-11-03,775175,1192210,1967385
15108,TIET3,2016-12-31,2017-02-24,775175,1192210,1967385
15109,TIET3,2017-03-31,2017-05-05,775175,1192210,1967385
15110,TIET3,2017-06-30,2017-08-07,775175,1192210,1967385
15111,TIET3,2017-09-30,2017-11-01,775144,1192089,1967233
15112,TIET3,2017-12-31,2018-02-27,775155,1192131,1967286
15113,TIET3,2018-03-31,2018-05-07,775175,1192210,1967385
15114,TIET3,2018-06-30,2018-08-06,775175,1192210,1967385
15115,TIET3,2018-09-30,2018-11-05,775175,1192210,1967385
15116,TIET3,2018-12-31,2019-02-26,775175,1192210,1967385
15117,TIET3,2019-03-31,2019-05-06,775175,1192210,1967385
15118,TIET3,2019-06-30,2019-08-05,775175,1192210,1967385
15119,TIET3,2019-09-30,2019-11-05,786265,1209267,1995532
15120,TIET3,2019-12-31,2020-02-29,786265,1209267,1995532
15121,TIET3,2020-03-31,2020-05-07,786265,1209267,1995532
15122,TIET3,2020-06-30,2020-08-05,786265,1209267,1995532
15123,TIET3,2020-09-30,2020-11-05,786265,1209267,1995532
15124,TIET3,2020-12-31,2021-03-11,786265,1209267,1995532
15125,TIET4,2010-12-31,2011-03-28,600000001,50000007,650000008
15126,TIET4,2011-03-31,2011-05-12,600000,50000,650000
15127,TIET4,2011-06-30,2011-08-11,600000,50000,650000
15128,TIET4,2011-09-30,2011-11-10,600000,50000,650000
15129,TIET4,2011-12-31,2012-03-14,600000,50000,650000
15130,TIET4,2012-03-31,2012-05-10,600000,50000,650000
15131,TIET4,2012-06-30,2012-09-18,600000,50000,650000
15132,TIET4,2012-09-30,2012-11-07,600000,50000,650000
15133,TIET4,2012-12-31,2013-02-28,600000,50000,650000
15134,TIET4,2013-03-31,2013-05-10,600000,50000,650000
15135,TIET4,2013-06-30,2013-08-09,600000,50000,650000
15136,TIET4,2013-09-30,2013-11-08,300000,350000,650000
15137,TIET4,2013-12-31,2014-02-28,600000,50000,650000
15138,TIET4,2014-03-31,2014-05-07,600000,50000,650000
15139,TIET4,2014-06-30,2014-08-06,600000,50000,650000
15140,TIET4,2014-09-30,2014-11-06,600000,50000,650000
15141,TIET4,2014-12-31,2015-02-25,600000,50000,650000
15142,TIET4,2015-03-31,2015-05-08,600000,50000,650000
15143,TIET4,2015-06-30,2015-08-07,600000,50000,650000
15144,TIET4,2015-09-30,2015-11-04,600000,50000,650000
15145,TIET4,2015-12-31,2016-02-24,751094,1155174,1906268
15146,TIET4,2016-03-31,2016-05-06,751094,1155174,1906268
15147,TIET4,2016-06-30,2016-08-04,751094,1155174,1906268
15148,TIET4,2016-09-30,2016-11-03,775175,1192210,1967385
15149,TIET4,2016-12-31,2017-02-24,775175,1192210,1967385
15150,TIET4,2017-03-31,2017-05-05,775175,1192210,1967385
15151,TIET4,2017-06-30,2017-08-07,775175,1192210,1967385
15152,TIET4,2017-09-30,2017-11-01,775144,1192089,1967233
15153,TIET4,2017-12-31,2018-02-27,775155,1192131,1967286
15154,TIET4,2018-03-31,2018-05-07,775175,1192210,1967385
15155,TIET4,2018-06-30,2018-08-06,775175,1192210,1967385
15156,TIET4,2018-09-30,2018-11-05,775175,1192210,1967385
15157,TIET4,2018-12-31,2019-02-26,775175,1192210,1967385
15158,TIET4,2019-03-31,2019-05-06,775175,1192210,1967385
15159,TIET4,2019-06-30,2019-08-05,775175,1192210,1967385
15160,TIET4,2019-09-30,2019-11-05,786265,1209267,1995532
15161,TIET4,2019-12-31,2020-02-29,786265,1209267,1995532
15162,TIET4,2020-03-31,2020-05-07,786265,1209267,1995532
15163,TIET4,2020-06-30,2020-08-05,786265,1209267,1995532
15164,TIET4,2020-09-30,2020-11-05,786265,1209267,1995532
15165,TIET4,2020-12-31,2021-03-11,786265,1209267,1995532
15166,ATMP3,2010-12-31,2011-03-24,23089600,36681000,59770600
15167,ATMP3,2011-03-31,2011-04-27,23089600,36681000,59770600
15168,ATMP3,2011-06-30,2011-08-03,23089600,36681000,59770600
15169,ATMP3,2011-09-30,2011-12-12,24966582,39719499,64686081
15170,ATMP3,2011-12-31,2012-03-10,24966582,39719499,64686081
15171,ATMP3,2012-03-31,2012-04-26,24966582,39719499,64686081
15172,ATMP3,2012-06-30,2012-07-25,24966582,39719499,64686081
15173,ATMP3,2012-09-30,2012-10-24,24966582,39719499,64686081
15174,ATMP3,2012-12-31,2013-02-26,24966582,39719499,64686081
15175,ATMP3,2013-03-31,2013-05-02,24966582,39719499,64686081
15176,ATMP3,2013-06-30,2013-08-08,119957883,225809987,345767870
15177,ATMP3,2013-09-30,2013-10-31,119957883,225809987,345767870
15178,ATMP3,2013-12-31,2014-02-24,119725707,226042163,345767870
15179,ATMP3,2014-03-31,2014-05-09,119725707,226042163,345767870
15180,ATMP3,2014-06-30,2014-08-14,119725707,226042163,345767870
15181,ATMP3,2014-09-30,2014-11-13,119725707,226042163,345767870
15182,ATMP3,2014-12-31,2015-03-06,119725707,226042163,345767870
15183,ATMP3,2015-03-31,2015-05-14,119725707,226042163,345767870
15184,ATMP3,2015-06-30,2015-08-14,119725707,226042163,345767870
15185,ATMP3,2015-09-30,2015-11-15,118357576,220569639,338927215
15186,ATMP3,2015-12-31,2016-03-24,119725707,226042163,345767870
15187,ATMP3,2016-03-31,2016-05-24,119725707,226042163,345767870
15188,ATMP3,2016-06-30,2016-08-11,3457678,0,3457678
15189,ATMP3,2016-09-30,2016-11-10,3457678,0,3457678
15190,ATMP3,2016-12-31,2017-03-17,4185596,0,4185596
15191,ATMP3,2017-03-31,2017-05-11,4185596,0,4185596
15192,ATMP3,2017-06-30,2017-08-15,4185596,0,4185596
15193,ATMP3,2017-09-30,2017-11-14,4185596,0,4185596
15194,ATMP3,2017-12-31,2018-03-22,4185596,0,4185596
15195,ATMP3,2018-03-31,2018-05-10,4185596,0,4185596
15196,ATMP3,2018-06-30,2018-08-14,7457603,0,7457603
15197,ATMP3,2018-09-30,2018-11-13,11009412,0,11009412
15198,ATMP3,2018-12-31,2019-03-12,15727661,0,15727661
15199,ATMP3,2019-03-31,2019-05-15,21967447,0,21967447
15200,ATMP3,2019-06-30,2019-08-13,83954451,0,83954451
15201,ATMP3,2019-09-30,2019-11-13,2798048,0,2798048
15202,ATMP3,2019-12-31,2020-03-19,2812644,0,2812644
15203,ATMP3,2020-03-31,2020-06-30,23458943,0,23458943
15204,ATMP3,2020-06-30,2020-08-27,23458943,0,23458943
15205,ATMP3,2020-09-30,2020-11-16,23458943,0,23458943
15206,ATMP3,2020-12-31,2021-03-09,24669930,0,24669930
15207,LIQO3,2010-12-31,2011-03-24,23089600,36681000,59770600
15208,LIQO3,2011-03-31,2011-04-27,23089600,36681000,59770600
15209,LIQO3,2011-06-30,2011-08-03,23089600,36681000,59770600
15210,LIQO3,2011-09-30,2011-12-12,24966582,39719499,64686081
15211,LIQO3,2011-12-31,2012-03-10,24966582,39719499,64686081
15212,LIQO3,2012-03-31,2012-04-26,24966582,39719499,64686081
15213,LIQO3,2012-06-30,2012-07-25,24966582,39719499,64686081
15214,LIQO3,2012-09-30,2012-10-24,24966582,39719499,64686081
15215,LIQO3,2012-12-31,2013-02-26,24966582,39719499,64686081
15216,LIQO3,2013-03-31,2013-05-02,24966582,39719499,64686081
15217,LIQO3,2013-06-30,2013-08-08,119957883,225809987,345767870
15218,LIQO3,2013-09-30,2013-10-31,119957883,225809987,345767870
15219,LIQO3,2013-12-31,2014-02-24,119725707,226042163,345767870
15220,LIQO3,2014-03-31,2014-05-09,119725707,226042163,345767870
15221,LIQO3,2014-06-30,2014-08-14,119725707,226042163,345767870
15222,LIQO3,2014-09-30,2014-11-13,119725707,226042163,345767870
15223,LIQO3,2014-12-31,2015-03-06,119725707,226042163,345767870
15224,LIQO3,2015-03-31,2015-05-14,119725707,226042163,345767870
15225,LIQO3,2015-06-30,2015-08-14,119725707,226042163,345767870
15226,LIQO3,2015-09-30,2015-11-15,118357576,220569639,338927215
15227,LIQO3,2015-12-31,2016-03-24,119725707,226042163,345767870
15228,LIQO3,2016-03-31,2016-05-24,119725707,226042163,345767870
15229,LIQO3,2016-06-30,2016-08-11,3457678,0,3457678
15230,LIQO3,2016-09-30,2016-11-10,3457678,0,3457678
15231,LIQO3,2016-12-31,2017-03-17,4185596,0,4185596
15232,LIQO3,2017-03-31,2017-05-11,4185596,0,4185596
15233,LIQO3,2017-06-30,2017-08-15,4185596,0,4185596
15234,LIQO3,2017-09-30,2017-11-14,4185596,0,4185596
15235,LIQO3,2017-12-31,2018-03-22,4185596,0,4185596
15236,LIQO3,2018-03-31,2018-05-10,4185596,0,4185596
15237,LIQO3,2018-06-30,2018-08-14,7457603,0,7457603
15238,LIQO3,2018-09-30,2018-11-13,11009412,0,11009412
15239,LIQO3,2018-12-31,2019-03-12,15727661,0,15727661
15240,LIQO3,2019-03-31,2019-05-15,21967447,0,21967447
15241,LIQO3,2019-06-30,2019-08-13,83954451,0,83954451
15242,LIQO3,2019-09-30,2019-11-13,2798048,0,2798048
15243,LIQO3,2019-12-31,2020-03-19,2812644,0,2812644
15244,LIQO3,2020-03-31,2020-06-30,23458943,0,23458943
15245,LIQO3,2020-06-30,2020-08-27,23458943,0,23458943
15246,LIQO3,2020-09-30,2020-11-16,23458943,0,23458943
15247,LIQO3,2020-12-31,2021-03-09,24669930,0,24669930
15248,CABI3B,2010-12-31,2011-03-24,281930,545100,827030
15249,CABI3B,2011-03-31,2011-05-17,281930,545100,827030
15250,CABI3B,2011-06-30,2011-08-12,298263,577767,876030
15251,CABI3B,2011-09-30,2011-11-11,298263,577767,876030
15252,CABI3B,2011-12-31,2012-03-28,1333,2667,4000
15253,CABI3B,2012-03-31,2012-05-16,1333,2667,4000
15254,CABI3B,2012-06-30,2012-08-13,1333,2667,4000
15255,CABI3B,2012-09-30,2012-11-14,1333,2667,4000
15256,CABI3B,2012-12-31,2013-03-27,1333,2667,4000
15257,CABI3B,2013-03-31,2013-05-13,1333,2667,4000
15258,CABI3B,2013-06-30,2013-08-14,67999,136001,204000
15259,CABI3B,2013-09-30,2013-11-12,67999,136001,204000
15260,CABI3B,2013-12-31,2014-03-28,67999,136001,204000
15261,CABI3B,2014-03-31,2014-05-15,67999,136001,204000
15262,CABI3B,2014-06-30,2014-08-14,84667,169333,254000
15263,CABI3B,2014-09-30,2014-11-13,2168000,4336000,6504000
15264,CABI3B,2014-12-31,2015-03-27,2168000,4336000,6504000
15265,CABI3B,2015-03-31,2015-05-14,2168000,4336000,6504000
15266,CABI3B,2015-06-30,2015-08-14,2168000,4336000,6504000
15267,CABI3B,2015-09-30,2015-11-13,2201333,4402667,6604000
15268,CABI3B,2015-12-31,2016-03-22,2201333,4402667,6604000
15269,CABI3B,2016-03-31,2016-05-11,2201333,4402667,6604000
15270,CABI3B,2016-06-30,2016-08-10,2201333,4402667,6604000
15271,CABI3B,2016-09-30,2016-11-09,2368000,4736000,7104000
15272,CABI3B,2016-12-31,2017-03-16,2368000,4736000,7104000
15273,CABI3B,2017-03-31,2017-05-12,2368000,4736000,7104000
15274,CABI3B,2017-06-30,2017-08-07,2368000,4736000,7104000
15275,CABI3B,2017-09-30,2017-11-10,2368000,4736000,7104000
15276,CABI3B,2017-12-31,2018-03-22,2368000,4736000,7104000
15277,CABI3B,2018-03-31,2018-05-16,2368000,4736000,7104000
15278,CABI3B,2018-06-30,2018-08-14,2368000,4736000,7104000
15279,CABI3B,2018-09-30,2018-11-08,2368000,4736000,7104000
15280,CABI3B,2018-12-31,2019-03-28,2368000,4736000,7104000
15281,CABI3B,2019-03-31,2019-05-15,2368000,4736000,7104000
15282,CABI3B,2019-06-30,2019-08-14,2368000,4736000,7104000
15283,CABI3B,2019-09-30,2019-11-14,2368000,4736000,7104000
15284,CABI3B,2019-12-31,2020-03-27,2368,4736,7104
15285,CABI3B,2020-03-31,2020-05-16,2368000,4736000,7104000
15286,CABI3B,2020-06-30,2020-08-14,2368000,4736000,7104000
15287,CABI3B,2020-09-30,2020-11-13,2458000,4916000,7374000
15288,CACO3B,2010-12-31,2011-03-24,248628,497375,746003
15289,CACO3B,2011-03-31,2011-05-17,248628,497375,746003
15290,CACO3B,2011-06-30,2011-08-12,266961,534042,801003
15291,CACO3B,2011-09-30,2011-11-11,266961,534042,801003
15292,CACO3B,2011-12-31,2012-03-28,266961,534042,801003
15293,CACO3B,2012-03-31,2012-05-16,266961,534042,801003
15294,CACO3B,2012-06-30,2012-08-13,303211,606542,909753
15295,CACO3B,2012-09-30,2012-11-14,303211,606542,909753
15296,CACO3B,2012-12-31,2013-03-27,303211,606542,909753
15297,CACO3B,2013-03-31,2013-05-13,303211,606542,909753
15298,CACO3B,2013-06-30,2013-08-14,333211,666542,999753
15299,CACO3B,2013-09-30,2013-11-12,333211,666542,999753
15300,CACO3B,2013-12-31,2014-03-28,333211,666542,999753
15301,CACO3B,2014-03-31,2014-05-15,363211,726542,1089753
15302,CACO3B,2014-06-30,2014-08-14,379878,759875,1139753
15303,CACO3B,2014-09-30,2014-11-13,413211,826542,1239753
15304,CACO3B,2014-12-31,2015-03-27,413211,826542,1239753
15305,CACO3B,2015-03-31,2015-05-14,413211,826542,1239753
15306,CACO3B,2015-06-30,2015-08-14,413211,826542,1239753
15307,CACO3B,2015-09-30,2015-11-13,446544,893209,1339753
15308,CACO3B,2015-12-31,2016-03-22,446544,893209,1339753
15309,CACO3B,2016-03-31,2016-05-11,446544,893209,1339753
15310,CACO3B,2016-06-30,2016-08-10,613211,1226542,1839753
15311,CACO3B,2016-09-30,2016-11-09,613211,1226542,1839753
15312,CACO3B,2016-12-31,2017-03-16,613211,1226542,1839753
15313,CACO3B,2017-03-31,2017-05-12,613211,1226542,1839753
15314,CACO3B,2017-06-30,2017-08-14,613211,1226542,1839753
15315,CACO3B,2017-09-30,2017-11-10,613211,1226542,1839753
15316,CACO3B,2017-12-31,2018-03-22,613211,1226542,1839753
15317,CACO3B,2018-03-31,2018-05-16,613211,1226542,1839753
15318,CACO3B,2018-06-30,2018-08-14,613211,1226542,1839753
15319,CACO3B,2018-09-30,2018-11-08,613211,1226542,1839753
15320,CACO3B,2018-12-31,2019-03-28,613211,1226542,1839753
15321,CACO3B,2019-03-31,2019-05-15,613211,1226542,1839753
15322,CACO3B,2019-06-30,2019-08-14,613211,1226542,1839753
15323,CACO3B,2019-09-30,2019-11-14,613211,1226542,1839753
15324,CACO3B,2019-12-31,2020-03-27,613211,1226542,1839753
15325,CACO3B,2020-03-31,2020-05-16,6132110,12265420,18397530
15326,CACO3B,2020-06-30,2020-08-14,613211,1226542,1839753
15327,CACO3B,2020-09-30,2020-11-13,703211,1406542,2109753
15328,CRTE3B,2010-12-31,2011-04-05,48786,37680,86466
15329,CRTE3B,2011-03-31,2011-05-19,48786,37680,86466
15330,CRTE3B,2011-06-30,2011-07-29,48786,37680,86466
15331,CRTE3B,2011-09-30,2011-11-01,48786,37680,86466
15332,CRTE3B,2011-12-31,2012-03-29,48786,37680,86466
15333,CRTE3B,2012-03-31,2012-05-10,48786,37680,86466
15334,CRTE3B,2012-06-30,2012-08-01,48786,37680,86466
15335,CRTE3B,2012-09-30,2012-10-30,48786,37680,86466
15336,CRTE3B,2012-12-31,2013-03-27,48786,37680,86466
15337,CRTE3B,2013-03-31,2013-05-10,48786,37680,86466
15338,CRTE3B,2013-06-30,2013-08-08,48786,37680,86466
15339,CRTE3B,2013-09-30,2013-11-01,48786,37680,86466
15340,CRTE3B,2013-12-31,2014-02-26,48786,37680,86466
15341,CRTE3B,2014-03-31,2014-05-09,48786,37680,86466
15342,CRTE3B,2014-06-30,2014-08-14,48786,37680,86466
15343,CRTE3B,2014-09-30,2015-02-06,48786,37680,86466
15344,CRTE3B,2014-12-31,2015-04-06,48786,37680,86466
15345,CRTE3B,2015-03-31,2015-04-30,48786,37680,86466
15346,CRTE3B,2015-06-30,2015-08-07,48786,37680,86466
15347,CRTE3B,2015-09-30,2015-11-05,48786,37680,86466
15348,CRTE3B,2015-12-31,2016-03-29,48786,37680,86466
15349,CRTE3B,2016-03-31,2016-05-05,48786,37680,86466
15350,CRTE3B,2016-06-30,2016-08-12,48786,37680,86466
15351,CRTE3B,2016-09-30,2016-11-08,48786,37680,86466
15352,CRTE3B,2016-12-31,2017-03-29,48786,37680,86466
15353,CRTE3B,2017-03-31,2017-05-04,48786,37680,86466
15354,CRTE3B,2017-06-30,2017-08-01,48786,37680,86466
15355,CRTE3B,2017-09-30,2017-11-08,48786,37680,86466
15356,CRTE3B,2017-12-31,2018-03-28,48786,37680,86466
15357,CRTE3B,2018-03-31,2018-05-07,48786,37680,86466
15358,CRTE3B,2018-06-30,2018-08-06,48786,37680,86466
15359,CRTE3B,2018-09-30,2018-11-08,48786,37680,86466
15360,CRTE3B,2018-12-31,2019-03-08,48786,37680,86466
15361,CRTE3B,2019-03-31,2019-05-13,48786,37680,86466
15362,CRTE3B,2019-06-30,2019-08-07,48786,37680,86466
15363,CRTE3B,2019-09-30,2019-11-08,48786,37680,86466
15364,CRTE3B,2019-12-31,2020-03-13,48786,37680,86466
15365,CRTE3B,2020-03-31,2020-05-04,48786,37680,86466
15366,CRTE3B,2020-06-30,2020-08-06,48786,37680,86466
15367,CRTE3B,2020-09-30,2020-11-05,48786,37680,86466
15368,CRTE3B,2020-12-31,2021-02-12,48786,37680,86466
15369,CRTE5B,2010-12-31,2011-04-05,48786,37680,86466
15370,CRTE5B,2011-03-31,2011-05-19,48786,37680,86466
15371,CRTE5B,2011-06-30,2011-07-29,48786,37680,86466
15372,CRTE5B,2011-09-30,2011-11-01,48786,37680,86466
15373,CRTE5B,2011-12-31,2012-03-29,48786,37680,86466
15374,CRTE5B,2012-03-31,2012-05-10,48786,37680,86466
15375,CRTE5B,2012-06-30,2012-08-01,48786,37680,86466
15376,CRTE5B,2012-09-30,2012-10-30,48786,37680,86466
15377,CRTE5B,2012-12-31,2013-03-27,48786,37680,86466
15378,CRTE5B,2013-03-31,2013-05-10,48786,37680,86466
15379,CRTE5B,2013-06-30,2013-08-08,48786,37680,86466
15380,CRTE5B,2013-09-30,2013-11-01,48786,37680,86466
15381,CRTE5B,2013-12-31,2014-02-26,48786,37680,86466
15382,CRTE5B,2014-03-31,2014-05-09,48786,37680,86466
15383,CRTE5B,2014-06-30,2014-08-14,48786,37680,86466
15384,CRTE5B,2014-09-30,2015-02-06,48786,37680,86466
15385,CRTE5B,2014-12-31,2015-04-06,48786,37680,86466
15386,CRTE5B,2015-03-31,2015-04-30,48786,37680,86466
15387,CRTE5B,2015-06-30,2015-08-07,48786,37680,86466
15388,CRTE5B,2015-09-30,2015-11-05,48786,37680,86466
15389,CRTE5B,2015-12-31,2016-03-29,48786,37680,86466
15390,CRTE5B,2016-03-31,2016-05-05,48786,37680,86466
15391,CRTE5B,2016-06-30,2016-08-12,48786,37680,86466
15392,CRTE5B,2016-09-30,2016-11-08,48786,37680,86466
15393,CRTE5B,2016-12-31,2017-03-29,48786,37680,86466
15394,CRTE5B,2017-03-31,2017-05-04,48786,37680,86466
15395,CRTE5B,2017-06-30,2017-08-01,48786,37680,86466
15396,CRTE5B,2017-09-30,2017-11-08,48786,37680,86466
15397,CRTE5B,2017-12-31,2018-03-28,48786,37680,86466
15398,CRTE5B,2018-03-31,2018-05-07,48786,37680,86466
15399,CRTE5B,2018-06-30,2018-08-06,48786,37680,86466
15400,CRTE5B,2018-09-30,2018-11-08,48786,37680,86466
15401,CRTE5B,2018-12-31,2019-03-08,48786,37680,86466
15402,CRTE5B,2019-03-31,2019-05-13,48786,37680,86466
15403,CRTE5B,2019-06-30,2019-08-07,48786,37680,86466
15404,CRTE5B,2019-09-30,2019-11-08,48786,37680,86466
15405,CRTE5B,2019-12-31,2020-03-13,48786,37680,86466
15406,CRTE5B,2020-03-31,2020-05-04,48786,37680,86466
15407,CRTE5B,2020-06-30,2020-08-06,48786,37680,86466
15408,CRTE5B,2020-09-30,2020-11-05,48786,37680,86466
15409,CRTE5B,2020-12-31,2021-02-12,48786,37680,86466
15410,PRMN3B,2010-12-31,2011-03-28,100,0,100
15411,PRMN3B,2011-03-31,2011-04-29,100,0,100
15412,PRMN3B,2011-06-30,2011-07-29,100,0,100
15413,PRMN3B,2011-09-30,2011-10-28,100,0,100
15414,PRMN3B,2011-12-31,2012-03-23,100000,0,100000
15415,PRMN3B,2012-03-31,2012-05-15,100,0,100
15416,PRMN3B,2012-06-30,2012-08-09,100,0,100
15417,PRMN3B,2012-09-30,2012-11-09,100,0,100
15418,PRMN3B,2012-12-31,2013-03-19,100,0,100
15419,PRMN3B,2013-03-31,2013-05-16,100,0,100
15420,PRMN3B,2013-06-30,2013-08-06,100,0,100
15421,PRMN3B,2013-09-30,2013-11-14,100,0,100
15422,PRMN3B,2013-12-31,2014-03-14,100000,0,100000
15423,PRMN3B,2014-03-31,2014-07-29,100,0,100
15424,PRMN3B,2014-06-30,2014-08-14,100,0,100
15425,PRMN3B,2014-09-30,2014-11-15,100,0,100
15426,PRMN3B,2014-12-31,2015-03-12,100000,0,100000
15427,PRMN3B,2015-03-31,2015-05-14,100,0,100
15428,PRMN3B,2015-06-30,2015-08-12,100000,0,100000
15429,PRMN3B,2015-09-30,2015-11-08,100000,0,100000
15430,PRMN3B,2015-12-31,2016-03-30,100,0,100
15431,PRMN3B,2016-03-31,2016-04-27,100000,0,100000
15432,PRMN3B,2016-06-30,2016-08-04,100000,0,100000
15433,PRMN3B,2016-09-30,2016-11-09,100,0,100
15434,PRMN3B,2016-12-31,2017-03-27,100,0,100
15435,PRMN3B,2017-03-31,2017-05-12,100,0,100
15436,PRMN3B,2017-06-30,2017-08-14,100,0,100
15437,PRMN3B,2017-09-30,2017-11-19,100,0,100
15438,PRMN3B,2017-12-31,2018-03-28,100,0,100
15439,PRMN3B,2018-03-31,2018-05-14,100,0,100
15440,PRMN3B,2018-06-30,2018-08-13,100,0,100
15441,PRMN3B,2018-09-30,2018-11-13,100,0,100
15442,PRMN3B,2018-12-31,2019-05-20,100,0,100
15443,PRMN3B,2019-03-31,2019-05-14,100,0,100
15444,PRMN3B,2019-06-30,2019-08-02,100,0,100
15445,PRMN3B,2019-09-30,2019-11-12,100,0,100
15446,PRMN3B,2019-12-31,2020-03-17,100,0,100
15447,PRMN3B,2020-03-31,2020-06-19,100,0,100
15448,PRMN3B,2020-06-30,2020-08-31,100,0,100
15449,PRMN3B,2020-09-30,2020-11-12,100,0,100
15450,PRMN3B,2020-12-31,2021-03-03,100,0,100
15451,BIOM3,2010-12-31,2011-05-05,7543,9795,17338
15452,BIOM3,2011-03-31,2012-03-16,7543248,9795585,17338833
15453,BIOM3,2011-06-30,2012-03-16,7543248,9795585,17338833
15454,BIOM3,2011-09-30,2012-03-16,7543248,9795585,17338833
15455,BIOM3,2011-12-31,2012-06-15,7543248,9795585,17338833
15456,BIOM3,2012-03-31,2012-05-15,7543248,9795585,17338833
15457,BIOM3,2012-06-30,2012-08-14,7543,9796,17339
15458,BIOM3,2012-09-30,2012-11-14,7543,9796,17339
15459,BIOM3,2012-12-31,2013-03-28,7543,9796,17339
15460,BIOM3,2013-03-31,2013-05-15,7543,9796,17339
15461,BIOM3,2013-06-30,2013-08-14,7543,9796,17339
15462,BIOM3,2013-09-30,2013-11-14,17339,0,17339
15463,BIOM3,2013-12-31,2014-05-14,29890,0,29890
15464,BIOM3,2014-03-31,2014-05-15,30827,0,30827
15465,BIOM3,2014-06-30,2014-08-14,30827,0,30827
15466,BIOM3,2014-09-30,2014-11-14,30827,0,30827
15467,BIOM3,2014-12-31,2015-03-05,30827,0,30827
15468,BIOM3,2015-03-31,2015-05-08,30827,0,30827
15469,BIOM3,2015-06-30,2015-08-14,30827,0,30827
15470,BIOM3,2015-09-30,2015-11-06,30827,0,30827
15471,BIOM3,2015-12-31,2016-03-18,30827,0,30827
15472,BIOM3,2016-03-31,2016-05-13,30827,0,30827
15473,BIOM3,2016-06-30,2016-08-12,30827,0,30827
15474,BIOM3,2016-09-30,2016-11-11,30827,0,30827
15475,BIOM3,2016-12-31,2017-03-17,30827,0,30827
15476,BIOM3,2017-03-31,2017-05-12,30827,0,30827
15477,BIOM3,2017-06-30,2017-08-11,35309,0,35309
15478,BIOM3,2017-09-30,2017-11-10,35309,0,35309
15479,BIOM3,2017-12-31,2018-03-23,35309,0,35309
15480,BIOM3,2018-03-31,2018-05-11,35309,0,35309
15481,BIOM3,2018-06-30,2018-08-13,47782714,0,47782714
15482,BIOM3,2018-09-30,2018-11-12,47782714,0,47782714
15483,BIOM3,2018-12-31,2019-03-28,47782714,0,47782714
15484,BIOM3,2019-03-31,2019-05-10,47782714,0,47782714
15485,BIOM3,2019-06-30,2019-08-13,47840092,0,47840092
15486,BIOM3,2019-09-30,2019-11-04,47840092,0,47840092
15487,BIOM3,2019-12-31,2020-04-08,60759988,0,60759988
15488,BIOM3,2020-03-31,2020-05-08,60759988,0,60759988
15489,BIOM3,2020-06-30,2020-08-07,60791774,0,60791774
15490,BIOM3,2020-09-30,2020-11-06,60791774,0,60791774
15491,BIOM3,2020-12-31,2021-03-26,67716252,0,67716252
15492,TPIS3,2010-12-31,2012-09-21,146000,0,146000
15493,TPIS3,2011-03-31,2011-05-12,146000,0,146000
15494,TPIS3,2011-06-30,2011-08-11,146000,0,146000
15495,TPIS3,2011-09-30,2011-11-10,146000,0,146000
15496,TPIS3,2011-12-31,2012-09-21,146000,0,146000
15497,TPIS3,2012-03-31,2012-09-21,146000,0,146000
15498,TPIS3,2012-06-30,2012-10-02,146000,0,146000
15499,TPIS3,2012-09-30,2012-11-08,146000,0,146000
15500,TPIS3,2012-12-31,2013-05-15,146000,0,146000
15501,TPIS3,2013-03-31,2013-05-15,146000,0,146000
15502,TPIS3,2013-06-30,2013-08-08,146000,0,146000
15503,TPIS3,2013-09-30,2013-11-07,176000,0,176000
15504,TPIS3,2013-12-31,2014-03-20,176000,0,176000
15505,TPIS3,2014-03-31,2014-05-05,176000,0,176000
15506,TPIS3,2014-06-30,2014-08-14,176000,0,176000
15507,TPIS3,2014-09-30,2014-11-07,176000,0,176000
15508,TPIS3,2014-12-31,2015-03-26,176000,0,176000
15509,TPIS3,2015-03-31,2015-05-13,176000,0,176000
15510,TPIS3,2015-06-30,2015-08-12,176000,0,176000
15511,TPIS3,2015-09-30,2015-11-16,176000,0,176000
15512,TPIS3,2015-12-31,2016-05-12,176000,0,176000
15513,TPIS3,2016-03-31,2016-05-12,176000,0,176000
15514,TPIS3,2016-06-30,2016-08-11,176000,0,176000
15515,TPIS3,2016-09-30,2016-11-10,176000,0,176000
15516,TPIS3,2016-12-31,2017-03-28,176000,0,176000
15517,TPIS3,2017-03-31,2017-05-11,176000,0,176000
15518,TPIS3,2017-06-30,2017-08-11,176000,0,176000
15519,TPIS3,2017-09-30,2017-11-09,176000,0,176000
15520,TPIS3,2017-12-31,2018-03-15,176000,0,176000
15521,TPIS3,2018-03-31,2018-05-10,176000,0,176000
15522,TPIS3,2018-06-30,2018-08-08,176000,0,176000
15523,TPIS3,2018-09-30,2018-11-13,176000,0,176000
15524,TPIS3,2018-12-31,2019-05-09,176000,0,176000
15525,TPIS3,2019-03-31,2019-05-15,176000,0,176000
15526,TPIS3,2019-06-30,2019-08-08,176000,0,176000
15527,TPIS3,2019-09-30,2019-11-07,176000,0,176000
15528,TPIS3,2019-12-31,2020-03-12,176000,0,176000
15529,TPIS3,2020-03-31,2020-05-28,176000,0,176000
15530,TPIS3,2020-06-30,2020-08-06,176000,0,176000
15531,TPIS3,2020-09-30,2020-11-16,176000,0,176000
15532,TPIS3,2020-12-31,2021-03-25,176000,0,176000
15533,ITUB3,2010-12-31,2011-09-01,2289286,2281650,4570936
15534,ITUB3,2011-03-31,2011-05-03,2289286,2281650,4570936
15535,ITUB3,2011-06-30,2011-08-03,2289286,2281650,4570936
15536,ITUB3,2011-09-30,2011-11-01,2289286,2281650,4570936
15537,ITUB3,2011-12-31,2020-03-18,2289286,2281650,4570936
15538,ITUB3,2012-03-31,2012-04-24,2289286,2281650,4570936
15539,ITUB3,2012-06-30,2012-10-30,2289286,2281650,4570936
15540,ITUB3,2012-09-30,2012-10-23,2289286,2281650,4570936
15541,ITUB3,2012-12-31,2020-03-18,2289286,2281650,4570936
15542,ITUB3,2013-03-31,2013-04-30,2289286,2281650,4570936
15543,ITUB3,2013-06-30,2013-07-30,2518215,2509815,5028030
15544,ITUB3,2013-09-30,2013-10-29,2518215,2509815,5028030
15545,ITUB3,2013-12-31,2014-04-11,2518215,2509815,5028030
15546,ITUB3,2014-03-31,2014-04-29,2518215,2509815,5028030
15547,ITUB3,2014-06-30,2014-08-05,2770037,2760796,5530833
15548,ITUB3,2014-09-30,2014-11-04,2770037,2760796,5530833
15549,ITUB3,2014-12-31,2015-02-03,2770037,2760796,5530833
15550,ITUB3,2015-03-31,2015-05-05,2770037,2760796,5530833
15551,ITUB3,2015-06-30,2015-08-04,3047040,3036876,6083916
15552,ITUB3,2015-09-30,2015-11-03,3047040,3036875,6083915
15553,ITUB3,2015-12-31,2016-02-02,3047040,3036876,6083916
15554,ITUB3,2016-03-31,2016-05-03,3047040,3036875,6083915
15555,ITUB3,2016-06-30,2016-08-02,3047040,2936876,5983916
15556,ITUB3,2016-09-30,2016-10-31,3047040,2936876,5983916
15557,ITUB3,2016-12-31,2017-02-07,3351744,3230563,6582307
15558,ITUB3,2017-03-31,2017-05-03,3351744,3230563,6582307
15559,ITUB3,2017-06-30,2017-08-11,3351744,3230563,6582307
15560,ITUB3,2017-09-30,2017-10-30,3351744,3230563,6582307
15561,ITUB3,2017-12-31,2018-02-05,3319951,3230563,6550514
15562,ITUB3,2018-03-31,2018-05-01,3305527,3230563,6536090
15563,ITUB3,2018-06-30,2018-07-30,3305527,3230563,6536090
15564,ITUB3,2018-09-30,2018-10-29,3305527,3230563,6536090
15565,ITUB3,2018-12-31,2019-02-19,4958290,4845845,9804135
15566,ITUB3,2019-03-31,2019-05-02,4958290,4845845,9804135
15567,ITUB3,2019-06-30,2019-11-25,4958290,4845845,9804135
15568,ITUB3,2019-09-30,2019-11-04,4958290,4845845,9804135
15569,ITUB3,2019-12-31,2020-02-10,4958290,4845845,9804135
15570,ITUB3,2020-03-31,2020-05-04,4958290,4845845,9804135
15571,ITUB3,2020-06-30,2020-08-03,4958290,4845845,9804135
15572,ITUB3,2020-09-30,2020-11-03,4958290,4845845,9804135
15573,ITUB3,2020-12-31,2021-02-25,4958290,4845845,9804135
15574,ITUB4,2010-12-31,2011-09-01,2289286,2281650,4570936
15575,ITUB4,2011-03-31,2011-05-03,2289286,2281650,4570936
15576,ITUB4,2011-06-30,2011-08-03,2289286,2281650,4570936
15577,ITUB4,2011-09-30,2011-11-01,2289286,2281650,4570936
15578,ITUB4,2011-12-31,2020-03-18,2289286,2281650,4570936
15579,ITUB4,2012-03-31,2012-04-24,2289286,2281650,4570936
15580,ITUB4,2012-06-30,2012-10-30,2289286,2281650,4570936
15581,ITUB4,2012-09-30,2012-10-23,2289286,2281650,4570936
15582,ITUB4,2012-12-31,2020-03-18,2289286,2281650,4570936
15583,ITUB4,2013-03-31,2013-04-30,2289286,2281650,4570936
15584,ITUB4,2013-06-30,2013-07-30,2518215,2509815,5028030
15585,ITUB4,2013-09-30,2013-10-29,2518215,2509815,5028030
15586,ITUB4,2013-12-31,2014-04-11,2518215,2509815,5028030
15587,ITUB4,2014-03-31,2014-04-29,2518215,2509815,5028030
15588,ITUB4,2014-06-30,2014-08-05,2770037,2760796,5530833
15589,ITUB4,2014-09-30,2014-11-04,2770037,2760796,5530833
15590,ITUB4,2014-12-31,2015-02-03,2770037,2760796,5530833
15591,ITUB4,2015-03-31,2015-05-05,2770037,2760796,5530833
15592,ITUB4,2015-06-30,2015-08-04,3047040,3036876,6083916
15593,ITUB4,2015-09-30,2015-11-03,3047040,3036875,6083915
15594,ITUB4,2015-12-31,2016-02-02,3047040,3036876,6083916
15595,ITUB4,2016-03-31,2016-05-03,3047040,3036875,6083915
15596,ITUB4,2016-06-30,2016-08-02,3047040,2936876,5983916
15597,ITUB4,2016-09-30,2016-10-31,3047040,2936876,5983916
15598,ITUB4,2016-12-31,2017-02-07,3351744,3230563,6582307
15599,ITUB4,2017-03-31,2017-05-03,3351744,3230563,6582307
15600,ITUB4,2017-06-30,2017-08-11,3351744,3230563,6582307
15601,ITUB4,2017-09-30,2017-10-30,3351744,3230563,6582307
15602,ITUB4,2017-12-31,2018-02-05,3319951,3230563,6550514
15603,ITUB4,2018-03-31,2018-05-01,3305527,3230563,6536090
15604,ITUB4,2018-06-30,2018-07-30,3305527,3230563,6536090
15605,ITUB4,2018-09-30,2018-10-29,3305527,3230563,6536090
15606,ITUB4,2018-12-31,2019-02-19,4958290,4845845,9804135
15607,ITUB4,2019-03-31,2019-05-02,4958290,4845845,9804135
15608,ITUB4,2019-06-30,2019-11-25,4958290,4845845,9804135
15609,ITUB4,2019-09-30,2019-11-04,4958290,4845845,9804135
15610,ITUB4,2019-12-31,2020-02-10,4958290,4845845,9804135
15611,ITUB4,2020-03-31,2020-05-04,4958290,4845845,9804135
15612,ITUB4,2020-06-30,2020-08-03,4958290,4845845,9804135
15613,ITUB4,2020-09-30,2020-11-03,4958290,4845845,9804135
15614,ITUB4,2020-12-31,2021-02-25,4958290,4845845,9804135
15615,CSMG3,2010-12-31,2011-03-17,115299,0,115299
15616,CSMG3,2011-03-31,2011-05-26,115299,0,115299
15617,CSMG3,2011-06-30,2011-08-10,115299,0,115299
15618,CSMG3,2011-09-30,2011-11-21,115299,0,115299
15619,CSMG3,2011-12-31,2012-03-09,114931,0,114931
15620,CSMG3,2012-03-31,2012-05-07,114931,0,114931
15621,CSMG3,2012-06-30,2012-08-06,119314,0,119314
15622,CSMG3,2012-09-30,2012-11-07,119327,0,119327
15623,CSMG3,2012-12-31,2013-03-06,119684,0,119684
15624,CSMG3,2013-03-31,2013-10-21,119327,0,119327
15625,CSMG3,2013-06-30,2013-10-21,119327,0,119327
15626,CSMG3,2013-09-30,2013-11-05,119327,0,119327
15627,CSMG3,2013-12-31,2014-01-30,119684,0,119684
15628,CSMG3,2014-03-31,2014-05-06,119327,0,119327
15629,CSMG3,2014-06-30,2014-08-01,119327,0,119327
15630,CSMG3,2014-09-30,2014-10-31,119327,0,119327
15631,CSMG3,2014-12-31,2015-04-06,119684,0,119684
15632,CSMG3,2015-03-31,2015-05-14,119684,0,119684
15633,CSMG3,2015-06-30,2015-08-13,119684,0,119684
15634,CSMG3,2015-09-30,2015-11-25,119684,0,119684
15635,CSMG3,2015-12-31,2016-03-11,119684,0,119684
15636,CSMG3,2016-03-31,2016-05-05,119684,0,119684
15637,CSMG3,2016-06-30,2016-08-11,119684,0,119684
15638,CSMG3,2016-09-30,2016-11-10,126751,0,126751
15639,CSMG3,2016-12-31,2017-03-09,126394,0,126394
15640,CSMG3,2017-03-31,2017-04-27,126751,0,126751
15641,CSMG3,2017-06-30,2017-07-27,126751,0,126751
15642,CSMG3,2017-09-30,2017-10-26,126751,0,126751
15643,CSMG3,2017-12-31,2018-02-23,126751,0,126751
15644,CSMG3,2018-03-31,2018-04-26,126751,0,126751
15645,CSMG3,2018-06-30,2018-07-26,126751,0,126751
15646,CSMG3,2018-09-30,2018-10-31,126751,0,126751
15647,CSMG3,2018-12-31,2019-02-28,126751,0,126751
15648,CSMG3,2019-03-31,2019-04-25,126751,0,126751
15649,CSMG3,2019-06-30,2019-07-26,126751,0,126751
15650,CSMG3,2019-09-30,2019-10-31,126751,0,126751
15651,CSMG3,2019-12-31,2020-03-19,126751,0,126751
15652,CSMG3,2020-03-31,2020-04-30,126751,0,126751
15653,CSMG3,2020-06-30,2020-07-30,126751,0,126751
15654,CSMG3,2020-09-30,2020-10-30,126751,0,126751
15655,CSMG3,2020-12-31,2021-03-01,380253,0,380253
15656,ECOR3,2010-12-31,2011-05-16,558699,0,558699
15657,ECOR3,2011-03-31,2011-05-16,558699,0,558699
15658,ECOR3,2011-06-30,2011-08-09,558699,0,558699
15659,ECOR3,2011-09-30,2011-11-08,558699,0,558699
15660,ECOR3,2011-12-31,2012-03-15,558699,0,558699
15661,ECOR3,2012-03-31,2012-05-14,558699,0,558699
15662,ECOR3,2012-06-30,2012-08-09,558699,0,558699
15663,ECOR3,2012-09-30,2012-11-06,558699,0,558699
15664,ECOR3,2012-12-31,2013-03-14,558699,0,558699
15665,ECOR3,2013-03-31,2013-05-15,558699,0,558699
15666,ECOR3,2013-06-30,2013-08-07,558699,0,558699
15667,ECOR3,2013-09-30,2013-11-05,558699,0,558699
15668,ECOR3,2013-12-31,2014-03-18,558699,0,558699
15669,ECOR3,2014-03-31,2014-05-06,558699,0,558699
15670,ECOR3,2014-06-30,2014-08-07,558699,0,558699
15671,ECOR3,2014-09-30,2014-11-06,558699,0,558699
15672,ECOR3,2014-12-31,2015-03-17,558699,0,558699
15673,ECOR3,2015-03-31,2015-05-11,558699,0,558699
15674,ECOR3,2015-06-30,2015-08-14,558699,0,558699
15675,ECOR3,2015-09-30,2015-11-10,558699,0,558699
15676,ECOR3,2015-12-31,2016-03-15,558699,0,558699
15677,ECOR3,2016-03-31,2016-05-12,558699,0,558699
15678,ECOR3,2016-06-30,2016-08-11,558699,0,558699
15679,ECOR3,2016-09-30,2016-11-10,558699,0,558699
15680,ECOR3,2016-12-31,2017-02-20,558699,0,558699
15681,ECOR3,2017-03-31,2017-05-08,558699,0,558699
15682,ECOR3,2017-06-30,2017-07-27,558699,0,558699
15683,ECOR3,2017-09-30,2017-11-09,558699,0,558699
15684,ECOR3,2017-12-31,2018-02-28,558699,0,558699
15685,ECOR3,2018-03-31,2018-04-25,558699,0,558699
15686,ECOR3,2018-06-30,2018-07-26,558699,0,558699
15687,ECOR3,2018-09-30,2018-10-30,558699,0,558699
15688,ECOR3,2018-12-31,2019-03-14,558699,0,558699
15689,ECOR3,2019-03-31,2019-04-29,558699,0,558699
15690,ECOR3,2019-06-30,2019-07-25,558699,0,558699
15691,ECOR3,2019-09-30,2019-10-29,558699,0,558699
15692,ECOR3,2019-12-31,2020-02-18,558699,0,558699
15693,ECOR3,2020-03-31,2020-12-17,558699,0,558699
15694,ECOR3,2020-06-30,2020-12-17,558699,0,558699
15695,ECOR3,2020-09-30,2020-11-04,558699,0,558699
15696,ECOR3,2020-12-31,2021-03-10,558699,0,558699
15697,NATU3,2010-12-31,2011-02-24,430881,0,430881
15698,NATU3,2011-03-31,2011-04-27,431035,0,431035
15699,NATU3,2011-06-30,2011-07-20,431235,0,431235
15700,NATU3,2011-09-30,2011-10-26,431239,0,431239
15701,NATU3,2011-12-31,2012-02-15,431239,0,431239
15702,NATU3,2012-03-31,2012-04-25,431239,0,431239
15703,NATU3,2012-06-30,2012-07-26,431239,0,431239
15704,NATU3,2012-09-30,2012-10-24,431239,0,431239
15705,NATU3,2012-12-31,2013-02-06,431239,0,431239
15706,NATU3,2013-03-31,2013-04-24,431239,0,431239
15707,NATU3,2013-06-30,2013-07-25,431239,0,431239
15708,NATU3,2013-09-30,2013-10-29,431239,0,431239
15709,NATU3,2013-12-31,2014-06-10,431239,0,431239
15710,NATU3,2014-03-31,2014-04-23,431239,0,431239
15711,NATU3,2014-06-30,2014-07-23,431239,0,431239
15712,NATU3,2014-09-30,2014-10-24,431239,0,431239
15713,NATU3,2014-12-31,2015-02-11,431239,0,431239
15714,NATU3,2015-03-31,2015-04-29,431239,0,431239
15715,NATU3,2015-06-30,2015-07-22,431239,0,431239
15716,NATU3,2015-09-30,2015-10-22,431239,0,431239
15717,NATU3,2015-12-31,2016-02-17,431239,0,431239
15718,NATU3,2016-03-31,2016-04-27,431239,0,431239
15719,NATU3,2016-06-30,2016-07-27,431239,0,431239
15720,NATU3,2016-09-30,2016-10-26,431239,0,431239
15721,NATU3,2016-12-31,2017-02-22,431239,0,431239
15722,NATU3,2017-03-31,2017-04-26,431239,0,431239
15723,NATU3,2017-06-30,2017-07-26,431239,0,431239
15724,NATU3,2017-09-30,2017-11-14,431239,0,431239
15725,NATU3,2017-12-31,2018-03-14,431239,0,431239
15726,NATU3,2018-03-31,2018-07-13,431239,0,431239
15727,NATU3,2018-06-30,2018-08-09,431239,0,431239
15728,NATU3,2018-09-30,2018-11-08,431239,0,431239
15729,NATU3,2018-12-31,2019-02-28,431239,0,431239
15730,NATU3,2019-03-31,2019-05-02,431324,0,431324
15731,NATU3,2019-06-30,2019-08-14,431964,0,431964
15732,NATU3,2019-09-30,2019-11-13,865795,0,865795
15733,NATU3,2019-12-31,2020-03-05,865660,0,865660
15734,NATU3,2020-03-31,2020-05-27,865660,0,865660
15735,NATU3,2020-06-30,2020-08-27,865660,0,865660
15736,NATU3,2020-09-30,2020-11-13,920205,0,920205
15737,GOLL4,2010-12-31,2011-02-24,137033,133304,270337
15738,GOLL4,2011-03-31,2012-05-25,137032734,133338652,270371386
15739,GOLL4,2011-06-30,2012-05-25,137032734,133354132,270386866
15740,GOLL4,2011-09-30,2012-05-25,137032734,133354132,270386866
15741,GOLL4,2011-12-31,2012-07-25,137032734,133357270,270390004
15742,GOLL4,2012-03-31,2012-05-25,137032734,133357270,270390004
15743,GOLL4,2012-06-30,2012-08-13,137032734,133357270,270390004
15744,GOLL4,2012-09-30,2012-11-13,143858204,134858582,278716786
15745,GOLL4,2012-12-31,2013-03-27,143858204,134858582,278716786
15746,GOLL4,2013-03-31,2013-05-13,143858204,135003122,278861326
15747,GOLL4,2013-06-30,2013-08-13,143858204,135003122,278861326
15748,GOLL4,2013-09-30,2013-11-12,143858204,135003122,278861326
15749,GOLL4,2013-12-31,2014-03-25,143858204,135003122,278861326
15750,GOLL4,2014-03-31,2014-05-14,143858204,135003122,278861326
15751,GOLL4,2014-06-30,2014-08-19,143858204,135009316,278867520
15752,GOLL4,2014-09-30,2014-11-11,143858204,139257602,283115806
15753,GOLL4,2014-12-31,2015-03-30,5035037140,139315357,5174352497
15754,GOLL4,2015-03-31,2015-05-12,5035037140,139318357,5174355497
15755,GOLL4,2015-06-30,2015-09-11,5035037140,139318357,5174355497
15756,GOLL4,2015-09-30,2015-11-11,5035037140,203383968,5238421108
15757,GOLL4,2015-12-31,2016-03-29,5035037140,203383968,5238421108
15758,GOLL4,2016-03-31,2016-05-13,5035037140,203383968,5238421108
15759,GOLL4,2016-06-30,2016-08-16,5035037140,203383968,5238421108
15760,GOLL4,2016-09-30,2016-11-07,5035037140,203383968,5238421108
15761,GOLL4,2016-12-31,2017-02-17,5035037140,203383968,5238421108
15762,GOLL4,2017-03-31,2017-05-10,5035037140,203383968,5238421108
15763,GOLL4,2017-06-30,2017-08-09,5035037140,203383968,5238421108
15764,GOLL4,2017-09-30,2017-11-08,5035037140,203628153,5238665293
15765,GOLL4,2017-12-31,2018-03-07,2863682710,265899432,3129582142
15766,GOLL4,2018-03-31,2018-05-09,2863682710,266060461,3129743171
15767,GOLL4,2018-06-30,2018-08-02,2863682710,266559135,3130241845
15768,GOLL4,2018-09-30,2018-11-01,2863682710,266890553,3130573263
15769,GOLL4,2018-12-31,2019-02-28,2863682710,267543740,3131226450
15770,GOLL4,2019-03-31,2019-04-30,2863682710,268065268,3131747978
15771,GOLL4,2019-06-30,2019-08-01,2863682710,268206164,3131888874
15772,GOLL4,2019-09-30,2019-10-31,2863682710,268290641,3131973351
15773,GOLL4,2019-12-31,2020-02-28,2863682710,273682014,3137364724
15774,GOLL4,2020-03-31,2020-06-29,2863682710,273682014,3137364724
15775,GOLL4,2020-06-30,2020-08-13,2863682710,273879123,3137561833
15776,GOLL4,2020-09-30,2020-11-04,2863682710,274043115,3137725825
15777,GOLL4,2020-12-31,2021-03-18,2863682710,274024257,3137706967
15778,GRND3,2010-12-31,2011-02-25,300720000,0,300720000
15779,GRND3,2011-03-31,2012-04-12,300720,0,300720
15780,GRND3,2011-06-30,2012-04-12,300720,0,300720
15781,GRND3,2011-09-30,2012-04-12,300720,0,300720
15782,GRND3,2011-12-31,2012-03-01,300720,0,300720
15783,GRND3,2012-03-31,2012-04-25,300720,0,300720
15784,GRND3,2012-06-30,2012-07-26,300720,0,300720
15785,GRND3,2012-09-30,2012-10-25,300720,0,300720
15786,GRND3,2012-12-31,2013-02-28,300720,0,300720
15787,GRND3,2013-03-31,2013-04-25,300720,0,300720
15788,GRND3,2013-06-30,2013-07-25,300720,0,300720
15789,GRND3,2013-09-30,2013-10-24,300720,0,300720
15790,GRND3,2013-12-31,2014-02-13,300720,0,300720
15791,GRND3,2014-03-31,2014-04-24,300720,0,300720
15792,GRND3,2014-06-30,2014-07-24,300720,0,300720
15793,GRND3,2014-09-30,2014-10-24,300720,0,300720
15794,GRND3,2014-12-31,2015-02-12,300720,0,300720
15795,GRND3,2015-03-31,2015-04-23,300720,0,300720
15796,GRND3,2015-06-30,2015-07-23,300720,0,300720
15797,GRND3,2015-09-30,2015-10-22,300720,0,300720
15798,GRND3,2015-12-31,2016-02-25,300720,0,300720
15799,GRND3,2016-03-31,2016-04-28,300720,0,300720
15800,GRND3,2016-06-30,2016-07-28,300720,0,300720
15801,GRND3,2016-09-30,2016-10-20,300720,0,300720
15802,GRND3,2016-12-31,2017-02-16,300720,0,300720
15803,GRND3,2017-03-31,2017-04-27,300720,0,300720
15804,GRND3,2017-06-30,2017-07-27,300720,0,300720
15805,GRND3,2017-09-30,2017-10-26,300720,0,300720
15806,GRND3,2017-12-31,2018-02-22,300720,0,300720
15807,GRND3,2018-03-31,2018-04-26,300720,0,300720
15808,GRND3,2018-06-30,2018-07-26,902160,0,902160
15809,GRND3,2018-09-30,2018-10-25,902160,0,902160
15810,GRND3,2018-12-31,2019-02-14,902160,0,902160
15811,GRND3,2019-03-31,2019-04-25,902160,0,902160
15812,GRND3,2019-06-30,2019-08-01,902160,0,902160
15813,GRND3,2019-09-30,2019-10-24,902160,0,902160
15814,GRND3,2019-12-31,2020-02-14,902160,0,902160
15815,GRND3,2020-03-31,2021-03-04,902160,0,902160
15816,GRND3,2020-06-30,2021-03-04,902160,0,902160
15817,GRND3,2020-09-30,2021-03-04,902160,0,902160
15818,GRND3,2020-12-31,2021-03-04,902160,0,902160
15819,DASA3,2010-12-31,2011-03-28,229611740,0,229611740
15820,DASA3,2011-03-31,2011-05-10,311803015,0,311803015
15821,DASA3,2011-06-30,2011-08-15,311803015,0,311803015
15822,DASA3,2011-09-30,2011-11-14,311803015,0,311803015
15823,DASA3,2011-12-31,2012-03-26,311803015,0,311803015
15824,DASA3,2012-03-31,2012-05-14,311803015,0,311803015
15825,DASA3,2012-06-30,2012-08-13,311803015,0,311803015
15826,DASA3,2012-09-30,2012-11-12,311803015,0,311803015
15827,DASA3,2012-12-31,2013-03-11,311803015,0,311803015
15828,DASA3,2013-03-31,2013-05-13,311803015,0,311803015
15829,DASA3,2013-06-30,2013-08-26,311803015,0,311803015
15830,DASA3,2013-09-30,2013-11-11,311803015,0,311803015
15831,DASA3,2013-12-31,2014-03-24,311803015,0,311803015
15832,DASA3,2014-03-31,2014-05-12,311803015,0,311803015
15833,DASA3,2014-06-30,2014-08-11,311803015,0,311803015
15834,DASA3,2014-09-30,2014-11-10,311803015,0,311803015
15835,DASA3,2014-12-31,2015-03-23,311803015,0,311803015
15836,DASA3,2015-03-31,2015-05-12,311803015,0,311803015
15837,DASA3,2015-06-30,2015-08-10,311803015,0,311803015
15838,DASA3,2015-09-30,2015-11-12,310889283,0,310889283
15839,DASA3,2015-12-31,2016-03-23,310889283,0,310889283
15840,DASA3,2016-03-31,2016-05-10,310889283,0,310889283
15841,DASA3,2016-06-30,2016-08-10,310889283,0,310889283
15842,DASA3,2016-09-30,2016-11-08,310889283,0,310889283
15843,DASA3,2016-12-31,2017-03-20,310889283,0,310889283
15844,DASA3,2017-03-31,2017-05-12,310889283,0,310889283
15845,DASA3,2017-06-30,2017-08-11,310889283,0,310889283
15846,DASA3,2017-09-30,2017-11-13,311851140,0,311851140
15847,DASA3,2017-12-31,2018-03-16,311891942,0,311891942
15848,DASA3,2018-03-31,2018-05-15,311816941,0,311816941
15849,DASA3,2018-06-30,2018-08-14,311816941,0,311816941
15850,DASA3,2018-09-30,2018-11-14,311816941,0,311816941
15851,DASA3,2018-12-31,2019-03-14,311816941,0,311816941
15852,DASA3,2019-03-31,2019-05-14,311816941,0,311816941
15853,DASA3,2019-06-30,2019-08-14,314944846,0,314944846
15854,DASA3,2019-09-30,2019-11-14,314944846,0,314944846
15855,DASA3,2019-12-31,2020-03-13,314944846,0,314944846
15856,DASA3,2020-03-31,2020-06-19,480813758,0,480813758
15857,DASA3,2020-06-30,2020-08-21,480813758,0,480813758
15858,DASA3,2020-09-30,2020-11-13,480813758,0,480813758
15859,DASA3,2020-12-31,2021-03-06,480722092,0,480722092
15860,FRTA3,2010-12-31,2011-05-02,110000,0,110000
15861,FRTA3,2011-03-31,2011-07-06,110000,0,110000
15862,FRTA3,2011-06-30,2011-08-26,110000,0,110000
15863,FRTA3,2011-09-30,2011-11-14,110000,0,110000
15864,FRTA3,2011-12-31,2012-03-15,110000,0,110000
15865,FRTA3,2012-03-31,2012-05-29,150000,0,150000
15866,FRTA3,2012-06-30,2012-08-14,150000,0,150000
15867,FRTA3,2012-09-30,2012-11-14,150000,0,150000
15868,FRTA3,2012-12-31,2013-05-23,150000,0,150000
15869,FRTA3,2013-03-31,2013-06-28,150000,0,150000
15870,FRTA3,2013-06-30,2013-08-30,150000,0,150000
15871,FRTA3,2013-09-30,2013-11-07,150000,0,150000
15872,FRTA3,2013-12-31,2014-03-14,150000,0,150000
15873,FRTA3,2014-03-31,2014-05-15,150000,0,150000
15874,FRTA3,2014-06-30,2014-08-14,151875,0,151875
15875,FRTA3,2014-09-30,2014-11-13,151875,0,151875
15876,FRTA3,2014-12-31,2015-03-13,7593,0,7593
15877,FRTA3,2015-03-31,2016-05-31,7593,0,7593
15878,FRTA3,2015-06-30,2016-07-11,9094,0,9094
15879,FRTA3,2015-09-30,2016-09-02,9094,0,9094
15880,FRTA3,2015-12-31,2016-06-30,9094,0,9094
15881,FRTA3,2016-03-31,2016-05-16,9094,0,9094
15882,FRTA3,2016-06-30,2016-08-16,11942,0,11942
15883,FRTA3,2016-09-30,2016-11-11,11942,0,11942
15884,FRTA3,2016-12-31,2017-03-28,11942,0,11942
15885,FRTA3,2017-03-31,2017-05-16,11942,0,11942
15886,FRTA3,2017-06-30,2017-08-16,11942,0,11942
15887,FRTA3,2017-09-30,2017-11-14,11942,0,11942
15888,FRTA3,2017-12-31,2018-03-27,11942,0,11942
15889,FRTA3,2018-03-31,2018-05-16,12006636,0,12006636
15890,FRTA3,2018-06-30,2018-09-14,12006636,0,12006636
15891,FRTA3,2018-09-30,2018-11-23,12006636,0,12006636
15892,FRTA3,2018-12-31,2019-03-29,12006,0,12006
15893,FRTA3,2019-03-31,2019-05-20,12006636,0,12006636
15894,FRTA3,2019-06-30,2019-08-14,12006636,0,12006636
15895,FRTA3,2019-09-30,2019-11-14,2001106,0,2001106
15896,FRTA3,2019-12-31,2020-04-14,2001106,0,2001106
15897,FRTA3,2020-03-31,2020-06-29,2001106,0,2001106
15898,FRTA3,2020-06-30,2020-12-30,2001106,0,2001106
15899,FRTA3,2020-09-30,2020-11-16,2001106,0,2001106
15900,RENT3,2010-12-31,2011-03-04,201708,0,201708
15901,RENT3,2011-03-31,2011-05-10,201708,0,201708
15902,RENT3,2011-06-30,2011-07-25,201708,0,201708
15903,RENT3,2011-09-30,2011-10-24,201708,0,201708
15904,RENT3,2011-12-31,2012-03-13,201708,0,201708
15905,RENT3,2012-03-31,2012-05-09,201708,0,201708
15906,RENT3,2012-06-30,2012-07-30,201708,0,201708
15907,RENT3,2012-09-30,2012-10-26,201708,0,201708
15908,RENT3,2012-12-31,2013-03-20,201708,0,201708
15909,RENT3,2013-03-31,2013-04-25,201708,0,201708
15910,RENT3,2013-06-30,2013-08-06,211793,0,211793
15911,RENT3,2013-09-30,2013-10-24,211793,0,211793
15912,RENT3,2013-12-31,2014-03-21,211793,0,211793
15913,RENT3,2014-03-31,2014-04-16,211793,0,211793
15914,RENT3,2014-06-30,2014-07-25,211793,0,211793
15915,RENT3,2014-09-30,2014-10-23,211793,0,211793
15916,RENT3,2014-12-31,2015-03-24,211793,0,211793
15917,RENT3,2015-03-31,2015-04-24,211793,0,211793
15918,RENT3,2015-06-30,2015-07-23,211793,0,211793
15919,RENT3,2015-09-30,2015-10-22,211793,0,211793
15920,RENT3,2015-12-31,2016-03-03,211793,0,211793
15921,RENT3,2016-03-31,2016-04-25,211793,0,211793
15922,RENT3,2016-06-30,2016-07-21,211793,0,211793
15923,RENT3,2016-09-30,2016-10-20,211793,0,211793
15924,RENT3,2016-12-31,2017-02-05,211793,0,211793
15925,RENT3,2017-03-31,2017-04-26,211793,0,211793
15926,RENT3,2017-06-30,2017-07-20,222383,0,222383
15927,RENT3,2017-09-30,2017-11-06,222383,0,222383
15928,RENT3,2017-12-31,2018-03-14,667149,0,667149
15929,RENT3,2018-03-31,2018-04-26,667149,0,667149
15930,RENT3,2018-06-30,2018-07-26,667149,0,667149
15931,RENT3,2018-09-30,2018-10-24,667149,0,667149
15932,RENT3,2018-12-31,2019-02-21,667149,0,667149
15933,RENT3,2019-03-31,2019-04-25,722349,0,722349
15934,RENT3,2019-06-30,2019-08-01,722349,0,722349
15935,RENT3,2019-09-30,2019-10-23,722349,0,722349
15936,RENT3,2019-12-31,2020-03-10,758467,0,758467
15937,RENT3,2020-03-31,2020-05-14,758467,0,758467
15938,RENT3,2020-06-30,2020-07-29,758467,0,758467
15939,RENT3,2020-09-30,2020-10-27,758467,0,758467
15940,RENT3,2020-12-31,2021-02-25,758467,0,758467
15941,ENBR3,2010-12-31,2011-03-21,158805,0,158805
15942,ENBR3,2011-03-31,2011-05-17,158805,0,158805
15943,ENBR3,2011-06-30,2011-07-27,158805,0,158805
15944,ENBR3,2011-09-30,2011-10-26,158805,0,158805
15945,ENBR3,2011-12-31,2012-03-09,158805,0,158805
15946,ENBR3,2012-03-31,2012-05-09,476415,0,476415
15947,ENBR3,2012-06-30,2012-07-25,476415,0,476415
15948,ENBR3,2012-09-30,2012-10-31,476415,0,476415
15949,ENBR3,2012-12-31,2013-07-25,476415,0,476415
15950,ENBR3,2013-03-31,2013-05-08,476415,0,476415
15951,ENBR3,2013-06-30,2013-07-24,476415,0,476415
15952,ENBR3,2013-09-30,2013-10-30,476415,0,476415
15953,ENBR3,2013-12-31,2014-02-27,476415,0,476415
15954,ENBR3,2014-03-31,2014-05-09,476415,0,476415
15955,ENBR3,2014-06-30,2014-07-30,476415,0,476415
15956,ENBR3,2014-09-30,2014-10-29,476415,0,476415
15957,ENBR3,2014-12-31,2015-03-02,476415,0,476415
15958,ENBR3,2015-03-31,2015-05-06,476415,0,476415
15959,ENBR3,2015-06-30,2015-09-04,476415,0,476415
15960,ENBR3,2015-09-30,2015-10-28,476415,0,476415
15961,ENBR3,2015-12-31,2016-03-02,476415,0,476415
15962,ENBR3,2016-03-31,2016-05-02,476415,0,476415
15963,ENBR3,2016-06-30,2016-07-25,476415,0,476415
15964,ENBR3,2016-09-30,2016-10-31,606850,0,606850
15965,ENBR3,2016-12-31,2017-02-22,606850,0,606850
15966,ENBR3,2017-03-31,2017-05-02,606850,0,606850
15967,ENBR3,2017-06-30,2017-07-26,606850,0,606850
15968,ENBR3,2017-09-30,2017-10-31,606165,0,606165
15969,ENBR3,2017-12-31,2018-03-09,606165,0,606165
15970,ENBR3,2018-03-31,2018-05-11,606165,0,606165
15971,ENBR3,2018-06-30,2018-07-25,606248,0,606248
15972,ENBR3,2018-09-30,2018-11-01,606248,0,606248
15973,ENBR3,2018-12-31,2019-03-08,606248,0,606248
15974,ENBR3,2019-03-31,2019-05-10,606850,0,606850
15975,ENBR3,2019-06-30,2019-07-24,606850,0,606850
15976,ENBR3,2019-09-30,2019-10-23,606850,0,606850
15977,ENBR3,2019-12-31,2020-02-18,604806,0,604806
15978,ENBR3,2020-03-31,2020-05-05,604806,0,604806
15979,ENBR3,2020-06-30,2020-08-28,604877,0,604877
15980,ENBR3,2020-09-30,2020-11-30,606850,0,606850
15981,ENBR3,2020-12-31,2021-02-19,606850,0,606850
15982,CSAN3,2011-03-31,2011-06-07,407214,0,407214
15983,CSAN3,2011-06-30,2011-09-08,407214,0,407214
15984,CSAN3,2011-09-30,2011-11-09,407214,0,407214
15985,CSAN3,2011-12-31,2012-02-08,407214,0,407214
15986,CSAN3,2012-03-31,2012-05-31,407214,0,407214
15987,CSAN3,2012-06-30,2012-08-08,407214,0,407214
15988,CSAN3,2012-09-30,2012-11-07,407214,0,407214
15989,CSAN3,2012-12-31,2013-02-28,407214353,0,407214353
15990,CSAN3,2013-03-31,2013-06-05,407214353,0,407214353
15991,CSAN3,2013-06-30,2013-08-16,407214353,0,407214353
15992,CSAN3,2013-09-30,2013-11-06,407214353,0,407214353
15993,CSAN3,2013-12-31,2014-02-27,407214353,0,407214353
15994,CSAN3,2014-03-31,2014-05-13,407214353,0,407214353
15995,CSAN3,2014-06-30,2014-08-15,407214353,0,407214353
15996,CSAN3,2014-09-30,2014-11-05,407214353,0,407214353
15997,CSAN3,2014-12-31,2015-03-18,407214353,0,407214353
15998,CSAN3,2015-03-31,2015-06-16,407214353,0,407214353
15999,CSAN3,2015-06-30,2015-08-12,407214353,0,407214353
16000,CSAN3,2015-09-30,2015-11-11,407214353,0,407214353
16001,CSAN3,2015-12-31,2016-02-18,407214353,0,407214353
16002,CSAN3,2016-03-31,2016-05-12,407214353,0,407214353
16003,CSAN3,2016-06-30,2016-08-10,407214353,0,407214353
16004,CSAN3,2016-09-30,2016-11-09,407214353,0,407214353
16005,CSAN3,2016-12-31,2017-02-16,407294353,0,407294353
16006,CSAN3,2017-03-31,2017-05-10,407904353,0,407904353
16007,CSAN3,2017-06-30,2017-08-09,407904353,0,407904353
16008,CSAN3,2017-09-30,2017-11-10,407904353,0,407904353
16009,CSAN3,2017-12-31,2018-03-26,407904353,0,407904353
16010,CSAN3,2018-03-31,2018-05-15,407904353,0,407904353
16011,CSAN3,2018-06-30,2018-08-08,407904353,0,407904353
16012,CSAN3,2018-09-30,2018-11-07,407904353,0,407904353
16013,CSAN3,2018-12-31,2019-02-14,407904353,0,407904353
16014,CSAN3,2019-03-31,2019-05-13,398904353,0,398904353
16015,CSAN3,2019-06-30,2019-08-12,398904353,0,398904353
16016,CSAN3,2019-09-30,2019-11-12,398904353,0,398904353
16017,CSAN3,2019-12-31,2020-02-14,394210000,0,394210000
16018,CSAN3,2020-03-31,2020-05-29,394210000,0,394210000
16019,CSAN3,2020-06-30,2020-08-10,394210000,0,394210000
16020,CSAN3,2020-09-30,2020-11-13,394210000,0,394210000
16021,CSAN3,2020-12-31,2021-02-11,394210000,0,394210000
16022,LIGT3,2010-12-31,2011-03-28,203934060,0,203934060
16023,LIGT3,2011-03-31,2011-05-13,203934060,0,203934060
16024,LIGT3,2011-06-30,2011-08-05,203934060,0,203934060
16025,LIGT3,2011-09-30,2011-11-11,203934060,0,203934060
16026,LIGT3,2011-12-31,2012-03-06,203934060,0,203934060
16027,LIGT3,2012-03-31,2012-05-11,203934060,0,203934060
16028,LIGT3,2012-06-30,2012-08-14,203934060,0,203934060
16029,LIGT3,2012-09-30,2012-11-09,203934060,0,203934060
16030,LIGT3,2012-12-31,2013-03-25,203934060,0,203934060
16031,LIGT3,2013-03-31,2013-05-10,203934060,0,203934060
16032,LIGT3,2013-06-30,2013-08-13,203934060,0,203934060
16033,LIGT3,2013-09-30,2013-11-08,203934060,0,203934060
16034,LIGT3,2013-12-31,2014-03-11,203934060,0,203934060
16035,LIGT3,2014-03-31,2014-05-15,203934060,0,203934060
16036,LIGT3,2014-06-30,2014-08-13,203934060,0,203934060
16037,LIGT3,2014-09-30,2014-11-13,203934060,0,203934060
16038,LIGT3,2014-12-31,2015-03-06,203934060,0,203934060
16039,LIGT3,2015-03-31,2015-05-08,203934060,0,203934060
16040,LIGT3,2015-06-30,2015-08-12,203934060,0,203934060
16041,LIGT3,2015-09-30,2015-11-12,203934060,0,203934060
16042,LIGT3,2015-12-31,2016-11-10,203934060,0,203934060
16043,LIGT3,2016-03-31,2017-03-23,203934060,0,203934060
16044,LIGT3,2016-06-30,2017-03-23,203934060,0,203934060
16045,LIGT3,2016-09-30,2017-03-23,203934060,0,203934060
16046,LIGT3,2016-12-31,2017-03-23,203934060,0,203934060
16047,LIGT3,2017-03-31,2017-05-15,203934060,0,203934060
16048,LIGT3,2017-06-30,2017-08-10,203934060,0,203934060
16049,LIGT3,2017-09-30,2017-11-14,203934060,0,203934060
16050,LIGT3,2017-12-31,2018-03-28,203934060,0,203934060
16051,LIGT3,2018-03-31,2018-05-14,203934060,0,203934060
16052,LIGT3,2018-06-30,2018-08-22,203934060,0,203934060
16053,LIGT3,2018-09-30,2018-11-12,203934060,0,203934060
16054,LIGT3,2018-12-31,2019-03-28,203934060,0,203934060
16055,LIGT3,2019-03-31,2019-05-15,203934060,0,203934060
16056,LIGT3,2019-06-30,2019-08-15,203934060,0,203934060
16057,LIGT3,2019-09-30,2019-11-13,303934060,0,303934060
16058,LIGT3,2019-12-31,2020-03-12,303934060,0,303934060
16059,LIGT3,2020-03-31,2020-05-07,303934060,0,303934060
16060,LIGT3,2020-06-30,2020-08-13,303934060,0,303934060
16061,LIGT3,2020-09-30,2020-11-12,303934060,0,303934060
16062,LIGT3,2020-12-31,2021-03-19,303934060,0,303934060
16063,BRML3,2010-12-31,2012-10-18,406277,0,406277
16064,BRML3,2011-03-31,2011-05-02,406884,0,406884
16065,BRML3,2011-06-30,2012-10-18,449384,0,449384
16066,BRML3,2011-09-30,2012-11-12,449496,0,449496
16067,BRML3,2011-12-31,2012-10-18,449542,0,449542
16068,BRML3,2012-03-31,2012-04-26,452912,0,452912
16069,BRML3,2012-06-30,2012-10-18,453153,0,453153
16070,BRML3,2012-09-30,2012-11-13,453153,0,453153
16071,BRML3,2012-12-31,2013-03-06,453364,0,453364
16072,BRML3,2013-03-31,2013-05-07,457057,0,457057
16073,BRML3,2013-06-30,2013-08-12,457057,0,457057
16074,BRML3,2013-09-30,2013-11-04,457066,0,457066
16075,BRML3,2013-12-31,2014-03-17,457066,0,457066
16076,BRML3,2014-03-31,2014-05-06,460601,0,460601
16077,BRML3,2014-06-30,2014-08-04,460601,0,460601
16078,BRML3,2014-09-30,2014-11-04,460601,0,460601
16079,BRML3,2014-12-31,2015-03-11,460601,0,460601
16080,BRML3,2015-03-31,2015-05-05,463713,0,463713
16081,BRML3,2015-06-30,2015-08-03,463713,0,463713
16082,BRML3,2015-09-30,2015-11-02,463713,0,463713
16083,BRML3,2015-12-31,2016-03-14,463732,0,463732
16084,BRML3,2016-03-31,2016-05-13,467056,0,467056
16085,BRML3,2016-06-30,2016-08-11,607173,0,607173
16086,BRML3,2016-09-30,2016-11-14,607173,0,607173
16087,BRML3,2016-12-31,2017-03-15,611514,0,611514
16088,BRML3,2017-03-31,2017-05-09,619446,0,619446
16089,BRML3,2017-06-30,2017-08-14,870660,0,870660
16090,BRML3,2017-09-30,2017-11-14,870947,0,870947
16091,BRML3,2017-12-31,2018-03-16,872533,0,872533
16092,BRML3,2018-03-31,2018-05-14,872533,0,872533
16093,BRML3,2018-06-30,2018-08-09,873451,0,873451
16094,BRML3,2018-09-30,2018-11-13,871866,0,871866
16095,BRML3,2018-12-31,2019-03-29,871866,0,871866
16096,BRML3,2019-03-31,2019-05-09,872728,0,872728
16097,BRML3,2019-06-30,2019-08-08,872728,0,872728
16098,BRML3,2019-09-30,2019-11-13,872728,0,872728
16099,BRML3,2019-12-31,2020-03-12,872728,0,872728
16100,BRML3,2020-03-31,2020-06-04,873141,0,873141
16101,BRML3,2020-06-30,2020-08-13,873141,0,873141
16102,BRML3,2020-09-30,2020-11-12,873141,0,873141
16103,BRML3,2020-12-31,2021-03-11,873141333,0,873141333
16104,BRPR3,2010-12-31,2011-03-21,139512,0,139512
16105,BRPR3,2011-03-31,2011-05-20,139512,0,139512
16106,BRPR3,2011-06-30,2011-08-12,139754,0,139754
16107,BRPR3,2011-09-30,2011-11-11,180004,0,180004
16108,BRPR3,2011-12-31,2012-07-10,180004,0,180004
16109,BRPR3,2012-03-31,2012-05-15,309817,0,309817
16110,BRPR3,2012-06-30,2012-08-09,310307,0,310307
16111,BRPR3,2012-09-30,2012-11-09,310307,0,310307
16112,BRPR3,2012-12-31,2013-02-18,311613,0,311613
16113,BRPR3,2013-03-31,2013-05-06,311613,0,311613
16114,BRPR3,2013-06-30,2013-08-06,312653,0,312653
16115,BRPR3,2013-09-30,2013-11-05,312653,0,312653
16116,BRPR3,2013-12-31,2014-02-17,312653,0,312653
16117,BRPR3,2014-03-31,2014-05-05,312653,0,312653
16118,BRPR3,2014-06-30,2014-08-04,297539,0,297539
16119,BRPR3,2014-09-30,2014-11-03,298228,0,298228
16120,BRPR3,2014-12-31,2015-02-12,298228,0,298228
16121,BRPR3,2015-03-31,2015-05-04,298228,0,298228
16122,BRPR3,2015-06-30,2015-08-03,298228,0,298228
16123,BRPR3,2015-09-30,2015-11-03,298228,0,298228
16124,BRPR3,2015-12-31,2016-02-16,298228,0,298228
16125,BRPR3,2016-03-31,2016-05-03,298228,0,298228
16126,BRPR3,2016-06-30,2016-08-10,298228,0,298228
16127,BRPR3,2016-09-30,2016-11-09,298228,0,298228
16128,BRPR3,2016-12-31,2017-06-16,298228,0,298228
16129,BRPR3,2017-03-31,2017-06-16,298228,0,298228
16130,BRPR3,2017-06-30,2017-08-08,298228,0,298228
16131,BRPR3,2017-09-30,2017-11-07,407135,0,407135
16132,BRPR3,2017-12-31,2018-02-06,407135,0,407135
16133,BRPR3,2018-03-31,2018-05-08,407135,0,407135
16134,BRPR3,2018-06-30,2018-08-07,407135,0,407135
16135,BRPR3,2018-09-30,2018-11-06,407135,0,407135
16136,BRPR3,2018-12-31,2019-02-07,407135,0,407135
16137,BRPR3,2019-03-31,2019-05-07,407135,0,407135
16138,BRPR3,2019-06-30,2019-08-07,407135,0,407135
16139,BRPR3,2019-09-30,2019-10-30,407135,0,407135
16140,BRPR3,2019-12-31,2020-03-24,491510,0,491510
16141,BRPR3,2020-03-31,2020-05-06,491510,0,491510
16142,BRPR3,2020-06-30,2020-08-05,491510,0,491510
16143,BRPR3,2020-09-30,2020-11-04,491510,0,491510
16144,BRPR3,2020-12-31,2021-02-22,491510,0,491510
16145,TOTS3,2010-12-31,2011-01-31,31459,0,31459
16146,TOTS3,2011-03-31,2011-04-27,157303220,0,157303220
16147,TOTS3,2011-06-30,2011-07-27,157556860,0,157556860
16148,TOTS3,2011-09-30,2011-10-26,159335866,0,159335866
16149,TOTS3,2011-12-31,2012-01-31,159466791,0,159466791
16150,TOTS3,2012-03-31,2012-04-25,159778198,0,159778198
16151,TOTS3,2012-06-30,2012-07-25,160270272,0,160270272
16152,TOTS3,2012-09-30,2012-11-01,161622528,0,161622528
16153,TOTS3,2012-12-31,2013-01-29,161629945,0,161629945
16154,TOTS3,2013-03-31,2013-05-02,162160872,0,162160872
16155,TOTS3,2013-06-30,2013-07-31,162206591,0,162206591
16156,TOTS3,2013-09-30,2013-10-30,163455154,0,163455154
16157,TOTS3,2013-12-31,2014-01-29,163467071,0,163467071
16158,TOTS3,2014-03-31,2014-04-29,163467071,0,163467071
16159,TOTS3,2014-06-30,2014-07-30,163467071,0,163467071
16160,TOTS3,2014-09-30,2014-10-29,163467071,0,163467071
16161,TOTS3,2014-12-31,2015-01-28,163467071,0,163467071
16162,TOTS3,2015-03-31,2015-05-06,163467071,0,163467071
16163,TOTS3,2015-06-30,2015-08-05,163467071,0,163467071
16164,TOTS3,2015-09-30,2015-10-28,163467071,0,163467071
16165,TOTS3,2015-12-31,2016-03-16,165637727,0,165637727
16166,TOTS3,2016-03-31,2016-05-04,165637727,0,165637727
16167,TOTS3,2016-06-30,2016-08-03,165637727,0,165637727
16168,TOTS3,2016-09-30,2016-11-03,165637727,0,165637727
16169,TOTS3,2016-12-31,2017-02-22,165637727,0,165637727
16170,TOTS3,2017-03-31,2017-05-03,165637727,0,165637727
16171,TOTS3,2017-06-30,2017-08-02,165637727,0,165637727
16172,TOTS3,2017-09-30,2017-11-08,165637727,0,165637727
16173,TOTS3,2017-12-31,2018-02-07,165637727,0,165637727
16174,TOTS3,2018-03-31,2018-05-09,165637727,0,165637727
16175,TOTS3,2018-06-30,2018-08-01,165637727,0,165637727
16176,TOTS3,2018-09-30,2018-11-13,165637727,0,165637727
16177,TOTS3,2018-12-31,2019-02-13,165637727,0,165637727
16178,TOTS3,2019-03-31,2019-05-08,165637727,0,165637727
16179,TOTS3,2019-06-30,2019-08-07,192637727,0,192637727
16180,TOTS3,2019-09-30,2019-11-06,192637727,0,192637727
16181,TOTS3,2019-12-31,2020-02-12,192637727,0,192637727
16182,TOTS3,2020-03-31,2020-05-06,192637727,0,192637727
16183,TOTS3,2020-06-30,2020-08-05,577913181,0,577913181
16184,TOTS3,2020-09-30,2020-10-29,577913181,0,577913181
16185,TOTS3,2020-12-31,2021-02-10,577913181,0,577913181
16186,EQTL3,2010-12-31,2012-10-31,108826325,0,108826325
16187,EQTL3,2011-03-31,2011-05-11,109226672,0,109226672
16188,EQTL3,2011-06-30,2011-07-29,109226672,0,109226672
16189,EQTL3,2011-09-30,2011-11-03,109226672,0,109226672
16190,EQTL3,2011-12-31,2012-12-02,109226672,0,109226672
16191,EQTL3,2012-03-31,2012-12-02,109611778,0,109611778
16192,EQTL3,2012-06-30,2012-12-02,109611778,0,109611778
16193,EQTL3,2012-09-30,2012-12-02,109611778,0,109611778
16194,EQTL3,2012-12-31,2013-04-01,185243902,0,185243902
16195,EQTL3,2013-03-31,2013-05-15,198447352,0,198447352
16196,EQTL3,2013-06-30,2013-08-14,198447352,0,198447352
16197,EQTL3,2013-09-30,2013-11-01,198447352,0,198447352
16198,EQTL3,2013-12-31,2014-03-11,198447352,0,198447352
16199,EQTL3,2014-03-31,2014-05-08,198447352,0,198447352
16200,EQTL3,2014-06-30,2014-08-08,198447352,0,198447352
16201,EQTL3,2014-09-30,2014-10-31,198447352,0,198447352
16202,EQTL3,2014-12-31,2015-02-24,198447352,0,198447352
16203,EQTL3,2015-03-31,2015-05-07,198447352,0,198447352
16204,EQTL3,2015-06-30,2015-08-13,198447352,0,198447352
16205,EQTL3,2015-09-30,2015-11-03,198551102,0,198551102
16206,EQTL3,2015-12-31,2017-09-23,198587352,0,198587352
16207,EQTL3,2016-03-31,2016-05-12,198588467,0,198588467
16208,EQTL3,2016-06-30,2016-08-11,198675967,0,198675967
16209,EQTL3,2016-09-30,2016-11-14,198675967,0,198675967
16210,EQTL3,2016-12-31,2017-09-23,198675967,0,198675967
16211,EQTL3,2017-03-31,2017-05-09,198675967,0,198675967
16212,EQTL3,2017-06-30,2017-09-23,198693733,0,198693733
16213,EQTL3,2017-09-30,2017-11-09,198743467,0,198743467
16214,EQTL3,2017-12-31,2018-03-09,198743467,0,198743467
16215,EQTL3,2018-03-31,2018-05-10,198743467,0,198743467
16216,EQTL3,2018-06-30,2018-08-09,198743467,0,198743467
16217,EQTL3,2018-09-30,2018-11-08,198769717,0,198769717
16218,EQTL3,2018-12-31,2019-04-12,198769717,0,198769717
16219,EQTL3,2019-03-31,2019-05-15,201102217,0,201102217
16220,EQTL3,2019-06-30,2019-08-15,201747217,0,201747217
16221,EQTL3,2019-09-30,2019-11-14,201872217,0,201872217
16222,EQTL3,2019-12-31,2020-05-23,1010186085,0,1010186085
16223,EQTL3,2020-03-31,2020-06-29,1010186085,0,1010186085
16224,EQTL3,2020-06-30,2020-08-20,1010286085,0,1010286085
16225,EQTL3,2020-09-30,2020-11-13,1010511085,0,1010511085
16226,EQTL3,2020-12-31,2021-03-24,1010511085,0,1010511085
16227,VLID3,2010-12-31,2011-03-21,51500,0,51500
16228,VLID3,2011-03-31,2011-05-10,51500,0,51500
16229,VLID3,2011-06-30,2011-08-10,56650,0,56650
16230,VLID3,2011-09-30,2011-11-09,56650,0,56650
16231,VLID3,2011-12-31,2012-03-21,55750,0,55750
16232,VLID3,2012-03-31,2012-05-09,55750,0,55750
16233,VLID3,2012-06-30,2012-08-14,55750,0,55750
16234,VLID3,2012-09-30,2012-11-07,55750,0,55750
16235,VLID3,2012-12-31,2013-03-27,55750,0,55750
16236,VLID3,2013-03-31,2013-05-15,55750,0,55750
16237,VLID3,2013-06-30,2013-08-14,55750,0,55750
16238,VLID3,2013-09-30,2013-12-18,55750,0,55750
16239,VLID3,2013-12-31,2014-03-21,55750,0,55750
16240,VLID3,2014-03-31,2014-05-05,55750,0,55750
16241,VLID3,2014-06-30,2014-08-04,55750,0,55750
16242,VLID3,2014-09-30,2014-11-10,55750,0,55750
16243,VLID3,2014-12-31,2015-03-05,55750,0,55750
16244,VLID3,2015-03-31,2015-05-05,55750,0,55750
16245,VLID3,2015-06-30,2015-08-03,55750,0,55750
16246,VLID3,2015-09-30,2015-11-03,64750,0,64750
16247,VLID3,2015-12-31,2016-04-25,64750,0,64750
16248,VLID3,2016-03-31,2016-05-12,64750,0,64750
16249,VLID3,2016-06-30,2016-08-15,64750,0,64750
16250,VLID3,2016-09-30,2016-11-09,64750,0,64750
16251,VLID3,2016-12-31,2017-03-16,64750,0,64750
16252,VLID3,2017-03-31,2017-05-10,64750,0,64750
16253,VLID3,2017-06-30,2017-08-07,71225,0,71225
16254,VLID3,2017-09-30,2017-11-08,71225,0,71225
16255,VLID3,2017-12-31,2018-03-12,71225,0,71225
16256,VLID3,2018-03-31,2018-05-09,71225,0,71225
16257,VLID3,2018-06-30,2018-08-08,71225,0,71225
16258,VLID3,2018-09-30,2018-11-07,71225,0,71225
16259,VLID3,2018-12-31,2019-03-14,71225,0,71225
16260,VLID3,2019-03-31,2019-05-08,71225,0,71225
16261,VLID3,2019-06-30,2019-08-06,71225,0,71225
16262,VLID3,2019-09-30,2019-10-31,71225,0,71225
16263,VLID3,2019-12-31,2020-03-05,71225,0,71225
16264,VLID3,2020-03-31,2020-05-21,71225,0,71225
16265,VLID3,2020-06-30,2020-08-06,71225,0,71225
16266,VLID3,2020-09-30,2020-11-05,71225,0,71225
16267,VLID3,2020-12-31,2021-03-18,71225000,0,71225000
16268,AGRO3,2011-06-30,2012-05-10,58422400,0,58422400
16269,AGRO3,2011-09-30,2012-05-10,58422400,0,58422400
16270,AGRO3,2011-12-31,2012-05-10,58422400,0,58422400
16271,AGRO3,2012-03-31,2012-05-11,58422400,0,58422400
16272,AGRO3,2012-06-30,2012-09-06,58422400,0,58422400
16273,AGRO3,2012-09-30,2012-11-14,58422400,0,58422400
16274,AGRO3,2012-12-31,2013-02-07,58422400,0,58422400
16275,AGRO3,2013-03-31,2013-05-08,58422400,0,58422400
16276,AGRO3,2013-06-30,2013-11-01,58422400,0,58422400
16277,AGRO3,2013-09-30,2013-11-07,58422400,0,58422400
16278,AGRO3,2013-12-31,2014-02-06,58422400,0,58422400
16279,AGRO3,2014-03-31,2014-05-12,58422400,0,58422400
16280,AGRO3,2014-06-30,2014-09-06,58422400,0,58422400
16281,AGRO3,2014-09-30,2014-11-06,58422400,0,58422400
16282,AGRO3,2014-12-31,2015-02-26,58422400,0,58422400
16283,AGRO3,2015-03-31,2015-05-08,58226600,0,58226600
16284,AGRO3,2015-06-30,2015-09-03,58226600,0,58226600
16285,AGRO3,2015-09-30,2015-11-05,58226600,0,58226600
16286,AGRO3,2015-12-31,2016-02-03,58226600,0,58226600
16287,AGRO3,2016-03-31,2016-05-05,58226600,0,58226600
16288,AGRO3,2016-06-30,2016-08-18,58226600,0,58226600
16289,AGRO3,2016-09-30,2016-11-03,56888916,0,56888916
16290,AGRO3,2016-12-31,2017-02-02,56888916,0,56888916
16291,AGRO3,2017-03-31,2017-05-05,56888916,0,56888916
16292,AGRO3,2017-06-30,2017-08-29,56888916,0,56888916
16293,AGRO3,2017-09-30,2017-11-07,56888916,0,56888916
16294,AGRO3,2017-12-31,2018-02-05,56888916,0,56888916
16295,AGRO3,2018-03-31,2018-05-07,56888916,0,56888916
16296,AGRO3,2018-06-30,2018-08-27,56888916,0,56888916
16297,AGRO3,2018-09-30,2018-11-05,56888916,0,56888916
16298,AGRO3,2018-12-31,2019-02-05,56888916,0,56888916
16299,AGRO3,2019-03-31,2019-05-07,56888916,0,56888916
16300,AGRO3,2019-06-30,2019-09-02,56888916,0,56888916
16301,AGRO3,2019-09-30,2019-11-06,56888916,0,56888916
16302,AGRO3,2019-12-31,2020-02-03,56888916,0,56888916
16303,AGRO3,2020-03-31,2020-05-06,62104301,0,62104301
16304,AGRO3,2020-06-30,2020-08-27,62104301,0,62104301
16305,AGRO3,2020-09-30,2020-11-04,62104301,0,62104301
16306,CARD3,2010-12-31,2011-04-08,48572,0,48572
16307,CARD3,2011-03-31,2011-06-07,48572,0,48572
16308,CARD3,2011-06-30,2011-08-10,48572,0,48572
16309,CARD3,2011-09-30,2011-11-09,48572,0,48572
16310,CARD3,2011-12-31,2012-03-08,46571,0,46571
16311,CARD3,2012-03-31,2012-05-11,46571,0,46571
16312,CARD3,2012-06-30,2012-08-09,46571,0,46571
16313,CARD3,2012-09-30,2012-11-07,46571,0,46571
16314,CARD3,2012-12-31,2013-03-07,46571,0,46571
16315,CARD3,2013-03-31,2013-05-14,46571,0,46571
16316,CARD3,2013-06-30,2013-08-07,45571,0,45571
16317,CARD3,2013-09-30,2013-11-07,44500,0,44500
16318,CARD3,2013-12-31,2014-03-17,42900,0,42900
16319,CARD3,2014-03-31,2014-05-08,41800,0,41800
16320,CARD3,2014-06-30,2014-08-07,41800,0,41800
16321,CARD3,2014-09-30,2014-11-06,41800,0,41800
16322,CARD3,2014-12-31,2015-03-12,41800,0,41800
16323,CARD3,2015-03-31,2015-05-11,41800,0,41800
16324,CARD3,2015-06-30,2015-08-10,41800,0,41800
16325,CARD3,2015-09-30,2015-11-10,41800,0,41800
16326,CARD3,2015-12-31,2016-03-10,41800,0,41800
16327,CARD3,2016-03-31,2016-05-11,41800,0,41800
16328,CARD3,2016-06-30,2016-08-10,41800,0,41800
16329,CARD3,2016-09-30,2016-11-09,41800,0,41800
16330,CARD3,2016-12-31,2017-03-09,41800,0,41800
16331,CARD3,2017-03-31,2017-05-11,41800,0,41800
16332,CARD3,2017-06-30,2017-08-10,41800,0,41800
16333,CARD3,2017-09-30,2017-11-09,41800,0,41800
16334,CARD3,2017-12-31,2018-03-07,41800,0,41800
16335,CARD3,2018-03-31,2018-05-08,41800,0,41800
16336,CARD3,2018-06-30,2018-08-08,41800,0,41800
16337,CARD3,2018-09-30,2018-11-07,41800,0,41800
16338,CARD3,2018-12-31,2019-02-27,41800,0,41800
16339,CARD3,2019-03-31,2019-05-07,41800,0,41800
16340,CARD3,2019-06-30,2019-08-06,41800,0,41800
16341,CARD3,2019-09-30,2019-11-05,41800,0,41800
16342,CARD3,2019-12-31,2020-03-11,41800,0,41800
16343,CARD3,2020-03-31,2020-05-06,41800,0,41800
16344,CARD3,2020-06-30,2020-08-12,41800,0,41800
16345,CARD3,2020-09-30,2020-11-12,41800,0,41800
16346,CARD3,2020-12-31,2021-03-04,41800,0,41800
16347,LUPA3,2010-12-31,2011-03-02,47737703,0,47737703
16348,LUPA3,2011-03-31,2011-05-03,47737703,0,47737703
16349,LUPA3,2011-06-30,2011-08-10,47737955,0,47737955
16350,LUPA3,2011-09-30,2011-11-09,47737955,0,47737955
16351,LUPA3,2011-12-31,2012-04-02,47737703,0,47737703
16352,LUPA3,2012-03-31,2012-05-15,47737955,0,47737955
16353,LUPA3,2012-06-30,2012-08-14,47737955,0,47737955
16354,LUPA3,2012-09-30,2012-11-14,60237955,0,60237955
16355,LUPA3,2012-12-31,2013-03-29,157003138,0,157003138
16356,LUPA3,2013-03-31,2013-05-15,157003401,0,157003401
16357,LUPA3,2013-06-30,2013-08-14,157004093,0,157004093
16358,LUPA3,2013-09-30,2013-11-14,157604619,0,157604619
16359,LUPA3,2013-12-31,2014-04-22,157604619,0,157604619
16360,LUPA3,2014-03-31,2014-05-15,157604619,0,157604619
16361,LUPA3,2014-06-30,2014-08-14,157604619,0,157604619
16362,LUPA3,2014-09-30,2014-11-03,4697054385,0,4697054385
16363,LUPA3,2014-12-31,2015-03-27,4697054385,0,4697054385
16364,LUPA3,2015-03-31,2015-05-15,4696917000,0,4696917000
16365,LUPA3,2015-06-30,2015-08-14,9393834,0,9393834
16366,LUPA3,2015-09-30,2015-11-13,9393834,0,9393834
16367,LUPA3,2015-12-31,2016-03-29,9393834,0,9393834
16368,LUPA3,2016-03-31,2016-05-13,9393834,0,9393834
16369,LUPA3,2016-06-30,2016-11-11,9393834,0,9393834
16370,LUPA3,2016-09-30,2016-11-11,9393834,0,9393834
16371,LUPA3,2016-12-31,2017-03-28,9393834,0,9393834
16372,LUPA3,2017-03-31,2017-05-15,9393834,0,9393834
16373,LUPA3,2017-06-30,2017-08-14,9393834,0,9393834
16374,LUPA3,2017-09-30,2017-11-14,9393834,0,9393834
16375,LUPA3,2017-12-31,2018-03-22,9393834,0,9393834
16376,LUPA3,2018-03-31,2018-05-16,15130239,0,15130239
16377,LUPA3,2018-06-30,2018-09-06,15488921,0,15488921
16378,LUPA3,2018-09-30,2018-11-14,15853203,0,15853203
16379,LUPA3,2018-12-31,2019-04-01,16222745,0,16222745
16380,LUPA3,2019-03-31,2019-05-15,16597970,0,16597970
16381,LUPA3,2019-06-30,2019-08-14,16978437,0,16978437
16382,LUPA3,2019-09-30,2019-11-14,22122908,0,22122908
16383,LUPA3,2019-12-31,2020-03-20,22515076,0,22515076
16384,LUPA3,2020-03-31,2020-05-14,25034015,0,25034015
16385,LUPA3,2020-06-30,2020-08-28,25437456,0,25437456
16386,LUPA3,2020-09-30,2020-11-12,25847142,0,25847142
16387,LUPA3,2020-12-31,2021-03-20,26262840,0,26262840
16388,EMBR3,2010-12-31,2011-03-24,740465,0,740465
16389,EMBR3,2011-03-31,2011-05-06,740465,0,740465
16390,EMBR3,2011-06-30,2011-07-28,740465,0,740465
16391,EMBR3,2011-09-30,2011-11-02,740465,0,740465
16392,EMBR3,2011-12-31,2012-03-26,740465,0,740465
16393,EMBR3,2012-03-31,2012-04-26,740465,0,740465
16394,EMBR3,2012-06-30,2012-07-30,740465,0,740465
16395,EMBR3,2012-09-30,2012-10-23,740465,0,740465
16396,EMBR3,2012-12-31,2013-03-12,740465,0,740465
16397,EMBR3,2013-03-31,2013-04-29,740465,0,740465
16398,EMBR3,2013-06-30,2013-07-25,740465,0,740465
16399,EMBR3,2013-09-30,2013-10-31,740465,0,740465
16400,EMBR3,2013-12-31,2014-04-02,740465,0,740465
16401,EMBR3,2014-03-31,2014-04-30,740465,0,740465
16402,EMBR3,2014-06-30,2014-07-31,740465,0,740465
16403,EMBR3,2014-09-30,2014-11-06,740465,0,740465
16404,EMBR3,2014-12-31,2015-03-16,740465,0,740465
16405,EMBR3,2015-03-31,2015-04-30,740465,0,740465
16406,EMBR3,2015-06-30,2015-07-30,740465,0,740465
16407,EMBR3,2015-09-30,2015-10-27,740465,0,740465
16408,EMBR3,2015-12-31,2016-03-18,740465,0,740465
16409,EMBR3,2016-03-31,2016-05-31,740465,0,740465
16410,EMBR3,2016-06-30,2016-08-12,740465,0,740465
16411,EMBR3,2016-09-30,2016-10-31,740465,0,740465
16412,EMBR3,2016-12-31,2017-03-09,740465,0,740465
16413,EMBR3,2017-03-31,2017-05-02,740465,0,740465
16414,EMBR3,2017-06-30,2017-07-28,740465,0,740465
16415,EMBR3,2017-09-30,2017-10-27,740465,0,740465
16416,EMBR3,2017-12-31,2018-03-08,740465,0,740465
16417,EMBR3,2018-03-31,2018-04-27,740465,0,740465
16418,EMBR3,2018-06-30,2018-07-31,740465,0,740465
16419,EMBR3,2018-09-30,2018-10-30,740465,0,740465
16420,EMBR3,2018-12-31,2019-03-14,740765,0,740765
16421,EMBR3,2019-03-31,2019-05-31,740465,0,740465
16422,EMBR3,2019-06-30,2019-08-14,740465,0,740465
16423,EMBR3,2019-09-30,2019-11-12,740465,0,740465
16424,EMBR3,2019-12-31,2020-03-26,740465,0,740465
16425,EMBR3,2020-03-31,2020-06-01,740465,0,740465
16426,EMBR3,2020-06-30,2020-08-05,740465,0,740465
16427,EMBR3,2020-09-30,2020-11-10,740465,0,740465
16428,EMBR3,2020-12-31,2021-03-19,740465,0,740465
16429,ODPV3,2010-12-31,2011-03-21,177098264,0,177098264
16430,ODPV3,2011-03-31,2011-05-10,177098264,0,177098264
16431,ODPV3,2011-06-30,2011-08-04,177098264,0,177098264
16432,ODPV3,2011-09-30,2011-11-03,177098264,0,177098264
16433,ODPV3,2011-12-31,2012-03-01,177098264,0,177098264
16434,ODPV3,2012-03-31,2012-04-26,177098264,0,177098264
16435,ODPV3,2012-06-30,2012-07-26,531294792,0,531294792
16436,ODPV3,2012-09-30,2012-10-25,531294792,0,531294792
16437,ODPV3,2012-12-31,2013-03-05,531294792,0,531294792
16438,ODPV3,2013-03-31,2013-04-30,531294792,0,531294792
16439,ODPV3,2013-06-30,2013-07-30,531294792,0,531294792
16440,ODPV3,2013-09-30,2013-10-29,531294792,0,531294792
16441,ODPV3,2013-12-31,2014-03-10,531294792,0,531294792
16442,ODPV3,2014-03-31,2014-04-29,531294792,0,531294792
16443,ODPV3,2014-06-30,2014-07-29,531294792,0,531294792
16444,ODPV3,2014-09-30,2014-10-28,531294792,0,531294792
16445,ODPV3,2014-12-31,2015-03-04,531294792,0,531294792
16446,ODPV3,2015-03-31,2015-04-29,531294792,0,531294792
16447,ODPV3,2015-06-30,2015-07-29,531294792,0,531294792
16448,ODPV3,2015-09-30,2015-10-28,531294792,0,531294792
16449,ODPV3,2015-12-31,2016-03-09,531294792,0,531294792
16450,ODPV3,2016-03-31,2016-04-27,531294792,0,531294792
16451,ODPV3,2016-06-30,2016-07-27,531294792,0,531294792
16452,ODPV3,2016-09-30,2016-10-26,531294792,0,531294792
16453,ODPV3,2016-12-31,2017-02-21,531294792,0,531294792
16454,ODPV3,2017-03-31,2017-04-26,531294792,0,531294792
16455,ODPV3,2017-06-30,2017-07-26,531294792,0,531294792
16456,ODPV3,2017-09-30,2017-10-25,531294792,0,531294792
16457,ODPV3,2017-12-31,2018-02-28,531294792,0,531294792
16458,ODPV3,2018-03-31,2018-04-25,531294792,0,531294792
16459,ODPV3,2018-06-30,2018-07-25,531294792,0,531294792
16460,ODPV3,2018-09-30,2018-10-24,531294792,0,531294792
16461,ODPV3,2018-12-31,2019-02-26,531294792,0,531294792
16462,ODPV3,2019-03-31,2019-05-02,531294792,0,531294792
16463,ODPV3,2019-06-30,2019-08-01,531294792,0,531294792
16464,ODPV3,2019-09-30,2019-10-30,531294792,0,531294792
16465,ODPV3,2019-12-31,2020-03-27,531294792,0,531294792
16466,ODPV3,2020-03-31,2020-04-29,531294792,0,531294792
16467,ODPV3,2020-06-30,2020-07-29,531294792,0,531294792
16468,ODPV3,2020-09-30,2020-10-28,531294792,0,531294792
16469,ODPV3,2020-12-31,2021-03-04,531294792,0,531294792
16470,CCXC3,2010-12-31,2011-03-30,3776809,0,3776809
16471,CCXC3,2011-03-31,2011-05-13,3776809,0,3776809
16472,CCXC3,2011-06-30,2011-08-22,3776809,0,3776809
16473,CCXC3,2011-09-30,2011-11-11,3776809,0,3776809
16474,CCXC3,2011-12-31,2012-03-29,63776809,0,63776809
16475,CCXC3,2012-03-31,2012-05-14,63776809,0,63776809
16476,CCXC3,2012-06-30,2012-08-13,170123,0,170123
16477,CCXC3,2012-09-30,2012-11-08,170123,0,170123
16478,CCXC3,2012-12-31,2013-02-21,170122934,0,170122934
16479,CCXC3,2013-03-31,2013-05-09,170123,0,170123
16480,CCXC3,2013-06-30,2013-08-14,170123,0,170123
16481,CCXC3,2013-09-30,2013-11-25,170123,0,170123
16482,CCXC3,2013-12-31,2014-04-14,170122934,0,170122934
16483,CCXC3,2014-03-31,2014-05-15,170123,0,170123
16484,CCXC3,2014-06-30,2014-08-14,170123,0,170123
16485,CCXC3,2014-09-30,2014-11-14,170123,0,170123
16486,CCXC3,2014-12-31,2015-03-31,170122934,0,170122934
16487,CCXC3,2015-03-31,2015-05-15,170123,0,170123
16488,CCXC3,2015-06-30,2015-08-14,170123,0,170123
16489,CCXC3,2015-09-30,2015-11-17,17012,0,17012
16490,CCXC3,2015-12-31,2016-03-30,17012293,0,17012293
16491,CCXC3,2016-03-31,2016-05-13,17012,0,17012
16492,CCXC3,2016-06-30,2016-09-14,17012,0,17012
16493,CCXC3,2016-09-30,2016-11-14,17012,0,17012
16494,CCXC3,2016-12-31,2017-03-28,17012293,0,17012293
16495,CCXC3,2017-03-31,2017-05-15,17012,0,17012
16496,CCXC3,2017-06-30,2017-09-14,17012,0,17012
16497,CCXC3,2017-09-30,2017-11-14,17012,0,17012
16498,CCXC3,2017-12-31,2018-04-09,17012293,0,17012293
16499,CCXC3,2018-03-31,2018-05-15,17012,0,17012
16500,CCXC3,2018-06-30,2018-08-14,1701,0,1701
16501,CCXC3,2018-09-30,2018-11-14,1701,0,1701
16502,CCXC3,2018-12-31,2019-04-01,1701229,0,1701229
16503,CCXC3,2019-03-31,2019-05-15,1701,0,1701
16504,CCXC3,2019-06-30,2019-08-14,1701,0,1701
16505,CCXC3,2019-09-30,2019-11-14,1701,0,1701
16506,CCXC3,2019-12-31,2020-09-23,1701229,0,1701229
16507,TAEE11,2010-12-31,2011-06-09,203518,59981,263499
16508,TAEE11,2011-03-31,2011-06-10,203518,59981,263499
16509,TAEE11,2011-06-30,2011-08-09,203518,59981,263499
16510,TAEE11,2011-09-30,2011-11-10,203518,59981,263499
16511,TAEE11,2011-12-31,2012-07-02,203518,59981,263499
16512,TAEE11,2012-03-31,2012-07-02,203518,59981,263499
16513,TAEE11,2012-06-30,2012-10-10,203518,59981,263499
16514,TAEE11,2012-09-30,2012-11-14,230518,113981,344499
16515,TAEE11,2012-12-31,2013-03-27,691553,341944,1033497
16516,TAEE11,2013-03-31,2013-05-15,691553,341944,1033497
16517,TAEE11,2013-06-30,2013-08-14,691553,341944,1033497
16518,TAEE11,2013-09-30,2013-11-13,691553,341944,1033497
16519,TAEE11,2013-12-31,2014-03-21,691553,341944,1033497
16520,TAEE11,2014-03-31,2014-05-14,691553,341944,1033497
16521,TAEE11,2014-06-30,2014-08-13,691553,341944,1033497
16522,TAEE11,2014-09-30,2014-11-10,691553,341944,1033497
16523,TAEE11,2014-12-31,2015-03-12,640714,392783,1033497
16524,TAEE11,2015-03-31,2015-05-11,640714,392783,1033497
16525,TAEE11,2015-06-30,2015-08-19,640714,392783,1033497
16526,TAEE11,2015-09-30,2015-11-05,640714,392783,1033497
16527,TAEE11,2015-12-31,2016-03-14,640714,392783,1033497
16528,TAEE11,2016-03-31,2016-05-04,640714,392783,1033497
16529,TAEE11,2016-06-30,2016-08-08,640714,392783,1033497
16530,TAEE11,2016-09-30,2016-11-08,590714,442783,1033497
16531,TAEE11,2016-12-31,2017-03-10,590714,442783,1033497
16532,TAEE11,2017-03-31,2017-05-05,590714,442783,1033497
16533,TAEE11,2017-06-30,2017-08-09,590714,442783,1033497
16534,TAEE11,2017-09-30,2017-11-08,590714,442783,1033497
16535,TAEE11,2017-12-31,2018-05-17,590714,442783,1033497
16536,TAEE11,2018-03-31,2018-05-09,590714,442783,1033497
16537,TAEE11,2018-06-30,2018-08-06,590714,442783,1033497
16538,TAEE11,2018-09-30,2018-11-06,590714,442783,1033497
16539,TAEE11,2018-12-31,2019-04-11,590714,442783,1033497
16540,TAEE11,2019-03-31,2019-05-14,590714,442783,1033497
16541,TAEE11,2019-06-30,2019-08-06,590714,442783,1033497
16542,TAEE11,2019-09-30,2019-11-13,590714,442783,1033497
16543,TAEE11,2019-12-31,2020-03-12,590714,442783,1033497
16544,TAEE11,2020-03-31,2020-05-14,590714,442783,1033497
16545,TAEE11,2020-06-30,2020-08-12,590714,442783,1033497
16546,TAEE11,2020-09-30,2020-11-11,590714,442783,1033497
16547,TAEE11,2020-12-31,2021-03-03,590714,442783,1033497
16548,TAEE3,2010-12-31,2011-06-09,203518,59981,263499
16549,TAEE3,2011-03-31,2011-06-10,203518,59981,263499
16550,TAEE3,2011-06-30,2011-08-09,203518,59981,263499
16551,TAEE3,2011-09-30,2011-11-10,203518,59981,263499
16552,TAEE3,2011-12-31,2012-07-02,203518,59981,263499
16553,TAEE3,2012-03-31,2012-07-02,203518,59981,263499
16554,TAEE3,2012-06-30,2012-10-10,203518,59981,263499
16555,TAEE3,2012-09-30,2012-11-14,230518,113981,344499
16556,TAEE3,2012-12-31,2013-03-27,691553,341944,1033497
16557,TAEE3,2013-03-31,2013-05-15,691553,341944,1033497
16558,TAEE3,2013-06-30,2013-08-14,691553,341944,1033497
16559,TAEE3,2013-09-30,2013-11-13,691553,341944,1033497
16560,TAEE3,2013-12-31,2014-03-21,691553,341944,1033497
16561,TAEE3,2014-03-31,2014-05-14,691553,341944,1033497
16562,TAEE3,2014-06-30,2014-08-13,691553,341944,1033497
16563,TAEE3,2014-09-30,2014-11-10,691553,341944,1033497
16564,TAEE3,2014-12-31,2015-03-12,640714,392783,1033497
16565,TAEE3,2015-03-31,2015-05-11,640714,392783,1033497
16566,TAEE3,2015-06-30,2015-08-19,640714,392783,1033497
16567,TAEE3,2015-09-30,2015-11-05,640714,392783,1033497
16568,TAEE3,2015-12-31,2016-03-14,640714,392783,1033497
16569,TAEE3,2016-03-31,2016-05-04,640714,392783,1033497
16570,TAEE3,2016-06-30,2016-08-08,640714,392783,1033497
16571,TAEE3,2016-09-30,2016-11-08,590714,442783,1033497
16572,TAEE3,2016-12-31,2017-03-10,590714,442783,1033497
16573,TAEE3,2017-03-31,2017-05-05,590714,442783,1033497
16574,TAEE3,2017-06-30,2017-08-09,590714,442783,1033497
16575,TAEE3,2017-09-30,2017-11-08,590714,442783,1033497
16576,TAEE3,2017-12-31,2018-05-17,590714,442783,1033497
16577,TAEE3,2018-03-31,2018-05-09,590714,442783,1033497
16578,TAEE3,2018-06-30,2018-08-06,590714,442783,1033497
16579,TAEE3,2018-09-30,2018-11-06,590714,442783,1033497
16580,TAEE3,2018-12-31,2019-04-11,590714,442783,1033497
16581,TAEE3,2019-03-31,2019-05-14,590714,442783,1033497
16582,TAEE3,2019-06-30,2019-08-06,590714,442783,1033497
16583,TAEE3,2019-09-30,2019-11-13,590714,442783,1033497
16584,TAEE3,2019-12-31,2020-03-12,590714,442783,1033497
16585,TAEE3,2020-03-31,2020-05-14,590714,442783,1033497
16586,TAEE3,2020-06-30,2020-08-12,590714,442783,1033497
16587,TAEE3,2020-09-30,2020-11-11,590714,442783,1033497
16588,TAEE3,2020-12-31,2021-03-03,590714,442783,1033497
16589,TAEE4,2010-12-31,2011-06-09,203518,59981,263499
16590,TAEE4,2011-03-31,2011-06-10,203518,59981,263499
16591,TAEE4,2011-06-30,2011-08-09,203518,59981,263499
16592,TAEE4,2011-09-30,2011-11-10,203518,59981,263499
16593,TAEE4,2011-12-31,2012-07-02,203518,59981,263499
16594,TAEE4,2012-03-31,2012-07-02,203518,59981,263499
16595,TAEE4,2012-06-30,2012-10-10,203518,59981,263499
16596,TAEE4,2012-09-30,2012-11-14,230518,113981,344499
16597,TAEE4,2012-12-31,2013-03-27,691553,341944,1033497
16598,TAEE4,2013-03-31,2013-05-15,691553,341944,1033497
16599,TAEE4,2013-06-30,2013-08-14,691553,341944,1033497
16600,TAEE4,2013-09-30,2013-11-13,691553,341944,1033497
16601,TAEE4,2013-12-31,2014-03-21,691553,341944,1033497
16602,TAEE4,2014-03-31,2014-05-14,691553,341944,1033497
16603,TAEE4,2014-06-30,2014-08-13,691553,341944,1033497
16604,TAEE4,2014-09-30,2014-11-10,691553,341944,1033497
16605,TAEE4,2014-12-31,2015-03-12,640714,392783,1033497
16606,TAEE4,2015-03-31,2015-05-11,640714,392783,1033497
16607,TAEE4,2015-06-30,2015-08-19,640714,392783,1033497
16608,TAEE4,2015-09-30,2015-11-05,640714,392783,1033497
16609,TAEE4,2015-12-31,2016-03-14,640714,392783,1033497
16610,TAEE4,2016-03-31,2016-05-04,640714,392783,1033497
16611,TAEE4,2016-06-30,2016-08-08,640714,392783,1033497
16612,TAEE4,2016-09-30,2016-11-08,590714,442783,1033497
16613,TAEE4,2016-12-31,2017-03-10,590714,442783,1033497
16614,TAEE4,2017-03-31,2017-05-05,590714,442783,1033497
16615,TAEE4,2017-06-30,2017-08-09,590714,442783,1033497
16616,TAEE4,2017-09-30,2017-11-08,590714,442783,1033497
16617,TAEE4,2017-12-31,2018-05-17,590714,442783,1033497
16618,TAEE4,2018-03-31,2018-05-09,590714,442783,1033497
16619,TAEE4,2018-06-30,2018-08-06,590714,442783,1033497
16620,TAEE4,2018-09-30,2018-11-06,590714,442783,1033497
16621,TAEE4,2018-12-31,2019-04-11,590714,442783,1033497
16622,TAEE4,2019-03-31,2019-05-14,590714,442783,1033497
16623,TAEE4,2019-06-30,2019-08-06,590714,442783,1033497
16624,TAEE4,2019-09-30,2019-11-13,590714,442783,1033497
16625,TAEE4,2019-12-31,2020-03-12,590714,442783,1033497
16626,TAEE4,2020-03-31,2020-05-14,590714,442783,1033497
16627,TAEE4,2020-06-30,2020-08-12,590714,442783,1033497
16628,TAEE4,2020-09-30,2020-11-11,590714,442783,1033497
16629,TAEE4,2020-12-31,2021-03-03,590714,442783,1033497
16630,MDIA3,2010-12-31,2011-02-28,113450,0,113450
16631,MDIA3,2011-03-31,2011-05-06,113450000,0,113450000
16632,MDIA3,2011-06-30,2011-07-25,113450000,0,113450000
16633,MDIA3,2011-09-30,2011-10-31,113450000,0,113450000
16634,MDIA3,2011-12-31,2012-03-05,113450000,0,113450000
16635,MDIA3,2012-03-31,2012-04-23,113450000,0,113450000
16636,MDIA3,2012-06-30,2012-07-27,113450000,0,113450000
16637,MDIA3,2012-09-30,2012-10-26,113450000,0,113450000
16638,MDIA3,2012-12-31,2013-03-04,113450000,0,113450000
16639,MDIA3,2013-03-31,2013-05-07,113450000,0,113450000
16640,MDIA3,2013-06-30,2013-07-30,113450000,0,113450000
16641,MDIA3,2013-09-30,2013-10-28,113450000,0,113450000
16642,MDIA3,2013-12-31,2014-03-10,113450000,0,113450000
16643,MDIA3,2014-03-31,2014-05-05,113450000,0,113450000
16644,MDIA3,2014-06-30,2014-07-28,113450000,0,113450000
16645,MDIA3,2014-09-30,2014-10-27,113450000,0,113450000
16646,MDIA3,2014-12-31,2015-02-27,113450000,0,113450000
16647,MDIA3,2015-03-31,2015-04-27,113450000,0,113450000
16648,MDIA3,2015-06-30,2015-07-27,113450000,0,113450000
16649,MDIA3,2015-09-30,2015-10-26,113450000,0,113450000
16650,MDIA3,2015-12-31,2016-02-26,113000000,0,113000000
16651,MDIA3,2016-03-31,2016-05-02,113000000,0,113000000
16652,MDIA3,2016-06-30,2016-08-04,113000000,0,113000000
16653,MDIA3,2016-09-30,2016-10-31,113000000,0,113000000
16654,MDIA3,2016-12-31,2017-03-06,113000000,0,113000000
16655,MDIA3,2017-03-31,2017-05-05,113000000,0,113000000
16656,MDIA3,2017-06-30,2017-08-07,339000000,0,339000000
16657,MDIA3,2017-09-30,2017-10-30,339000000,0,339000000
16658,MDIA3,2017-12-31,2018-03-05,339000000,0,339000000
16659,MDIA3,2018-03-31,2018-05-14,339000000,0,339000000
16660,MDIA3,2018-06-30,2018-08-13,339000000,0,339000000
16661,MDIA3,2018-09-30,2018-11-14,339000000,0,339000000
16662,MDIA3,2018-12-31,2019-03-13,339000000,0,339000000
16663,MDIA3,2019-03-31,2019-05-10,339000000,0,339000000
16664,MDIA3,2019-06-30,2019-08-09,339000000,0,339000000
16665,MDIA3,2019-09-30,2019-11-08,339000000,0,339000000
16666,MDIA3,2019-12-31,2020-03-06,339000000,0,339000000
16667,MDIA3,2020-03-31,2020-05-08,339000000,0,339000000
16668,MDIA3,2020-06-30,2020-08-07,339000000,0,339000000
16669,MDIA3,2020-09-30,2020-11-06,339000000,0,339000000
16670,PFRM3,2010-12-31,2011-03-03,33164,0,33164
16671,PFRM3,2011-03-31,2011-05-11,33164,0,33164
16672,PFRM3,2011-06-30,2011-08-10,33164,0,33164
16673,PFRM3,2011-09-30,2011-10-24,33164,0,33164
16674,PFRM3,2011-12-31,2013-03-26,33299,0,33299
16675,PFRM3,2012-03-31,2012-05-03,33299,0,33299
16676,PFRM3,2012-06-30,2012-09-11,33299,0,33299
16677,PFRM3,2012-09-30,2012-11-07,33543,0,33543
16678,PFRM3,2012-12-31,2013-03-26,33543,0,33543
16679,PFRM3,2013-03-31,2013-05-14,33543,0,33543
16680,PFRM3,2013-06-30,2013-09-02,33543,0,33543
16681,PFRM3,2013-09-30,2013-11-13,33708,0,33708
16682,PFRM3,2013-12-31,2014-03-31,33208,0,33208
16683,PFRM3,2014-03-31,2018-06-29,33208,0,33208
16684,PFRM3,2014-06-30,2018-06-29,41509,0,41509
16685,PFRM3,2014-09-30,2018-06-29,41509,0,41509
16686,PFRM3,2014-12-31,2018-06-29,41509,0,41509
16687,PFRM3,2015-03-31,2018-06-29,41509,0,41509
16688,PFRM3,2015-06-30,2018-06-29,41509,0,41509
16689,PFRM3,2015-09-30,2018-06-29,41509,0,41509
16690,PFRM3,2015-12-31,2018-04-19,41509,0,41509
16691,PFRM3,2016-03-31,2018-07-02,41509,0,41509
16692,PFRM3,2016-06-30,2018-07-02,64838,0,64838
16693,PFRM3,2016-09-30,2018-07-02,64838,0,64838
16694,PFRM3,2016-12-31,2018-04-20,64838,0,64838
16695,PFRM3,2017-03-31,2018-07-02,64838,0,64838
16696,PFRM3,2017-06-30,2018-07-02,76310,0,76310
16697,PFRM3,2017-09-30,2018-07-02,76310,0,76310
16698,PFRM3,2017-12-31,2018-03-22,76310,0,76310
16699,PFRM3,2018-03-31,2018-05-10,123813,0,123813
16700,PFRM3,2018-06-30,2018-08-02,123813,0,123813
16701,PFRM3,2018-09-30,2018-11-12,123813,0,123813
16702,PFRM3,2018-12-31,2019-05-16,123813,0,123813
16703,PFRM3,2019-03-31,2019-05-23,123813,0,123813
16704,PFRM3,2019-06-30,2019-07-23,123813,0,123813
16705,PFRM3,2019-09-30,2019-11-12,123813,0,123813
16706,PFRM3,2019-12-31,2020-03-11,123813,0,123813
16707,PFRM3,2020-03-31,2020-05-06,123813,0,123813
16708,PFRM3,2020-06-30,2020-08-17,123813,0,123813
16709,PFRM3,2020-09-30,2020-11-04,123813,0,123813
16710,PFRM3,2020-12-31,2021-03-16,123813,0,123813
16711,TESA3,2010-12-31,2011-06-06,1084190,0,1084190
16712,TESA3,2011-03-31,2011-05-12,1084190,0,1084190
16713,TESA3,2011-06-30,2011-08-12,1084190,0,1084190
16714,TESA3,2011-09-30,2012-04-04,2320145,0,2320145
16715,TESA3,2011-12-31,2012-03-30,2320145,0,2320145
16716,TESA3,2012-03-31,2012-04-28,2320145,0,2320145
16717,TESA3,2012-06-30,2012-08-09,2320145,0,2320145
16718,TESA3,2012-09-30,2012-11-13,2320145,0,2320145
16719,TESA3,2012-12-31,2013-04-04,3486812,0,3486812
16720,TESA3,2013-03-31,2013-05-10,3486812,0,3486812
16721,TESA3,2013-06-30,2013-08-14,387424,0,387424
16722,TESA3,2013-09-30,2013-11-08,387424,0,387424
16723,TESA3,2013-12-31,2014-03-27,387424,0,387424
16724,TESA3,2014-03-31,2014-04-23,387424,0,387424
16725,TESA3,2014-06-30,2014-08-01,387424,0,387424
16726,TESA3,2014-09-30,2014-10-30,387424,0,387424
16727,TESA3,2014-12-31,2015-03-30,537424,0,537424
16728,TESA3,2015-03-31,2015-04-29,537424,0,537424
16729,TESA3,2015-06-30,2015-08-04,537424,0,537424
16730,TESA3,2015-09-30,2015-11-12,17914,0,17914
16731,TESA3,2015-12-31,2016-03-23,17914,0,17914
16732,TESA3,2016-03-31,2016-05-10,17914,0,17914
16733,TESA3,2016-06-30,2016-08-09,17914,0,17914
16734,TESA3,2016-09-30,2016-11-10,17914,0,17914
16735,TESA3,2016-12-31,2017-03-09,17914,0,17914
16736,TESA3,2017-03-31,2017-05-03,17914,0,17914
16737,TESA3,2017-06-30,2017-08-09,17914,0,17914
16738,TESA3,2017-09-30,2017-11-01,17914,0,17914
16739,TESA3,2017-12-31,2018-03-27,17914,0,17914
16740,TESA3,2018-03-31,2018-05-09,17914,0,17914
16741,TESA3,2018-06-30,2018-08-14,17914,0,17914
16742,TESA3,2018-09-30,2018-10-31,17914,0,17914
16743,TESA3,2018-12-31,2019-03-21,17914,0,17914
16744,TESA3,2019-03-31,2019-05-07,17914,0,17914
16745,TESA3,2019-06-30,2019-08-06,21615,0,21615
16746,TESA3,2019-09-30,2019-11-04,21639,0,21639
16747,TESA3,2019-12-31,2020-03-12,21640,0,21640
16748,TESA3,2020-03-31,2020-05-14,21656,0,21656
16749,TESA3,2020-06-30,2020-09-04,21657,0,21657
16750,TESA3,2020-09-30,2020-11-12,21657,0,21657
16751,TESA3,2020-12-31,2021-03-10,21779,0,21779
16752,POSI3,2010-12-31,2011-05-11,87800,0,87800
16753,POSI3,2011-03-31,2011-05-12,87800,0,87800
16754,POSI3,2011-06-30,2011-08-12,87800,0,87800
16755,POSI3,2011-09-30,2011-11-10,87800,0,87800
16756,POSI3,2011-12-31,2012-03-20,87800,0,87800
16757,POSI3,2012-03-31,2012-05-09,87800,0,87800
16758,POSI3,2012-06-30,2012-08-14,87800,0,87800
16759,POSI3,2012-09-30,2012-11-08,87800,0,87800
16760,POSI3,2012-12-31,2013-03-14,87800,0,87800
16761,POSI3,2013-03-31,2013-05-09,87800,0,87800
16762,POSI3,2013-06-30,2013-08-08,87800,0,87800
16763,POSI3,2013-09-30,2013-11-11,87800,0,87800
16764,POSI3,2013-12-31,2014-02-20,87800,0,87800
16765,POSI3,2014-03-31,2014-05-08,87800,0,87800
16766,POSI3,2014-06-30,2014-08-06,87800,0,87800
16767,POSI3,2014-09-30,2014-11-10,87800,0,87800
16768,POSI3,2014-12-31,2015-03-06,87800,0,87800
16769,POSI3,2015-03-31,2015-05-15,87800,0,87800
16770,POSI3,2015-06-30,2015-08-14,87800,0,87800
16771,POSI3,2015-09-30,2015-11-13,87800,0,87800
16772,POSI3,2015-12-31,2016-03-23,87800,0,87800
16773,POSI3,2016-03-31,2016-05-13,87800,0,87800
16774,POSI3,2016-06-30,2016-08-09,87800,0,87800
16775,POSI3,2016-09-30,2016-11-10,87800,0,87800
16776,POSI3,2016-12-31,2017-03-16,87800,0,87800
16777,POSI3,2017-03-31,2017-05-11,87800,0,87800
16778,POSI3,2017-06-30,2017-08-09,87800,0,87800
16779,POSI3,2017-09-30,2017-11-13,87800,0,87800
16780,POSI3,2017-12-31,2018-03-14,87800,0,87800
16781,POSI3,2018-03-31,2018-05-14,87800,0,87800
16782,POSI3,2018-06-30,2018-08-14,87800,0,87800
16783,POSI3,2018-09-30,2018-11-12,87800,0,87800
16784,POSI3,2018-12-31,2019-03-27,87800,0,87800
16785,POSI3,2019-03-31,2019-05-15,87800,0,87800
16786,POSI3,2019-06-30,2019-08-14,87800,0,87800
16787,POSI3,2019-09-30,2019-11-13,87800,0,87800
16788,POSI3,2019-12-31,2020-03-04,87800,0,87800
16789,POSI3,2020-03-31,2020-06-08,141800,0,141800
16790,POSI3,2020-06-30,2020-08-13,142112,0,142112
16791,POSI3,2020-09-30,2020-11-09,141800,0,141800
16792,POSI3,2020-12-31,2021-03-17,141800,0,141800
16793,LPSB3,2010-12-31,2011-03-25,55202,0,55202
16794,LPSB3,2011-03-31,2011-05-17,55266,0,55266
16795,LPSB3,2011-06-30,2011-08-12,55845,0,55845
16796,LPSB3,2011-09-30,2011-11-09,56562,0,56562
16797,LPSB3,2011-12-31,2012-03-20,56562,0,56562
16798,LPSB3,2012-03-31,2012-05-10,56668,0,56668
16799,LPSB3,2012-06-30,2012-08-13,56668,0,56668
16800,LPSB3,2012-09-30,2012-11-13,57079,0,57079
16801,LPSB3,2012-12-31,2013-03-14,57079,0,57079
16802,LPSB3,2013-03-31,2013-05-09,114157,0,114157
16803,LPSB3,2013-06-30,2013-08-13,114157,0,114157
16804,LPSB3,2013-09-30,2013-11-08,114382,0,114382
16805,LPSB3,2013-12-31,2014-03-17,114382,0,114382
16806,LPSB3,2014-03-31,2014-05-09,114382,0,114382
16807,LPSB3,2014-06-30,2014-08-14,114382,0,114382
16808,LPSB3,2014-09-30,2014-11-14,114382,0,114382
16809,LPSB3,2014-12-31,2015-05-11,114382,0,114382
16810,LPSB3,2015-03-31,2015-05-11,114382,0,114382
16811,LPSB3,2015-06-30,2015-08-14,114519,0,114519
16812,LPSB3,2015-09-30,2015-11-13,114528,0,114528
16813,LPSB3,2015-12-31,2016-03-22,114577,0,114577
16814,LPSB3,2016-03-31,2016-05-09,114587,0,114587
16815,LPSB3,2016-06-30,2016-08-15,114615,0,114615
16816,LPSB3,2016-09-30,2016-11-10,114615,0,114615
16817,LPSB3,2016-12-31,2017-02-22,124731,0,124731
16818,LPSB3,2017-03-31,2017-05-12,124731,0,124731
16819,LPSB3,2017-06-30,2017-08-14,125133,0,125133
16820,LPSB3,2017-09-30,2017-11-13,125143,0,125143
16821,LPSB3,2017-12-31,2018-03-20,125143,0,125143
16822,LPSB3,2018-03-31,2018-07-31,125143,0,125143
16823,LPSB3,2018-06-30,2018-08-14,125653,0,125653
16824,LPSB3,2018-09-30,2018-11-14,125653,0,125653
16825,LPSB3,2018-12-31,2019-03-20,125663,0,125663
16826,LPSB3,2019-03-31,2019-05-09,125773,0,125773
16827,LPSB3,2019-06-30,2019-08-06,126555,0,126555
16828,LPSB3,2019-09-30,2019-11-14,126555,0,126555
16829,LPSB3,2019-12-31,2020-03-27,147555,0,147555
16830,LPSB3,2020-03-31,2020-06-29,147555,0,147555
16831,LPSB3,2020-06-30,2020-08-14,147555,0,147555
16832,LPSB3,2020-09-30,2020-11-11,147555,0,147555
16833,TCSA3,2010-12-31,2011-03-24,145383,0,145383
16834,TCSA3,2011-03-31,2011-05-11,185265,0,185265
16835,TCSA3,2011-06-30,2011-08-04,185265,0,185265
16836,TCSA3,2011-09-30,2011-11-10,185265,0,185265
16837,TCSA3,2011-12-31,2012-03-21,185967,0,185967
16838,TCSA3,2012-03-31,2012-05-14,185967,0,185967
16839,TCSA3,2012-06-30,2012-08-16,185967,0,185967
16840,TCSA3,2012-09-30,2012-11-13,185967,0,185967
16841,TCSA3,2012-12-31,2013-03-22,185967,0,185967
16842,TCSA3,2013-03-31,2013-05-24,185967,0,185967
16843,TCSA3,2013-06-30,2013-07-30,185967,0,185967
16844,TCSA3,2013-09-30,2013-10-31,185967,0,185967
16845,TCSA3,2013-12-31,2014-04-29,185967,0,185967
16846,TCSA3,2014-03-31,2014-04-29,180000,0,180000
16847,TCSA3,2014-06-30,2014-08-05,180000,0,180000
16848,TCSA3,2014-09-30,2014-10-29,180000,0,180000
16849,TCSA3,2014-12-31,2015-03-23,180000,0,180000
16850,TCSA3,2015-03-31,2015-04-29,180000,0,180000
16851,TCSA3,2015-06-30,2015-10-07,180000,0,180000
16852,TCSA3,2015-09-30,2015-11-12,180000,0,180000
16853,TCSA3,2015-12-31,2016-03-22,180000,0,180000
16854,TCSA3,2016-03-31,2016-05-13,173500,0,173500
16855,TCSA3,2016-06-30,2016-08-16,173500,0,173500
16856,TCSA3,2016-09-30,2016-11-10,191340,0,191340
16857,TCSA3,2016-12-31,2017-03-23,273500,0,273500
16858,TCSA3,2017-03-31,2017-05-10,296744,0,296744
16859,TCSA3,2017-06-30,2018-01-29,331192,0,331192
16860,TCSA3,2017-09-30,2018-01-29,331192,0,331192
16861,TCSA3,2017-12-31,2018-03-22,331192,0,331192
16862,TCSA3,2018-03-31,2018-05-10,331192,0,331192
16863,TCSA3,2018-06-30,2018-08-09,331192,0,331192
16864,TCSA3,2018-09-30,2018-11-08,331192,0,331192
16865,TCSA3,2018-12-31,2019-06-14,331192,0,331192
16866,TCSA3,2019-03-31,2019-05-09,331192,0,331192
16867,TCSA3,2019-06-30,2019-08-08,331192,0,331192
16868,TCSA3,2019-09-30,2019-11-08,736192,0,736192
16869,TCSA3,2019-12-31,2020-03-18,736192,0,736192
16870,TCSA3,2020-03-31,2020-05-14,736192,0,736192
16871,TCSA3,2020-06-30,2020-08-12,73619,0,73619
16872,TCSA3,2020-09-30,2020-11-11,73619,0,73619
16873,TCSA3,2020-12-31,2021-03-18,73619,0,73619
16874,RDNI3,2010-12-31,2011-03-10,48575,0,48575
16875,RDNI3,2011-03-31,2011-05-09,48575,0,48575
16876,RDNI3,2011-06-30,2011-08-15,48575,0,48575
16877,RDNI3,2011-09-30,2011-11-14,48575,0,48575
16878,RDNI3,2011-12-31,2012-03-22,48575,0,48575
16879,RDNI3,2012-03-31,2012-05-15,48575,0,48575
16880,RDNI3,2012-06-30,2012-08-10,48575,0,48575
16881,RDNI3,2012-09-30,2012-11-09,48575,0,48575
16882,RDNI3,2012-12-31,2013-03-26,48575,0,48575
16883,RDNI3,2013-03-31,2013-05-10,48575,0,48575
16884,RDNI3,2013-06-30,2013-08-09,48575,0,48575
16885,RDNI3,2013-09-30,2013-11-07,48575,0,48575
16886,RDNI3,2013-12-31,2014-03-20,48575,0,48575
16887,RDNI3,2014-03-31,2014-05-08,48575,0,48575
16888,RDNI3,2014-06-30,2014-08-11,48575,0,48575
16889,RDNI3,2014-09-30,2014-11-10,48575,0,48575
16890,RDNI3,2014-12-31,2015-03-19,44270,0,44270
16891,RDNI3,2015-03-31,2015-05-12,44270,0,44270
16892,RDNI3,2015-06-30,2015-08-11,44267,0,44267
16893,RDNI3,2015-09-30,2015-11-11,44270,0,44270
16894,RDNI3,2015-12-31,2016-03-17,43770,0,43770
16895,RDNI3,2016-03-31,2016-05-11,43770,0,43770
16896,RDNI3,2016-06-30,2017-11-07,43770,0,43770
16897,RDNI3,2016-09-30,2017-11-07,43770,0,43770
16898,RDNI3,2016-12-31,2017-03-16,43770,0,43770
16899,RDNI3,2017-03-31,2017-06-30,43770,0,43770
16900,RDNI3,2017-06-30,2017-08-11,43770,0,43770
16901,RDNI3,2017-09-30,2017-11-09,43770,0,43770
16902,RDNI3,2017-12-31,2018-03-15,43770,0,43770
16903,RDNI3,2018-03-31,2018-05-10,43770,0,43770
16904,RDNI3,2018-06-30,2018-08-09,43770,0,43770
16905,RDNI3,2018-09-30,2018-11-07,43770,0,43770
16906,RDNI3,2018-12-31,2019-03-14,43770,0,43770
16907,RDNI3,2019-03-31,2019-05-09,43770,0,43770
16908,RDNI3,2019-06-30,2019-08-08,43770,0,43770
16909,RDNI3,2019-09-30,2019-11-06,43770,0,43770
16910,RDNI3,2019-12-31,2020-03-11,43770,0,43770
16911,RDNI3,2020-03-31,2020-05-13,43770,0,43770
16912,RDNI3,2020-06-30,2020-08-12,43770,0,43770
16913,RDNI3,2020-09-30,2020-11-12,43770,0,43770
16914,RDNI3,2020-12-31,2021-03-12,43770,0,43770
16915,PDGR3,2010-12-31,2011-04-04,1106242,0,1106242
16916,PDGR3,2011-03-31,2011-08-24,1108170,0,1108170
16917,PDGR3,2011-06-30,2011-08-24,1123516,0,1123516
16918,PDGR3,2011-09-30,2011-12-16,1123632,0,1123632
16919,PDGR3,2011-12-31,2012-04-18,1123632,0,1123632
16920,PDGR3,2012-03-31,2012-05-14,1133129,0,1133129
16921,PDGR3,2012-06-30,2012-08-13,1140642,0,1140642
16922,PDGR3,2012-09-30,2012-11-21,1333648,0,1333648
16923,PDGR3,2012-12-31,2013-03-26,1333648,0,1333648
16924,PDGR3,2013-03-31,2013-05-09,1333648,0,1333648
16925,PDGR3,2013-06-30,2013-08-09,1339547,0,1339547
16926,PDGR3,2013-09-30,2013-11-06,1339547,0,1339547
16927,PDGR3,2013-12-31,2014-02-13,1339547,0,1339547
16928,PDGR3,2014-03-31,2014-05-09,1323264,0,1323264
16929,PDGR3,2014-06-30,2014-07-31,1323264,0,1323264
16930,PDGR3,2014-09-30,2014-10-30,1323264,0,1323264
16931,PDGR3,2014-12-31,2015-03-18,1323264,0,1323264
16932,PDGR3,2015-03-31,2015-05-06,1323264,0,1323264
16933,PDGR3,2015-06-30,2015-07-31,2459628,0,2459628
16934,PDGR3,2015-09-30,2015-11-04,2459627,0,2459627
16935,PDGR3,2015-12-31,2016-03-29,491932,0,491932
16936,PDGR3,2016-03-31,2016-05-11,49192,0,49192
16937,PDGR3,2016-06-30,2016-08-10,49192,0,49192
16938,PDGR3,2016-09-30,2016-11-15,49192,0,49192
16939,PDGR3,2016-12-31,2017-03-29,49192,0,49192
16940,PDGR3,2017-03-31,2017-05-15,49192,0,49192
16941,PDGR3,2017-06-30,2017-08-15,49192,0,49192
16942,PDGR3,2017-09-30,2017-11-03,49192,0,49192
16943,PDGR3,2017-12-31,2018-03-29,49192,0,49192
16944,PDGR3,2018-03-31,2018-05-17,49192,0,49192
16945,PDGR3,2018-06-30,2018-08-14,80669,0,80669
16946,PDGR3,2018-09-30,2018-11-14,80669,0,80669
16947,PDGR3,2018-12-31,2019-04-03,80669,0,80669
16948,PDGR3,2019-03-31,2019-05-15,8066,0,8066
16949,PDGR3,2019-06-30,2019-08-14,8066,0,8066
16950,PDGR3,2019-09-30,2019-11-14,8066,0,8066
16951,PDGR3,2019-12-31,2020-03-30,8066,0,8066
16952,PDGR3,2020-03-31,2020-05-15,8066,0,8066
16953,PDGR3,2020-06-30,2020-08-14,8066,0,8066
16954,PDGR3,2020-09-30,2020-11-13,8066,0,8066
16955,IGTA3,2010-12-31,2011-03-29,79255489,0,79255489
16956,IGTA3,2011-03-31,2011-05-17,79255894,0,79255894
16957,IGTA3,2011-06-30,2011-08-04,79255894,0,79255894
16958,IGTA3,2011-09-30,2011-11-08,79255489,0,79255489
16959,IGTA3,2011-12-31,2013-02-07,79255489,0,79255489
16960,IGTA3,2012-03-31,2013-02-07,79255489,0,79255489
16961,IGTA3,2012-06-30,2013-02-07,79255489,0,79255489
16962,IGTA3,2012-09-30,2013-02-07,79255489,0,79255489
16963,IGTA3,2012-12-31,2013-05-21,158510978,0,158510978
16964,IGTA3,2013-03-31,2013-05-21,158510978,0,158510978
16965,IGTA3,2013-06-30,2013-08-16,174510978,0,174510978
16966,IGTA3,2013-09-30,2013-11-07,176611578,0,176611578
16967,IGTA3,2013-12-31,2014-04-03,176611578,0,176611578
16968,IGTA3,2014-03-31,2014-05-06,176611578,0,176611578
16969,IGTA3,2014-06-30,2014-08-12,176611578,0,176611578
16970,IGTA3,2014-09-30,2014-11-03,176611578,0,176611578
16971,IGTA3,2014-12-31,2015-03-19,176611578,0,176611578
16972,IGTA3,2015-03-31,2015-05-11,176611578,0,176611578
16973,IGTA3,2015-06-30,2015-08-10,176611578,0,176611578
16974,IGTA3,2015-09-30,2015-11-10,176611578,0,176611578
16975,IGTA3,2015-12-31,2016-03-08,176611578,0,176611578
16976,IGTA3,2016-03-31,2016-05-10,176611578,0,176611578
16977,IGTA3,2016-06-30,2016-08-09,176611578,0,176611578
16978,IGTA3,2016-09-30,2016-11-08,176611578,0,176611578
16979,IGTA3,2016-12-31,2017-02-21,176611578,0,176611578
16980,IGTA3,2017-03-31,2017-05-09,176611578,0,176611578
16981,IGTA3,2017-06-30,2017-08-08,176611578,0,176611578
16982,IGTA3,2017-09-30,2017-11-07,176611578,0,176611578
16983,IGTA3,2017-12-31,2018-02-27,176611578,0,176611578
16984,IGTA3,2018-03-31,2018-05-08,176611578,0,176611578
16985,IGTA3,2018-06-30,2018-08-07,176611578,0,176611578
16986,IGTA3,2018-09-30,2018-11-06,176611578,0,176611578
16987,IGTA3,2018-12-31,2019-02-26,176611578,0,176611578
16988,IGTA3,2019-03-31,2019-05-07,176611578,0,176611578
16989,IGTA3,2019-06-30,2019-08-06,176611578,0,176611578
16990,IGTA3,2019-09-30,2019-11-07,176611578,0,176611578
16991,IGTA3,2019-12-31,2020-02-18,176611578,0,176611578
16992,IGTA3,2020-03-31,2020-05-26,176611578,0,176611578
16993,IGTA3,2020-06-30,2020-08-04,176611578,0,176611578
16994,IGTA3,2020-09-30,2020-11-05,176611578,0,176611578
16995,IGTA3,2020-12-31,2021-03-04,176611578,0,176611578
16996,SMTO3,2011-03-31,2011-06-28,113000000,0,113000000
16997,SMTO3,2011-06-30,2011-08-15,113000000,0,113000000
16998,SMTO3,2011-09-30,2011-11-14,113000000,0,113000000
16999,SMTO3,2011-12-31,2012-02-14,113000000,0,113000000
17000,SMTO3,2012-03-31,2012-06-25,113000000,0,113000000
17001,SMTO3,2012-06-30,2012-08-14,113000000,0,113000000
17002,SMTO3,2012-09-30,2012-11-07,113000000,0,113000000
17003,SMTO3,2012-12-31,2013-02-06,113000000,0,113000000
17004,SMTO3,2013-03-31,2013-06-24,113000000,0,113000000
17005,SMTO3,2013-06-30,2013-08-12,113000000,0,113000000
17006,SMTO3,2013-09-30,2013-11-11,113000000,0,113000000
17007,SMTO3,2013-12-31,2014-02-13,113000000,0,113000000
17008,SMTO3,2014-03-31,2014-06-16,113000000,0,113000000
17009,SMTO3,2014-06-30,2014-08-11,113000000,0,113000000
17010,SMTO3,2014-09-30,2014-11-10,113000000,0,113000000
17011,SMTO3,2014-12-31,2015-02-09,113329207,0,113329207
17012,SMTO3,2015-03-31,2015-07-08,113329207,0,113329207
17013,SMTO3,2015-06-30,2015-08-10,113329207,0,113329207
17014,SMTO3,2015-09-30,2015-11-09,113329207,0,113329207
17015,SMTO3,2015-12-31,2016-02-12,113329207,0,113329207
17016,SMTO3,2016-03-31,2016-06-06,113329207,0,113329207
17017,SMTO3,2016-06-30,2016-08-08,113329207,0,113329207
17018,SMTO3,2016-09-30,2016-11-09,113329207,0,113329207
17019,SMTO3,2016-12-31,2017-02-08,339987621,0,339987621
17020,SMTO3,2017-03-31,2017-06-26,364011329,0,364011329
17021,SMTO3,2017-06-30,2017-08-14,364011329,0,364011329
17022,SMTO3,2017-09-30,2017-11-09,364011329,0,364011329
17023,SMTO3,2017-12-31,2018-02-08,364011329,0,364011329
17024,SMTO3,2018-03-31,2018-06-25,364011329,0,364011329
17025,SMTO3,2018-06-30,2018-08-13,364011329,0,364011329
17026,SMTO3,2018-09-30,2018-11-06,364011329,0,364011329
17027,SMTO3,2018-12-31,2019-02-11,364011329,0,364011329
17028,SMTO3,2019-03-31,2019-06-24,364011329,0,364011329
17029,SMTO3,2019-06-30,2019-08-12,351011329,0,351011329
17030,SMTO3,2019-09-30,2019-11-11,354011329,0,354011329
17031,SMTO3,2019-12-31,2020-02-10,354011329,0,354011329
17032,SMTO3,2020-03-31,2020-06-29,354011329,0,354011329
17033,SMTO3,2020-06-30,2020-08-10,354011329,0,354011329
17034,SMTO3,2020-09-30,2021-02-18,354011329,0,354011329
17035,SMTO3,2020-12-31,2021-02-18,354011329,0,354011329
17036,EVEN3,2010-12-31,2011-03-29,233293408,0,233293408
17037,EVEN3,2011-03-31,2011-05-09,223293408,0,223293408
17038,EVEN3,2011-06-30,2011-08-10,233293408,0,233293408
17039,EVEN3,2011-09-30,2011-11-09,233293408,0,233293408
17040,EVEN3,2011-12-31,2012-03-27,233293408,0,233293408
17041,EVEN3,2012-03-31,2012-05-07,233293408,0,233293408
17042,EVEN3,2012-06-30,2012-08-07,233293,0,233293
17043,EVEN3,2012-09-30,2012-12-11,233293,0,233293
17044,EVEN3,2012-12-31,2013-03-04,233293408,0,233293408
17045,EVEN3,2013-03-31,2013-05-08,233293408,0,233293408
17046,EVEN3,2013-06-30,2013-08-12,233293408,0,233293408
17047,EVEN3,2013-09-30,2013-11-06,233293408,0,233293408
17048,EVEN3,2013-12-31,2014-02-24,233293408,0,233293408
17049,EVEN3,2014-03-31,2014-05-07,233293408,0,233293408
17050,EVEN3,2014-06-30,2014-08-12,233293408,0,233293408
17051,EVEN3,2014-09-30,2014-11-13,233293408,0,233293408
17052,EVEN3,2014-12-31,2015-03-16,233293408,0,233293408
17053,EVEN3,2015-03-31,2015-05-07,233293408,0,233293408
17054,EVEN3,2015-06-30,2015-08-07,233293408,0,233293408
17055,EVEN3,2015-09-30,2015-12-07,233293408,0,233293408
17056,EVEN3,2015-12-31,2016-03-30,233293408,0,233293408
17057,EVEN3,2016-03-31,2016-05-12,225000000,0,225000000
17058,EVEN3,2016-06-30,2016-08-11,225000000,0,225000000
17059,EVEN3,2016-09-30,2016-11-11,225000000,0,225000000
17060,EVEN3,2016-12-31,2017-03-22,225000000,0,225000000
17061,EVEN3,2017-03-31,2017-05-15,225000000,0,225000000
17062,EVEN3,2017-06-30,2017-08-14,225000000,0,225000000
17063,EVEN3,2017-09-30,2017-11-13,225000000,0,225000000
17064,EVEN3,2017-12-31,2018-03-26,225000000,0,225000000
17065,EVEN3,2018-03-31,2018-05-10,225000000,0,225000000
17066,EVEN3,2018-06-30,2018-08-13,225000000,0,225000000
17067,EVEN3,2018-09-30,2018-11-13,225000000,0,225000000
17068,EVEN3,2018-12-31,2019-03-28,217000000,0,217000000
17069,EVEN3,2019-03-31,2019-05-09,217000000,0,217000000
17070,EVEN3,2019-06-30,2019-08-14,217000000,0,217000000
17071,EVEN3,2019-09-30,2019-11-12,217000000,0,217000000
17072,EVEN3,2019-12-31,2020-03-30,217000000,0,217000000
17073,EVEN3,2020-03-31,2020-05-15,217000000,0,217000000
17074,EVEN3,2020-06-30,2020-07-30,212000000,0,212000000
17075,EVEN3,2020-09-30,2020-11-12,212000000,0,212000000
17076,EVEN3,2020-09-30,2020-11-12,212000000,0,212000000
17077,EVEN3,2020-12-31,2021-03-18,212000000,0,212000000
17078,SANB11,2010-12-31,2011-03-28,212841732,186202385,399044117
17079,SANB11,2011-03-31,2011-04-28,212841732,186202385,399044117
17080,SANB11,2011-06-30,2011-07-27,212841732,186202385,399044117
17081,SANB11,2011-09-30,2011-10-27,212841732,186202385,399044117
17082,SANB11,2011-12-31,2012-03-19,212841732,186202385,399044117
17083,SANB11,2012-03-31,2012-04-26,212841732,186202385,399044117
17084,SANB11,2012-06-30,2012-07-26,212841732,186202385,399044117
17085,SANB11,2012-09-30,2012-10-25,212841732,186202385,399044117
17086,SANB11,2012-12-31,2013-03-29,212841732,186202385,399044117
17087,SANB11,2013-03-31,2013-04-25,212841732,186202385,399044117
17088,SANB11,2013-06-30,2013-07-30,212841732,186202385,399044117
17089,SANB11,2013-09-30,2013-10-28,212841732,186202385,399044117
17090,SANB11,2013-12-31,2014-06-18,212841732,186202385,399044117
17091,SANB11,2014-03-31,2014-06-20,212841732,186202385,399044117
17092,SANB11,2014-06-30,2014-07-31,3869850,3730990,7600840
17093,SANB11,2014-09-30,2014-11-04,3844766,3705906,7550672
17094,SANB11,2014-12-31,2015-03-31,3840238,3701378,7541616
17095,SANB11,2015-03-31,2015-04-28,3842577,3703717,7546294
17096,SANB11,2015-06-30,2015-07-30,3869850,3730990,7600840
17097,SANB11,2015-09-30,2015-10-29,3869849,3730991,7600840
17098,SANB11,2015-12-31,2016-02-29,3830753,3691894,7522647
17099,SANB11,2016-03-31,2016-04-27,3829491,3690632,7520123
17100,SANB11,2016-06-30,2016-07-27,3826465,3687605,7514070
17101,SANB11,2016-09-30,2016-10-26,3827637,3688778,7516415
17102,SANB11,2016-12-31,2017-02-24,3825185,3686326,7511511
17103,SANB11,2017-03-31,2017-04-26,3829485,3690626,7520111
17104,SANB11,2017-06-30,2017-07-28,3850971,3712111,7563082
17105,SANB11,2017-09-30,2017-10-25,3818695,3679836,7498531
17106,SANB11,2017-12-31,2018-07-30,3812850,3673991,7486841
17107,SANB11,2018-03-31,2018-07-30,3818695,3679836,7498531
17108,SANB11,2018-06-30,2018-08-02,3818695,3679836,7498531
17109,SANB11,2018-09-30,2018-10-31,3807635,3668776,7476411
17110,SANB11,2018-12-31,2019-02-28,3805378,3666519,7471897
17111,SANB11,2019-03-31,2019-04-30,3805067,3666208,7471275
17112,SANB11,2019-06-30,2019-07-23,3818695,3679836,7498531
17113,SANB11,2019-09-30,2019-10-30,3818695,3679836,7498531
17114,SANB11,2019-12-31,2020-03-12,3818695,3679836,7498531
17115,SANB11,2020-03-31,2020-04-28,3818695,3679836,7498531
17116,SANB11,2020-06-30,2020-07-29,3818695,3679836,7498531
17117,SANB11,2020-09-30,2020-10-27,3818695,3679836,7498531
17118,SANB11,2020-12-31,2021-02-26,3818695,3679836,7498531
17119,SANB3,2010-12-31,2011-03-28,212841732,186202385,399044117
17120,SANB3,2011-03-31,2011-04-28,212841732,186202385,399044117
17121,SANB3,2011-06-30,2011-07-27,212841732,186202385,399044117
17122,SANB3,2011-09-30,2011-10-27,212841732,186202385,399044117
17123,SANB3,2011-12-31,2012-03-19,212841732,186202385,399044117
17124,SANB3,2012-03-31,2012-04-26,212841732,186202385,399044117
17125,SANB3,2012-06-30,2012-07-26,212841732,186202385,399044117
17126,SANB3,2012-09-30,2012-10-25,212841732,186202385,399044117
17127,SANB3,2012-12-31,2013-03-29,212841732,186202385,399044117
17128,SANB3,2013-03-31,2013-04-25,212841732,186202385,399044117
17129,SANB3,2013-06-30,2013-07-30,212841732,186202385,399044117
17130,SANB3,2013-09-30,2013-10-28,212841732,186202385,399044117
17131,SANB3,2013-12-31,2014-06-18,212841732,186202385,399044117
17132,SANB3,2014-03-31,2014-06-20,212841732,186202385,399044117
17133,SANB3,2014-06-30,2014-07-31,3869850,3730990,7600840
17134,SANB3,2014-09-30,2014-11-04,3844766,3705906,7550672
17135,SANB3,2014-12-31,2015-03-31,3840238,3701378,7541616
17136,SANB3,2015-03-31,2015-04-28,3842577,3703717,7546294
17137,SANB3,2015-06-30,2015-07-30,3869850,3730990,7600840
17138,SANB3,2015-09-30,2015-10-29,3869849,3730991,7600840
17139,SANB3,2015-12-31,2016-02-29,3830753,3691894,7522647
17140,SANB3,2016-03-31,2016-04-27,3829491,3690632,7520123
17141,SANB3,2016-06-30,2016-07-27,3826465,3687605,7514070
17142,SANB3,2016-09-30,2016-10-26,3827637,3688778,7516415
17143,SANB3,2016-12-31,2017-02-24,3825185,3686326,7511511
17144,SANB3,2017-03-31,2017-04-26,3829485,3690626,7520111
17145,SANB3,2017-06-30,2017-07-28,3850971,3712111,7563082
17146,SANB3,2017-09-30,2017-10-25,3818695,3679836,7498531
17147,SANB3,2017-12-31,2018-07-30,3812850,3673991,7486841
17148,SANB3,2018-03-31,2018-07-30,3818695,3679836,7498531
17149,SANB3,2018-06-30,2018-08-02,3818695,3679836,7498531
17150,SANB3,2018-09-30,2018-10-31,3807635,3668776,7476411
17151,SANB3,2018-12-31,2019-02-28,3805378,3666519,7471897
17152,SANB3,2019-03-31,2019-04-30,3805067,3666208,7471275
17153,SANB3,2019-06-30,2019-07-23,3818695,3679836,7498531
17154,SANB3,2019-09-30,2019-10-30,3818695,3679836,7498531
17155,SANB3,2019-12-31,2020-03-12,3818695,3679836,7498531
17156,SANB3,2020-03-31,2020-04-28,3818695,3679836,7498531
17157,SANB3,2020-06-30,2020-07-29,3818695,3679836,7498531
17158,SANB3,2020-09-30,2020-10-27,3818695,3679836,7498531
17159,SANB3,2020-12-31,2021-02-26,3818695,3679836,7498531
17160,SANB4,2010-12-31,2011-03-28,212841732,186202385,399044117
17161,SANB4,2011-03-31,2011-04-28,212841732,186202385,399044117
17162,SANB4,2011-06-30,2011-07-27,212841732,186202385,399044117
17163,SANB4,2011-09-30,2011-10-27,212841732,186202385,399044117
17164,SANB4,2011-12-31,2012-03-19,212841732,186202385,399044117
17165,SANB4,2012-03-31,2012-04-26,212841732,186202385,399044117
17166,SANB4,2012-06-30,2012-07-26,212841732,186202385,399044117
17167,SANB4,2012-09-30,2012-10-25,212841732,186202385,399044117
17168,SANB4,2012-12-31,2013-03-29,212841732,186202385,399044117
17169,SANB4,2013-03-31,2013-04-25,212841732,186202385,399044117
17170,SANB4,2013-06-30,2013-07-30,212841732,186202385,399044117
17171,SANB4,2013-09-30,2013-10-28,212841732,186202385,399044117
17172,SANB4,2013-12-31,2014-06-18,212841732,186202385,399044117
17173,SANB4,2014-03-31,2014-06-20,212841732,186202385,399044117
17174,SANB4,2014-06-30,2014-07-31,3869850,3730990,7600840
17175,SANB4,2014-09-30,2014-11-04,3844766,3705906,7550672
17176,SANB4,2014-12-31,2015-03-31,3840238,3701378,7541616
17177,SANB4,2015-03-31,2015-04-28,3842577,3703717,7546294
17178,SANB4,2015-06-30,2015-07-30,3869850,3730990,7600840
17179,SANB4,2015-09-30,2015-10-29,3869849,3730991,7600840
17180,SANB4,2015-12-31,2016-02-29,3830753,3691894,7522647
17181,SANB4,2016-03-31,2016-04-27,3829491,3690632,7520123
17182,SANB4,2016-06-30,2016-07-27,3826465,3687605,7514070
17183,SANB4,2016-09-30,2016-10-26,3827637,3688778,7516415
17184,SANB4,2016-12-31,2017-02-24,3825185,3686326,7511511
17185,SANB4,2017-03-31,2017-04-26,3829485,3690626,7520111
17186,SANB4,2017-06-30,2017-07-28,3850971,3712111,7563082
17187,SANB4,2017-09-30,2017-10-25,3818695,3679836,7498531
17188,SANB4,2017-12-31,2018-07-30,3812850,3673991,7486841
17189,SANB4,2018-03-31,2018-07-30,3818695,3679836,7498531
17190,SANB4,2018-06-30,2018-08-02,3818695,3679836,7498531
17191,SANB4,2018-09-30,2018-10-31,3807635,3668776,7476411
17192,SANB4,2018-12-31,2019-02-28,3805378,3666519,7471897
17193,SANB4,2019-03-31,2019-04-30,3805067,3666208,7471275
17194,SANB4,2019-06-30,2019-07-23,3818695,3679836,7498531
17195,SANB4,2019-09-30,2019-10-30,3818695,3679836,7498531
17196,SANB4,2019-12-31,2020-03-12,3818695,3679836,7498531
17197,SANB4,2020-03-31,2020-04-28,3818695,3679836,7498531
17198,SANB4,2020-06-30,2020-07-29,3818695,3679836,7498531
17199,SANB4,2020-09-30,2020-10-27,3818695,3679836,7498531
17200,SANB4,2020-12-31,2021-02-26,3818695,3679836,7498531
17201,CPRE3,2010-12-31,2011-03-03,708403499,0,708403499
17202,CPRE3,2011-03-31,2011-05-16,708403499,0,708403499
17203,CPRE3,2011-06-30,2011-08-11,708403499,0,708403499
17204,CPRE3,2011-09-30,2011-11-11,1676101458,0,1676101458
17205,CPRE3,2011-12-31,2012-03-07,2061370145,0,2061370145
17206,CPRE3,2012-03-31,2012-05-03,2061370145,0,2061370145
17207,CPRE3,2012-06-30,2012-08-02,412274029,0,412274029
17208,CPRE3,2012-09-30,2012-10-31,412274029,0,412274029
17209,CPRE3,2012-12-31,2013-03-18,412274029,0,412274029
17210,CPRE3,2013-03-31,2013-05-08,412274029,0,412274029
17211,CPRE3,2013-06-30,2013-08-14,412274029,0,412274029
17212,CPRE3,2013-09-30,2013-11-12,441425692,0,441425692
17213,CPRE3,2013-12-31,2014-03-25,441425692,0,441425692
17214,CPRE3,2014-03-31,2014-05-08,441486996,0,441486996
17215,CPRE3,2014-06-30,2014-08-12,441529878,0,441529878
17216,CPRE3,2014-09-30,2014-11-12,441529878,0,441529878
17217,CPRE3,2014-12-31,2015-03-24,503308389,0,503308389
17218,CPRE3,2015-03-31,2015-05-07,503308389,0,503308389
17219,CPRE3,2015-06-30,2015-08-12,503308389,0,503308389
17220,CPRE3,2015-09-30,2015-11-11,503308389,0,503308389
17221,CPRE3,2015-12-31,2016-03-16,503308389,0,503308389
17222,CPRE3,2016-03-31,2016-05-12,503308389,0,503308389
17223,CPRE3,2016-06-30,2016-08-10,503308389,0,503308389
17224,CPRE3,2016-09-30,2016-11-09,503351271,0,503351271
17225,CPRE3,2016-12-31,2017-03-22,503351271,0,503351271
17226,CPRE3,2017-03-31,2017-05-10,503351271,0,503351271
17227,CPRE3,2017-06-30,2017-08-09,503351271,0,503351271
17228,CPRE3,2017-09-30,2017-11-09,503351271,0,503351271
17229,CPRE3,2017-12-31,2018-03-22,503351271,0,503351271
17230,CPRE3,2018-03-31,2018-05-11,503351271,0,503351271
17231,CPRE3,2018-06-30,2018-08-09,503351271,0,503351271
17232,CPRE3,2018-09-30,2018-11-08,503351271,0,503351271
17233,CPRE3,2018-12-31,2019-03-25,503811489,0,503811489
17234,CPRE3,2019-03-31,2019-05-06,503811489,0,503811489
17235,CPRE3,2019-06-30,2019-08-07,521315091,0,521315091
17236,CPRE3,2019-09-30,2019-11-11,521315091,0,521315091
17237,CPRE3,2019-12-31,2020-03-09,521315091,0,521315091
17238,CPRE3,2020-03-31,2020-05-14,521315091,0,521315091
17239,CPRE3,2020-06-30,2020-08-13,521315091,0,521315091
17240,CPRE3,2020-09-30,2020-11-12,593782504,0,593782504
17241,CPRE3,2020-12-31,2021-03-25,593782504,0,593782504
17242,PINE3,2010-12-31,2011-03-21,45444,39965,85409
17243,PINE3,2011-03-31,2011-06-28,45444,39965,85409
17244,PINE3,2011-06-30,2011-08-11,45444,39965,85409
17245,PINE3,2011-09-30,2011-11-11,45443872,38590394,84034266
17246,PINE3,2011-12-31,2012-03-05,45443872,38590394,84034266
17247,PINE3,2012-03-31,2012-05-28,51886766,46966008,98852774
17248,PINE3,2012-06-30,2012-08-21,51886766,46966008,98852774
17249,PINE3,2012-09-30,2012-11-14,51886766,46966008,98852774
17250,PINE3,2012-12-31,2013-02-26,58444889,50186211,108631100
17251,PINE3,2013-03-31,2013-05-15,58444889,50186211,108631100
17252,PINE3,2013-06-30,2013-08-12,58444889,52397424,110842313
17253,PINE3,2013-09-30,2013-11-14,58444889,52397424,110842313
17254,PINE3,2013-12-31,2014-02-27,58444889,52397424,110842313
17255,PINE3,2014-03-31,2014-05-23,65178483,55869285,121047768
17256,PINE3,2014-06-30,2014-09-09,65178483,55993541,121172024
17257,PINE3,2014-09-30,2014-11-26,65178483,55993541,121172024
17258,PINE3,2014-12-31,2015-03-19,65178483,55993541,121172024
17259,PINE3,2015-03-31,2015-05-11,65178483,55993541,121172024
17260,PINE3,2015-06-30,2015-08-12,65178483,55993541,121172024
17261,PINE3,2015-09-30,2015-11-09,65178483,55993541,121172024
17262,PINE3,2015-12-31,2016-03-10,65178483,55993541,121172024
17263,PINE3,2016-03-31,2016-05-10,65178483,55993541,121172024
17264,PINE3,2016-06-30,2016-08-08,65178483,55993541,121172024
17265,PINE3,2016-09-30,2016-11-14,65178483,55993541,121172024
17266,PINE3,2016-12-31,2017-03-30,65178483,55993541,121172024
17267,PINE3,2017-03-31,2017-05-08,65178483,55993541,121172024
17268,PINE3,2017-06-30,2017-08-14,65178483,55993541,121172024
17269,PINE3,2017-09-30,2017-11-09,65178483,55993541,121172024
17270,PINE3,2017-12-31,2018-03-29,65178483,55993541,121172024
17271,PINE3,2018-03-31,2018-05-07,65178483,55993541,121172024
17272,PINE3,2018-06-30,2018-08-06,65178483,55993541,121172024
17273,PINE3,2018-09-30,2018-11-08,65178483,55993541,121172024
17274,PINE3,2018-12-31,2019-03-29,65178483,55993541,121172024
17275,PINE3,2019-03-31,2019-05-09,65178483,55993541,121172024
17276,PINE3,2019-06-30,2019-08-16,65178483,55993541,121172024
17277,PINE3,2019-09-30,2019-11-11,65178483,55992912,121171395
17278,PINE3,2019-12-31,2020-04-29,75577842,72579922,148157764
17279,PINE3,2020-03-31,2020-05-13,75577842,72579922,148157764
17280,PINE3,2020-06-30,2020-08-12,75577842,72579922,148157764
17281,PINE3,2020-09-30,2020-11-11,75577842,72579922,148157764
17282,PINE3,2020-12-31,2021-02-10,75577842,72579922,148157764
17283,PINE4,2010-12-31,2011-03-21,45444,39965,85409
17284,PINE4,2011-03-31,2011-06-28,45444,39965,85409
17285,PINE4,2011-06-30,2011-08-11,45444,39965,85409
17286,PINE4,2011-09-30,2011-11-11,45443872,38590394,84034266
17287,PINE4,2011-12-31,2012-03-05,45443872,38590394,84034266
17288,PINE4,2012-03-31,2012-05-28,51886766,46966008,98852774
17289,PINE4,2012-06-30,2012-08-21,51886766,46966008,98852774
17290,PINE4,2012-09-30,2012-11-14,51886766,46966008,98852774
17291,PINE4,2012-12-31,2013-02-26,58444889,50186211,108631100
17292,PINE4,2013-03-31,2013-05-15,58444889,50186211,108631100
17293,PINE4,2013-06-30,2013-08-12,58444889,52397424,110842313
17294,PINE4,2013-09-30,2013-11-14,58444889,52397424,110842313
17295,PINE4,2013-12-31,2014-02-27,58444889,52397424,110842313
17296,PINE4,2014-03-31,2014-05-23,65178483,55869285,121047768
17297,PINE4,2014-06-30,2014-09-09,65178483,55993541,121172024
17298,PINE4,2014-09-30,2014-11-26,65178483,55993541,121172024
17299,PINE4,2014-12-31,2015-03-19,65178483,55993541,121172024
17300,PINE4,2015-03-31,2015-05-11,65178483,55993541,121172024
17301,PINE4,2015-06-30,2015-08-12,65178483,55993541,121172024
17302,PINE4,2015-09-30,2015-11-09,65178483,55993541,121172024
17303,PINE4,2015-12-31,2016-03-10,65178483,55993541,121172024
17304,PINE4,2016-03-31,2016-05-10,65178483,55993541,121172024
17305,PINE4,2016-06-30,2016-08-08,65178483,55993541,121172024
17306,PINE4,2016-09-30,2016-11-14,65178483,55993541,121172024
17307,PINE4,2016-12-31,2017-03-30,65178483,55993541,121172024
17308,PINE4,2017-03-31,2017-05-08,65178483,55993541,121172024
17309,PINE4,2017-06-30,2017-08-14,65178483,55993541,121172024
17310,PINE4,2017-09-30,2017-11-09,65178483,55993541,121172024
17311,PINE4,2017-12-31,2018-03-29,65178483,55993541,121172024
17312,PINE4,2018-03-31,2018-05-07,65178483,55993541,121172024
17313,PINE4,2018-06-30,2018-08-06,65178483,55993541,121172024
17314,PINE4,2018-09-30,2018-11-08,65178483,55993541,121172024
17315,PINE4,2018-12-31,2019-03-29,65178483,55993541,121172024
17316,PINE4,2019-03-31,2019-05-09,65178483,55993541,121172024
17317,PINE4,2019-06-30,2019-08-16,65178483,55993541,121172024
17318,PINE4,2019-09-30,2019-11-11,65178483,55992912,121171395
17319,PINE4,2019-12-31,2020-04-29,75577842,72579922,148157764
17320,PINE4,2020-03-31,2020-05-13,75577842,72579922,148157764
17321,PINE4,2020-06-30,2020-08-12,75577842,72579922,148157764
17322,PINE4,2020-09-30,2020-11-11,75577842,72579922,148157764
17323,PINE4,2020-12-31,2021-02-10,75577842,72579922,148157764
17324,JBSS3,2010-12-31,2011-03-24,2567471476,0,2567471476
17325,JBSS3,2011-03-31,2011-05-11,2567471476,0,2567471476
17326,JBSS3,2011-06-30,2012-04-05,2567471476,0,2567471476
17327,JBSS3,2011-09-30,2012-04-05,3061444191,0,3061444191
17328,JBSS3,2011-12-31,2012-03-21,3061444191,0,3061444191
17329,JBSS3,2012-03-31,2012-05-15,2963924296,0,2963924296
17330,JBSS3,2012-06-30,2012-08-14,2963924296,0,2963924296
17331,JBSS3,2012-09-30,2012-11-13,2943644008,0,2943644008
17332,JBSS3,2012-12-31,2013-10-07,2943644008,0,2943644008
17333,JBSS3,2013-03-31,2013-05-14,2943644008,0,2943644008
17334,JBSS3,2013-06-30,2013-11-06,2943644008,0,2943644008
17335,JBSS3,2013-09-30,2013-11-13,2943644008,0,2943644008
17336,JBSS3,2013-12-31,2014-03-24,2943644008,0,2943644008
17337,JBSS3,2014-03-31,2014-05-15,2943644008,0,2943644008
17338,JBSS3,2014-06-30,2014-08-14,2943644008,0,2943644008
17339,JBSS3,2014-09-30,2014-11-12,2943644008,0,2943644008
17340,JBSS3,2014-12-31,2016-08-05,2943644008,0,2943644008
17341,JBSS3,2015-03-31,2015-05-13,2944389270,0,2944389270
17342,JBSS3,2015-06-30,2015-08-13,2944425560,0,2944425560
17343,JBSS3,2015-09-30,2015-11-11,2856857505,0,2856857505
17344,JBSS3,2015-12-31,2017-04-07,2856857505,0,2856857505
17345,JBSS3,2016-03-31,2016-08-05,2856857505,0,2856857505
17346,JBSS3,2016-06-30,2016-08-10,2856857505,0,2856857505
17347,JBSS3,2016-09-30,2016-11-14,2856857505,0,2856857505
17348,JBSS3,2016-12-31,2017-04-07,2856857505,0,2856857505
17349,JBSS3,2017-03-31,2018-03-29,2728747412,0,2728747412
17350,JBSS3,2017-06-30,2018-03-29,2728747412,0,2728747412
17351,JBSS3,2017-09-30,2018-03-29,2728747412,0,2728747412
17352,JBSS3,2017-12-31,2018-03-28,2728747412,0,2728747412
17353,JBSS3,2018-03-31,2018-05-14,2728747412,0,2728747412
17354,JBSS3,2018-06-30,2018-08-14,2728747412,0,2728747412
17355,JBSS3,2018-09-30,2018-11-13,2728747412,0,2728747412
17356,JBSS3,2018-12-31,2019-03-28,2728747412,0,2728747412
17357,JBSS3,2019-03-31,2019-05-14,2728747412,0,2728747412
17358,JBSS3,2019-06-30,2019-08-14,2728747412,0,2728747412
17359,JBSS3,2019-09-30,2019-11-14,2728747412,0,2728747412
17360,JBSS3,2019-12-31,2020-03-25,2728747412,0,2728747412
17361,JBSS3,2020-03-31,2020-05-14,2728747412,0,2728747412
17362,JBSS3,2020-06-30,2020-08-13,2728747412,0,2728747412
17363,JBSS3,2020-09-30,2020-11-11,2666079023,0,2666079023
17364,JBSS3,2020-12-31,2021-03-24,2623373646,0,2623373646
17365,JHSF3,2010-12-31,2011-03-30,426374825,0,426374825
17366,JHSF3,2011-03-31,2011-05-17,426374825,0,426374825
17367,JHSF3,2011-06-30,2011-08-15,426374825,0,426374825
17368,JHSF3,2011-09-30,2011-11-10,427074825,0,427074825
17369,JHSF3,2011-12-31,2012-03-26,428762581,0,428762581
17370,JHSF3,2012-03-31,2012-05-15,428989318,0,428989318
17371,JHSF3,2012-06-30,2012-08-14,429999185,0,429999185
17372,JHSF3,2012-09-30,2012-11-12,430264187,0,430264187
17373,JHSF3,2012-12-31,2013-03-27,430550735,0,430550735
17374,JHSF3,2013-03-31,2013-05-14,431327816,0,431327816
17375,JHSF3,2013-06-30,2013-08-14,431434183,0,431434183
17376,JHSF3,2013-09-30,2013-11-14,431816420,0,431816420
17377,JHSF3,2013-12-31,2014-03-25,432043157,0,432043157
17378,JHSF3,2014-03-31,2014-05-13,432043157,0,432043157
17379,JHSF3,2014-06-30,2014-08-13,432043157,0,432043157
17380,JHSF3,2014-09-30,2014-11-13,432269894,0,432269894
17381,JHSF3,2014-12-31,2015-03-12,432269894,0,432269894
17382,JHSF3,2015-03-31,2015-05-11,432269894,0,432269894
17383,JHSF3,2015-06-30,2015-08-13,525000000,0,525000000
17384,JHSF3,2015-09-30,2015-11-12,525000000,0,525000000
17385,JHSF3,2015-12-31,2016-03-30,525000000,0,525000000
17386,JHSF3,2016-03-31,2016-05-16,525000000,0,525000000
17387,JHSF3,2016-06-30,2016-08-16,525000000,0,525000000
17388,JHSF3,2016-09-30,2016-11-15,525000000,0,525000000
17389,JHSF3,2016-12-31,2017-03-30,525000000,0,525000000
17390,JHSF3,2017-03-31,2017-05-15,525661247,0,525661247
17391,JHSF3,2017-06-30,2017-08-14,525661247,0,525661247
17392,JHSF3,2017-09-30,2017-11-10,525661247,0,525661247
17393,JHSF3,2017-12-31,2018-04-16,525661247,0,525661247
17394,JHSF3,2018-03-31,2018-05-14,526383839,0,526383839
17395,JHSF3,2018-06-30,2018-08-09,526383839,0,526383839
17396,JHSF3,2018-09-30,2018-11-08,526383839,0,526383839
17397,JHSF3,2018-12-31,2019-02-21,526383839,0,526383839
17398,JHSF3,2019-03-31,2019-05-07,527233245,0,527233245
17399,JHSF3,2019-06-30,2019-08-21,530059981,0,530059981
17400,JHSF3,2019-09-30,2019-10-30,530059981,0,530059981
17401,JHSF3,2019-12-31,2020-02-13,638059981,0,638059981
17402,JHSF3,2020-03-31,2020-05-14,641241829,0,641241829
17403,JHSF3,2020-06-30,2020-08-13,641241829,0,641241829
17404,JHSF3,2020-09-30,2020-11-05,685530641,0,685530641
17405,JHSF3,2020-12-31,2021-02-18,684810641,0,684810641
17406,FRIO3,2010-12-31,2011-02-24,41439,0,41439
17407,FRIO3,2011-03-31,2011-05-13,41439,0,41439
17408,FRIO3,2011-06-30,2011-08-05,41439,0,41439
17409,FRIO3,2011-09-30,2011-11-10,41439,0,41439
17410,FRIO3,2011-12-31,2012-02-15,41439,0,41439
17411,FRIO3,2012-03-31,2012-05-15,41439,0,41439
17412,FRIO3,2012-06-30,2012-08-08,41439,0,41439
17413,FRIO3,2012-09-30,2012-11-08,41439,0,41439
17414,FRIO3,2012-12-31,2013-02-25,41439,0,41439
17415,FRIO3,2013-03-31,2013-05-15,41439,0,41439
17416,FRIO3,2013-06-30,2013-08-12,41439,0,41439
17417,FRIO3,2013-09-30,2013-11-12,41439,0,41439
17418,FRIO3,2013-12-31,2014-03-13,41439,0,41439
17419,FRIO3,2014-03-31,2014-05-08,41439,0,41439
17420,FRIO3,2014-06-30,2014-08-06,41439,0,41439
17421,FRIO3,2014-09-30,2014-11-11,41439,0,41439
17422,FRIO3,2014-12-31,2015-03-02,41439,0,41439
17423,FRIO3,2015-03-31,2015-05-07,41439,0,41439
17424,FRIO3,2015-06-30,2015-08-10,40804,0,40804
17425,FRIO3,2015-09-30,2015-11-09,40804,0,40804
17426,FRIO3,2015-12-31,2016-03-01,13601,0,13601
17427,FRIO3,2016-03-31,2016-05-09,13601,0,13601
17428,FRIO3,2016-06-30,2016-08-09,13601,0,13601
17429,FRIO3,2016-09-30,2016-11-10,61601,0,61601
17430,FRIO3,2016-12-31,2017-02-20,61601,0,61601
17431,FRIO3,2017-03-31,2017-05-15,61601,0,61601
17432,FRIO3,2017-06-30,2017-08-08,4106754,0,4106754
17433,FRIO3,2017-09-30,2017-11-09,4106754,0,4106754
17434,FRIO3,2017-12-31,2018-03-05,4106754,0,4106754
17435,FRIO3,2018-03-31,2018-05-29,4106754,0,4106754
17436,FRIO3,2018-06-30,2018-08-09,4106754,0,4106754
17437,FRIO3,2018-09-30,2018-11-14,4106754,0,4106754
17438,FRIO3,2018-12-31,2019-03-14,4106754,0,4106754
17439,FRIO3,2019-03-31,2019-05-09,4106754,0,4106754
17440,FRIO3,2019-06-30,2019-08-13,4106754,0,4106754
17441,FRIO3,2019-09-30,2019-11-11,4106754,0,4106754
17442,FRIO3,2019-12-31,2020-03-27,4106754,0,4106754
17443,FRIO3,2020-03-31,2020-06-26,4106754,0,4106754
17444,FRIO3,2020-06-30,2020-08-24,4106754,0,4106754
17445,FRIO3,2020-09-30,2020-11-13,4106754,0,4106754
17446,FRIO3,2020-12-31,2021-03-08,4106754,0,4106754
17447,FHER3,2010-12-31,2011-04-20,48471,0,48471
17448,FHER3,2011-03-31,2011-05-27,48471,0,48471
17449,FHER3,2011-06-30,2011-08-11,48471,0,48471
17450,FHER3,2011-09-30,2011-11-16,48471,0,48471
17451,FHER3,2011-12-31,2012-03-14,48471,0,48471
17452,FHER3,2012-03-31,2012-05-10,48471,0,48471
17453,FHER3,2012-06-30,2012-08-28,48471407,0,48471407
17454,FHER3,2012-09-30,2012-11-09,48471407,0,48471407
17455,FHER3,2012-12-31,2013-03-08,48471407,0,48471407
17456,FHER3,2013-03-31,2013-05-09,48471407,0,48471407
17457,FHER3,2013-06-30,2013-08-08,48471,0,48471
17458,FHER3,2013-09-30,2013-11-07,48471,0,48471
17459,FHER3,2013-12-31,2014-03-12,48471407,0,48471407
17460,FHER3,2014-03-31,2014-05-08,48471407,0,48471407
17461,FHER3,2014-06-30,2014-08-07,48471407,0,48471407
17462,FHER3,2014-09-30,2014-11-06,48471407,0,48471407
17463,FHER3,2014-12-31,2015-03-12,48471407,0,48471407
17464,FHER3,2015-03-31,2015-05-14,53857284,0,53857284
17465,FHER3,2015-06-30,2015-08-13,53857284,0,53857284
17466,FHER3,2015-09-30,2015-11-12,53857284,0,53857284
17467,FHER3,2015-12-31,2016-03-10,53857284,0,53857284
17468,FHER3,2016-03-31,2016-05-12,53857284,0,53857284
17469,FHER3,2016-06-30,2016-08-05,53857284,0,53857284
17470,FHER3,2016-09-30,2016-11-04,53857284,0,53857284
17471,FHER3,2016-12-31,2017-03-17,53857284,0,53857284
17472,FHER3,2017-03-31,2017-05-05,53857284,0,53857284
17473,FHER3,2017-06-30,2017-08-10,53857284,0,53857284
17474,FHER3,2017-09-30,2017-11-09,53857284,0,53857284
17475,FHER3,2017-12-31,2018-03-13,53857284,0,53857284
17476,FHER3,2018-03-31,2018-05-15,53857284,0,53857284
17477,FHER3,2018-06-30,2018-08-10,53857284,0,53857284
17478,FHER3,2018-09-30,2018-11-14,53857284,0,53857284
17479,FHER3,2018-12-31,2019-03-28,53857284,0,53857284
17480,FHER3,2019-03-31,2019-05-14,53857284,0,53857284
17481,FHER3,2019-06-30,2019-09-18,53857284,0,53857284
17482,FHER3,2019-09-30,2019-11-12,53857284,0,53857284
17483,FHER3,2019-12-31,2020-03-31,53857284,0,53857284
17484,FHER3,2020-03-31,2020-06-15,53857284,0,53857284
17485,FHER3,2020-06-30,2020-08-28,53857284,0,53857284
17486,FHER3,2020-09-30,2020-11-13,53857284,0,53857284
17487,CRDE3,2010-12-31,2011-03-30,46136250,0,46136250
17488,CRDE3,2011-03-31,2011-05-16,48443062,0,48443062
17489,CRDE3,2011-06-30,2011-08-15,48443062,0,48443062
17490,CRDE3,2011-09-30,2011-11-14,48443062,0,48443062
17491,CRDE3,2011-12-31,2012-03-28,48443062,0,48443062
17492,CRDE3,2012-03-31,2012-05-15,48443062,0,48443062
17493,CRDE3,2012-06-30,2012-08-14,48443062,0,48443062
17494,CRDE3,2012-09-30,2012-11-14,48443062,0,48443062
17495,CRDE3,2012-12-31,2013-03-26,48443062,0,48443062
17496,CRDE3,2013-03-31,2013-05-14,48443062,0,48443062
17497,CRDE3,2013-06-30,2013-08-13,48443062,0,48443062
17498,CRDE3,2013-09-30,2013-11-14,48443062,0,48443062
17499,CRDE3,2013-12-31,2014-03-14,48443062,0,48443062
17500,CRDE3,2014-03-31,2014-05-15,48443062,0,48443062
17501,CRDE3,2014-06-30,2014-08-14,48443062,0,48443062
17502,CRDE3,2014-09-30,2014-11-12,48443062,0,48443062
17503,CRDE3,2014-12-31,2015-03-16,48443062,0,48443062
17504,CRDE3,2015-03-31,2015-05-14,48443062,0,48443062
17505,CRDE3,2015-06-30,2015-08-13,48443062,0,48443062
17506,CRDE3,2015-09-30,2015-11-12,48443062,0,48443062
17507,CRDE3,2015-12-31,2016-03-15,48443062,0,48443062
17508,CRDE3,2016-03-31,2016-05-12,48443062,0,48443062
17509,CRDE3,2016-06-30,2016-08-11,48443062,0,48443062
17510,CRDE3,2016-09-30,2016-11-10,48443062,0,48443062
17511,CRDE3,2016-12-31,2017-03-16,48443062,0,48443062
17512,CRDE3,2017-03-31,2017-05-12,48443062,0,48443062
17513,CRDE3,2017-06-30,2017-08-09,48443062,0,48443062
17514,CRDE3,2017-09-30,2017-11-13,48443062,0,48443062
17515,CRDE3,2017-12-31,2018-03-23,48443062,0,48443062
17516,CRDE3,2018-03-31,2018-05-15,48443062,0,48443062
17517,CRDE3,2018-06-30,2018-08-14,48443062,0,48443062
17518,CRDE3,2018-09-30,2018-11-13,48443062,0,48443062
17519,CRDE3,2018-12-31,2019-03-26,48443062,0,48443062
17520,CRDE3,2019-03-31,2019-05-14,2422153,0,2422153
17521,CRDE3,2019-06-30,2019-08-13,2422153,0,2422153
17522,CRDE3,2019-09-30,2019-11-13,2422153,0,2422153
17523,CRDE3,2019-12-31,2020-04-03,2422153,0,2422153
17524,CRDE3,2020-03-31,2020-06-16,2422153,0,2422153
17525,CRDE3,2020-06-30,2020-08-27,2422153,0,2422153
17526,CRDE3,2020-09-30,2020-11-12,2422153,0,2422153
17527,CEED3,2010-12-31,2011-03-29,380669270,6560558,387229828
17528,CEED3,2011-03-31,2011-05-26,380669270,6560558,387229828
17529,CEED3,2011-06-30,2011-08-12,380669270,6560558,387229828
17530,CEED3,2011-09-30,2011-11-25,380669270,6560558,387229828
17531,CEED3,2011-12-31,2012-04-13,380669270,6560558,387229828
17532,CEED3,2012-03-31,2012-05-18,380669270,6560558,387229828
17533,CEED3,2012-06-30,2012-08-15,380669270,6560558,387229828
17534,CEED3,2012-09-30,2012-11-14,380669270,6560558,387229828
17535,CEED3,2012-12-31,2013-03-26,380669270,6560558,387229828
17536,CEED3,2013-03-31,2013-05-15,380669270,6560558,387229828
17537,CEED3,2013-06-30,2013-08-14,380669270,6560558,387229828
17538,CEED3,2013-09-30,2013-11-14,380669270,6560558,387229828
17539,CEED3,2013-12-31,2014-03-31,380669270,6560558,387229828
17540,CEED3,2014-03-31,2014-05-15,380669270,6560558,387229828
17541,CEED3,2014-06-30,2014-08-14,380669270,6560558,387229828
17542,CEED3,2014-09-30,2014-11-14,380669270,6560558,387229828
17543,CEED3,2014-12-31,2015-03-30,380669270,6560558,387229828
17544,CEED3,2015-03-31,2015-05-15,380669270,6560558,387229828
17545,CEED3,2015-06-30,2015-08-14,380669270,6560558,387229828
17546,CEED3,2015-09-30,2015-11-13,380669270,6560558,387229828
17547,CEED3,2015-12-31,2016-03-29,380669270,6560558,387229828
17548,CEED3,2016-03-31,2016-05-13,380669270,6560558,387229828
17549,CEED3,2016-06-30,2016-08-12,9516732,164014,9680746
17550,CEED3,2016-09-30,2016-11-11,9516732,164014,9680746
17551,CEED3,2016-12-31,2017-04-03,9516732,164014,9680746
17552,CEED3,2017-03-31,2017-05-15,9516732,164014,9680746
17553,CEED3,2017-06-30,2017-09-04,9516732,164014,9680746
17554,CEED3,2017-09-30,2017-11-14,9516732,164014,9680746
17555,CEED3,2017-12-31,2018-05-11,9516732,164014,9680746
17556,CEED3,2018-03-31,2018-05-15,9516732,164014,9680746
17557,CEED3,2018-06-30,2018-08-14,9516732,164014,9680746
17558,CEED3,2018-09-30,2018-11-14,9516732,164014,9680746
17559,CEED3,2018-12-31,2019-03-26,9516732,164014,9680746
17560,CEED3,2019-03-31,2019-05-15,9516732,164014,9680746
17561,CEED3,2019-06-30,2019-08-14,9516732,164014,9680746
17562,CEED3,2019-09-30,2019-11-14,9516732,164014,9680746
17563,CEED3,2019-12-31,2020-03-30,9516732,164014,9680746
17564,CEED3,2020-03-31,2020-05-15,9516732,164014,9680746
17565,CEED3,2020-06-30,2020-08-14,9516732,164014,9680746
17566,CEED3,2020-09-30,2020-11-13,9516732,164014,9680746
17567,CEED4,2010-12-31,2011-03-29,380669270,6560558,387229828
17568,CEED4,2011-03-31,2011-05-26,380669270,6560558,387229828
17569,CEED4,2011-06-30,2011-08-12,380669270,6560558,387229828
17570,CEED4,2011-09-30,2011-11-25,380669270,6560558,387229828
17571,CEED4,2011-12-31,2012-04-13,380669270,6560558,387229828
17572,CEED4,2012-03-31,2012-05-18,380669270,6560558,387229828
17573,CEED4,2012-06-30,2012-08-15,380669270,6560558,387229828
17574,CEED4,2012-09-30,2012-11-14,380669270,6560558,387229828
17575,CEED4,2012-12-31,2013-03-26,380669270,6560558,387229828
17576,CEED4,2013-03-31,2013-05-15,380669270,6560558,387229828
17577,CEED4,2013-06-30,2013-08-14,380669270,6560558,387229828
17578,CEED4,2013-09-30,2013-11-14,380669270,6560558,387229828
17579,CEED4,2013-12-31,2014-03-31,380669270,6560558,387229828
17580,CEED4,2014-03-31,2014-05-15,380669270,6560558,387229828
17581,CEED4,2014-06-30,2014-08-14,380669270,6560558,387229828
17582,CEED4,2014-09-30,2014-11-14,380669270,6560558,387229828
17583,CEED4,2014-12-31,2015-03-30,380669270,6560558,387229828
17584,CEED4,2015-03-31,2015-05-15,380669270,6560558,387229828
17585,CEED4,2015-06-30,2015-08-14,380669270,6560558,387229828
17586,CEED4,2015-09-30,2015-11-13,380669270,6560558,387229828
17587,CEED4,2015-12-31,2016-03-29,380669270,6560558,387229828
17588,CEED4,2016-03-31,2016-05-13,380669270,6560558,387229828
17589,CEED4,2016-06-30,2016-08-12,9516732,164014,9680746
17590,CEED4,2016-09-30,2016-11-11,9516732,164014,9680746
17591,CEED4,2016-12-31,2017-04-03,9516732,164014,9680746
17592,CEED4,2017-03-31,2017-05-15,9516732,164014,9680746
17593,CEED4,2017-06-30,2017-09-04,9516732,164014,9680746
17594,CEED4,2017-09-30,2017-11-14,9516732,164014,9680746
17595,CEED4,2017-12-31,2018-05-11,9516732,164014,9680746
17596,CEED4,2018-03-31,2018-05-15,9516732,164014,9680746
17597,CEED4,2018-06-30,2018-08-14,9516732,164014,9680746
17598,CEED4,2018-09-30,2018-11-14,9516732,164014,9680746
17599,CEED4,2018-12-31,2019-03-26,9516732,164014,9680746
17600,CEED4,2019-03-31,2019-05-15,9516732,164014,9680746
17601,CEED4,2019-06-30,2019-08-14,9516732,164014,9680746
17602,CEED4,2019-09-30,2019-11-14,9516732,164014,9680746
17603,CEED4,2019-12-31,2020-03-30,9516732,164014,9680746
17604,CEED4,2020-03-31,2020-05-15,9516732,164014,9680746
17605,CEED4,2020-06-30,2020-08-14,9516732,164014,9680746
17606,CEED4,2020-09-30,2020-11-13,9516732,164014,9680746
17607,VIVR3,2010-12-31,2011-03-29,285309,0,285309
17608,VIVR3,2011-03-31,2011-05-16,285309,0,285309
17609,VIVR3,2011-06-30,2011-08-15,285309,0,285309
17610,VIVR3,2011-09-30,2011-11-14,285309,0,285309
17611,VIVR3,2011-12-31,2012-03-30,285309,0,285309
17612,VIVR3,2012-03-31,2012-05-15,285309,0,285309
17613,VIVR3,2012-06-30,2012-08-14,285309,0,285309
17614,VIVR3,2012-09-30,2012-11-14,285309,0,285309
17615,VIVR3,2012-12-31,2013-04-03,334965,0,334965
17616,VIVR3,2013-03-31,2013-05-22,334965,0,334965
17617,VIVR3,2013-06-30,2013-08-14,334965,0,334965
17618,VIVR3,2013-09-30,2013-11-14,335309,0,335309
17619,VIVR3,2013-12-31,2014-03-25,335309,0,335309
17620,VIVR3,2014-03-31,2014-05-15,335309,0,335309
17621,VIVR3,2014-06-30,2014-08-14,335309,0,335309
17622,VIVR3,2014-09-30,2014-11-14,335309,0,335309
17623,VIVR3,2014-12-31,2015-03-31,335309,0,335309
17624,VIVR3,2015-03-31,2015-05-15,335309,0,335309
17625,VIVR3,2015-06-30,2015-08-14,335309,0,335309
17626,VIVR3,2015-09-30,2015-11-13,339122,0,339122
17627,VIVR3,2015-12-31,2016-03-30,339392,0,339392
17628,VIVR3,2016-03-31,2016-05-13,341240,0,341240
17629,VIVR3,2016-06-30,2016-08-12,3414,0,3414
17630,VIVR3,2016-09-30,2016-11-14,3482,0,3482
17631,VIVR3,2016-12-31,2017-03-29,4298,0,4298
17632,VIVR3,2017-03-31,2017-05-12,4299,0,4299
17633,VIVR3,2017-06-30,2017-08-11,4299,0,4299
17634,VIVR3,2017-09-30,2017-11-13,4299,0,4299
17635,VIVR3,2017-12-31,2018-03-28,4301,0,4301
17636,VIVR3,2018-03-31,2018-05-14,4301,0,4301
17637,VIVR3,2018-06-30,2018-08-14,292810,0,292810
17638,VIVR3,2018-09-30,2018-11-13,292810,0,292810
17639,VIVR3,2018-12-31,2019-03-28,445395,0,445395
17640,VIVR3,2019-03-31,2019-05-14,463170,0,463170
17641,VIVR3,2019-06-30,2019-08-14,46317,0,46317
17642,VIVR3,2019-09-30,2019-11-13,46317,0,46317
17643,VIVR3,2019-12-31,2020-03-30,46572,0,46572
17644,VIVR3,2020-03-31,2020-05-29,46572,0,46572
17645,VIVR3,2020-06-30,2020-08-13,60430,0,60430
17646,VIVR3,2020-09-30,2020-11-13,95168,0,95168
17647,LOGN3,2010-12-31,2011-03-14,91712,0,91712
17648,LOGN3,2011-03-31,2011-05-11,91712,0,91712
17649,LOGN3,2011-06-30,2011-08-10,91711620,0,91711620
17650,LOGN3,2011-09-30,2011-11-09,91711620,0,91711620
17651,LOGN3,2011-12-31,2012-03-26,91712,0,91712
17652,LOGN3,2012-03-31,2012-05-16,91712,0,91712
17653,LOGN3,2012-06-30,2012-08-07,91712,0,91712
17654,LOGN3,2012-09-30,2012-11-06,91712,0,91712
17655,LOGN3,2012-12-31,2013-03-19,91712,0,91712
17656,LOGN3,2013-03-31,2013-05-14,91712,0,91712
17657,LOGN3,2013-06-30,2013-08-13,91712,0,91712
17658,LOGN3,2013-09-30,2013-11-12,91712,0,91712
17659,LOGN3,2013-12-31,2014-03-19,91712,0,91712
17660,LOGN3,2014-03-31,2014-05-14,91712,0,91712
17661,LOGN3,2014-06-30,2014-08-13,91712,0,91712
17662,LOGN3,2014-09-30,2014-11-12,91712,0,91712
17663,LOGN3,2014-12-31,2015-03-18,91712,0,91712
17664,LOGN3,2015-03-31,2015-05-14,91712,0,91712
17665,LOGN3,2015-06-30,2015-08-13,91712,0,91712
17666,LOGN3,2015-09-30,2015-11-12,91712,0,91712
17667,LOGN3,2015-12-31,2016-03-17,91712,0,91712
17668,LOGN3,2016-03-31,2016-05-12,91712,0,91712
17669,LOGN3,2016-06-30,2016-08-12,18342,0,18342
17670,LOGN3,2016-09-30,2016-11-10,18342,0,18342
17671,LOGN3,2016-12-31,2017-03-16,18342,0,18342
17672,LOGN3,2017-03-31,2017-05-11,23357,0,23357
17673,LOGN3,2017-06-30,2017-08-10,23357,0,23357
17674,LOGN3,2017-09-30,2017-11-09,23357,0,23357
17675,LOGN3,2017-12-31,2019-11-07,23357,0,23357
17676,LOGN3,2018-03-31,2018-05-15,23357,0,23357
17677,LOGN3,2018-06-30,2018-08-14,36040,0,36040
17678,LOGN3,2018-09-30,2018-11-21,37089,0,37089
17679,LOGN3,2018-12-31,2019-03-22,38075,0,38075
17680,LOGN3,2019-03-31,2019-05-15,38387,0,38387
17681,LOGN3,2019-06-30,2019-08-16,37771,0,37771
17682,LOGN3,2019-09-30,2019-11-06,48495751,0,48495751
17683,LOGN3,2019-12-31,2020-03-17,104199191,0,104199191
17684,LOGN3,2020-03-31,2020-11-13,104199191,0,104199191
17685,LOGN3,2020-06-30,2020-11-13,105489191,0,105489191
17686,LOGN3,2020-09-30,2020-11-10,105489191,0,105489191
17687,LOGN3,2020-12-31,2021-03-09,105489191,0,105489191
17688,SLCE3,2010-12-31,2011-03-25,98897500,0,98897500
17689,SLCE3,2011-03-31,2011-05-16,98897500,0,98897500
17690,SLCE3,2011-06-30,2011-08-11,98897500,0,98897500
17691,SLCE3,2011-09-30,2011-11-09,98897500,0,98897500
17692,SLCE3,2011-12-31,2012-03-28,98897500,0,98897500
17693,SLCE3,2012-03-31,2012-05-03,98897500,0,98897500
17694,SLCE3,2012-06-30,2012-08-08,98897500,0,98897500
17695,SLCE3,2012-09-30,2012-11-13,98897500,0,98897500
17696,SLCE3,2012-12-31,2013-03-14,98897500,0,98897500
17697,SLCE3,2013-03-31,2013-05-08,98897500,0,98897500
17698,SLCE3,2013-06-30,2013-08-07,98897500,0,98897500
17699,SLCE3,2013-09-30,2013-11-13,98897500,0,98897500
17700,SLCE3,2013-12-31,2014-03-12,98897500,0,98897500
17701,SLCE3,2014-03-31,2014-05-08,98897500,0,98897500
17702,SLCE3,2014-06-30,2014-08-13,98897500,0,98897500
17703,SLCE3,2014-09-30,2014-11-12,98897500,0,98897500
17704,SLCE3,2014-12-31,2015-03-11,98879500,0,98879500
17705,SLCE3,2015-03-31,2015-05-06,98897500,0,98897500
17706,SLCE3,2015-06-30,2015-08-12,98897500,0,98897500
17707,SLCE3,2015-09-30,2015-12-09,98897500,0,98897500
17708,SLCE3,2015-12-31,2016-03-09,98897500,0,98897500
17709,SLCE3,2016-03-31,2016-05-25,98897500,0,98897500
17710,SLCE3,2016-06-30,2016-08-10,98897500,0,98897500
17711,SLCE3,2016-09-30,2016-11-08,98897500,0,98897500
17712,SLCE3,2016-12-31,2017-03-27,98897500,0,98897500
17713,SLCE3,2017-03-31,2017-05-10,98897500,0,98897500
17714,SLCE3,2017-06-30,2017-10-06,98897500,0,98897500
17715,SLCE3,2017-09-30,2017-11-28,98897500,0,98897500
17716,SLCE3,2017-12-31,2018-03-07,98897500,0,98897500
17717,SLCE3,2018-03-31,2018-05-22,95297500,0,95297500
17718,SLCE3,2018-06-30,2018-08-14,95297500,0,95297500
17719,SLCE3,2018-09-30,2018-11-13,95297500,0,95297500
17720,SLCE3,2018-12-31,2019-03-13,95297500,0,95297500
17721,SLCE3,2019-03-31,2019-05-08,95297500,0,95297500
17722,SLCE3,2019-06-30,2019-11-21,190595000,0,190595000
17723,SLCE3,2019-09-30,2019-11-21,190595000,0,190595000
17724,SLCE3,2019-12-31,2020-03-26,190595000,0,190595000
17725,SLCE3,2020-03-31,2020-05-13,190595000,0,190595000
17726,SLCE3,2020-06-30,2020-08-13,190595000,0,190595000
17727,SLCE3,2020-09-30,2020-11-13,190595000,0,190595000
17728,SLCE3,2020-12-31,2021-03-17,190595000,0,190595000
17729,EZTC3,2010-12-31,2011-03-22,146724120,0,146724120
17730,EZTC3,2011-03-31,2011-05-10,146724120,0,146724120
17731,EZTC3,2011-06-30,2011-08-08,146724120,0,146724120
17732,EZTC3,2011-09-30,2011-11-08,146724120,0,146724120
17733,EZTC3,2011-12-31,2012-03-13,146724120,0,146724120
17734,EZTC3,2012-03-31,2012-05-15,146724120,0,146724120
17735,EZTC3,2012-06-30,2012-08-13,146724120,0,146724120
17736,EZTC3,2012-09-30,2012-11-09,146724120,0,146724120
17737,EZTC3,2012-12-31,2013-03-19,146724120,0,146724120
17738,EZTC3,2013-03-31,2013-05-13,146724120,0,146724120
17739,EZTC3,2013-06-30,2013-08-12,146724120,0,146724120
17740,EZTC3,2013-09-30,2013-11-12,146724120,0,146724120
17741,EZTC3,2013-12-31,2014-03-19,146724120,0,146724120
17742,EZTC3,2014-03-31,2014-05-08,146724120,0,146724120
17743,EZTC3,2014-06-30,2014-08-11,146724120,0,146724120
17744,EZTC3,2014-09-30,2014-11-10,146724120,0,146724120
17745,EZTC3,2014-12-31,2015-03-18,146724120,0,146724120
17746,EZTC3,2015-03-31,2015-05-07,146724120,0,146724120
17747,EZTC3,2015-06-30,2015-08-13,157058466,0,157058466
17748,EZTC3,2015-09-30,2015-11-12,157058466,0,157058466
17749,EZTC3,2015-12-31,2016-03-29,157058466,0,157058466
17750,EZTC3,2016-03-31,2016-05-12,165001783,0,165001783
17751,EZTC3,2016-06-30,2016-08-11,165001783,0,165001783
17752,EZTC3,2016-09-30,2016-11-09,165001783,0,165001783
17753,EZTC3,2016-12-31,2017-03-20,165001783,0,165001783
17754,EZTC3,2017-03-31,2017-05-11,165001783,0,165001783
17755,EZTC3,2017-06-30,2017-08-10,165001783,0,165001783
17756,EZTC3,2017-09-30,2017-11-09,165001783,0,165001783
17757,EZTC3,2017-12-31,2018-03-16,165001783,0,165001783
17758,EZTC3,2018-03-31,2018-05-10,165001783,0,165001783
17759,EZTC3,2018-06-30,2018-08-14,165001783,0,165001783
17760,EZTC3,2018-09-30,2018-11-08,165001783,0,165001783
17761,EZTC3,2018-12-31,2019-03-22,165001783,0,165001783
17762,EZTC3,2019-03-31,2019-05-14,165001783,0,165001783
17763,EZTC3,2019-06-30,2019-08-14,200000000,0,200000000
17764,EZTC3,2019-09-30,2019-11-13,227000,0,227000
17765,EZTC3,2019-12-31,2020-03-19,227000000,0,227000000
17766,EZTC3,2020-03-31,2020-05-15,227000000,0,227000000
17767,EZTC3,2020-06-30,2020-08-14,227000000,0,227000000
17768,EZTC3,2020-09-30,2020-12-02,227000000,0,227000000
17769,EZTC3,2020-12-31,2021-03-17,200000000,0,200000000
17770,MRFG3,2010-12-31,2012-11-05,346983954,0,346983954
17771,MRFG3,2011-03-31,2011-05-19,346983954,0,346983954
17772,MRFG3,2011-06-30,2011-08-15,346983954,0,346983954
17773,MRFG3,2011-09-30,2011-11-11,346983954,0,346983954
17774,MRFG3,2011-12-31,2012-11-27,346983954,0,346983954
17775,MRFG3,2012-03-31,2012-11-27,346983954,0,346983954
17776,MRFG3,2012-06-30,2012-11-27,346983954,0,346983954
17777,MRFG3,2012-09-30,2012-11-27,345747405,0,345747405
17778,MRFG3,2012-12-31,2013-03-27,476997405,0,476997405
17779,MRFG3,2013-03-31,2013-05-14,520747405,0,520747405
17780,MRFG3,2013-06-30,2013-11-13,520747405,0,520747405
17781,MRFG3,2013-09-30,2013-11-13,520747405,0,520747405
17782,MRFG3,2013-12-31,2014-03-19,520747405,0,520747405
17783,MRFG3,2014-03-31,2014-05-12,520747405,0,520747405
17784,MRFG3,2014-06-30,2014-08-13,520747405,0,520747405
17785,MRFG3,2014-09-30,2014-12-22,520747405,0,520747405
17786,MRFG3,2014-12-31,2015-03-02,520747405,0,520747405
17787,MRFG3,2015-03-31,2015-05-08,520747405,0,520747405
17788,MRFG3,2015-06-30,2015-08-12,520747405,0,520747405
17789,MRFG3,2015-09-30,2015-11-06,520747405,0,520747405
17790,MRFG3,2015-12-31,2016-02-29,520747405,0,520747405
17791,MRFG3,2016-03-31,2016-05-12,520747405,0,520747405
17792,MRFG3,2016-06-30,2016-08-11,521065385,0,521065385
17793,MRFG3,2016-09-30,2016-11-10,521300754,0,521300754
17794,MRFG3,2016-12-31,2017-02-23,521300754,0,521300754
17795,MRFG3,2017-03-31,2017-05-11,621279822,0,621279822
17796,MRFG3,2017-06-30,2017-08-14,621279822,0,621279822
17797,MRFG3,2017-09-30,2018-03-27,621279822,0,621279822
17798,MRFG3,2017-12-31,2018-03-27,621279822,0,621279822
17799,MRFG3,2018-03-31,2018-05-14,621279822,0,621279822
17800,MRFG3,2018-06-30,2018-08-14,621279822,0,621279822
17801,MRFG3,2018-09-30,2018-11-05,621279822,0,621279822
17802,MRFG3,2018-12-31,2019-02-27,621279822,0,621279822
17803,MRFG3,2019-03-31,2019-05-15,621279822,0,621279822
17804,MRFG3,2019-06-30,2019-08-22,621279822,0,621279822
17805,MRFG3,2019-09-30,2019-11-11,621279822,0,621279822
17806,MRFG3,2019-12-31,2020-02-19,711369913,0,711369913
17807,MRFG3,2020-03-31,2020-05-18,711369913,0,711369913
17808,MRFG3,2020-06-30,2020-08-12,711369913,0,711369913
17809,MRFG3,2020-09-30,2020-11-11,711369913,0,711369913
17810,MRFG3,2020-12-31,2021-03-08,711369913,0,711369913
17811,tgma3,2010-12-31,2011-03-01,66003,0,66003
17812,tgma3,2011-03-31,2011-05-16,66003,0,66003
17813,tgma3,2011-06-30,2011-08-11,66003,0,66003
17814,tgma3,2011-09-30,2011-11-08,66003,0,66003
17815,tgma3,2011-12-31,2012-03-14,66003,0,66003
17816,tgma3,2012-03-31,2012-05-09,66002,0,66002
17817,tgma3,2012-06-30,2012-08-14,66002,0,66002
17818,tgma3,2012-09-30,2012-11-06,66003,0,66003
17819,tgma3,2012-12-31,2013-04-11,66002,0,66002
17820,tgma3,2013-03-31,2013-05-15,66002,0,66002
17821,tgma3,2013-06-30,2013-12-13,66002,0,66002
17822,tgma3,2013-09-30,2013-12-13,66002,0,66002
17823,tgma3,2013-12-31,2014-03-26,66002915,0,66002915
17824,tgma3,2014-03-31,2014-05-12,66002915,0,66002915
17825,tgma3,2014-06-30,2014-08-14,66002915,0,66002915
17826,tgma3,2014-09-30,2014-11-12,66002915,0,66002915
17827,tgma3,2014-12-31,2015-03-26,66002915,0,66002915
17828,tgma3,2015-03-31,2015-05-07,66002915,0,66002915
17829,tgma3,2015-06-30,2015-08-06,66002915,0,66002915
17830,tgma3,2015-09-30,2015-11-05,66002915,0,66002915
17831,tgma3,2015-12-31,2016-03-21,66002915,0,66002915
17832,tgma3,2016-03-31,2016-05-10,66002915,0,66002915
17833,tgma3,2016-06-30,2016-08-09,66002915,0,66002915
17834,tgma3,2016-09-30,2016-11-10,66002915,0,66002915
17835,tgma3,2016-12-31,2017-03-21,66002915,0,66002915
17836,tgma3,2017-03-31,2017-08-15,66002915,0,66002915
17837,tgma3,2017-06-30,2017-08-15,66002915,0,66002915
17838,tgma3,2017-09-30,2017-11-07,66002915,0,66002915
17839,tgma3,2017-12-31,2018-03-20,66002915,0,66002915
17840,tgma3,2018-03-31,2018-05-08,66002915,0,66002915
17841,tgma3,2018-06-30,2018-08-07,66002915,0,66002915
17842,tgma3,2018-09-30,2018-11-08,66002915,0,66002915
17843,tgma3,2018-12-31,2019-03-19,66002915,0,66002915
17844,tgma3,2019-03-31,2019-05-03,66002915,0,66002915
17845,tgma3,2019-06-30,2019-08-07,66002915,0,66002915
17846,tgma3,2019-09-30,2020-04-23,66002915,0,66002915
17847,tgma3,2019-12-31,2020-03-31,66002915,0,66002915
17848,tgma3,2020-03-31,2020-05-12,66002815,0,66002815
17849,tgma3,2020-06-30,2020-08-05,66002815,0,66002815
17850,tgma3,2020-09-30,2020-11-06,66002815,0,66002815
17851,tgma3,2020-12-31,2021-03-09,66002915,0,66002915
17852,HBOR3,2010-12-31,2011-03-17,65097,0,65097
17853,HBOR3,2011-03-31,2011-05-18,65097,0,65097
17854,HBOR3,2011-06-30,2011-08-11,65097,0,65097
17855,HBOR3,2011-09-30,2011-11-14,65097,0,65097
17856,HBOR3,2011-12-31,2012-03-14,65097,0,65097
17857,HBOR3,2012-03-31,2012-05-15,65097,0,65097
17858,HBOR3,2012-06-30,2012-08-14,195291,0,195291
17859,HBOR3,2012-09-30,2012-11-13,195291,0,195291
17860,HBOR3,2012-12-31,2013-03-25,195291,0,195291
17861,HBOR3,2013-03-31,2013-05-14,198231,0,198231
17862,HBOR3,2013-06-30,2013-08-13,257700,0,257700
17863,HBOR3,2013-09-30,2013-11-13,257700,0,257700
17864,HBOR3,2013-12-31,2014-03-18,257700,0,257700
17865,HBOR3,2014-03-31,2014-05-13,257700,0,257700
17866,HBOR3,2014-06-30,2014-08-13,257700,0,257700
17867,HBOR3,2014-09-30,2014-11-13,257700,0,257700
17868,HBOR3,2014-12-31,2015-03-24,257700,0,257700
17869,HBOR3,2015-03-31,2015-05-12,257700,0,257700
17870,HBOR3,2015-06-30,2015-08-13,257700,0,257700
17871,HBOR3,2015-09-30,2015-11-12,257700,0,257700
17872,HBOR3,2015-12-31,2016-03-30,257700,0,257700
17873,HBOR3,2016-03-31,2016-05-12,257700,0,257700
17874,HBOR3,2016-06-30,2016-08-11,257700,0,257700
17875,HBOR3,2016-09-30,2016-11-10,257700,0,257700
17876,HBOR3,2016-12-31,2017-04-06,325882,0,325882
17877,HBOR3,2017-03-31,2017-05-11,325882,0,325882
17878,HBOR3,2017-06-30,2017-08-10,325882,0,325882
17879,HBOR3,2017-09-30,2017-11-14,325882,0,325882
17880,HBOR3,2017-12-31,2018-03-28,457913,0,457913
17881,HBOR3,2018-03-31,2018-05-15,457913,0,457913
17882,HBOR3,2018-06-30,2018-08-15,457913,0,457913
17883,HBOR3,2018-09-30,2018-11-13,457913,0,457913
17884,HBOR3,2018-12-31,2019-03-29,457913,0,457913
17885,HBOR3,2019-03-31,2019-05-15,457913,0,457913
17886,HBOR3,2019-06-30,2019-08-13,457913,0,457913
17887,HBOR3,2019-09-30,2019-11-13,457913,0,457913
17888,HBOR3,2019-12-31,2020-03-31,669255,0,669255
17889,HBOR3,2020-03-31,2020-06-16,669255,0,669255
17890,HBOR3,2020-06-30,2020-08-13,669255,0,669255
17891,HBOR3,2020-09-30,2020-11-11,133851,0,133851
17892,HBOR3,2020-12-31,2021-03-16,133851,0,133851
17893,IDVL3,2010-12-31,2011-04-28,27000000,14212984,41212984
17894,IDVL3,2011-03-31,2011-05-11,27000000,14212984,41212984
17895,IDVL3,2011-06-30,2011-08-08,27000000,14212984,41212984
17896,IDVL3,2011-09-30,2011-11-07,36945649,26160044,63105693
17897,IDVL3,2011-12-31,2012-03-26,36945649,26160044,63105693
17898,IDVL3,2012-03-31,2012-05-07,36945649,26160044,63105693
17899,IDVL3,2012-06-30,2012-08-07,36945649,26160044,63105693
17900,IDVL3,2012-09-30,2012-11-06,36945649,26160044,63105693
17901,IDVL3,2012-12-31,2013-03-25,36945649,26160044,63105693
17902,IDVL3,2013-03-31,2013-05-14,36945649,26160044,63105693
17903,IDVL3,2013-06-30,2013-08-15,36945649,26160044,63105693
17904,IDVL3,2013-09-30,2013-11-12,44410897,31021907,75432804
17905,IDVL3,2013-12-31,2014-03-25,44410897,31021907,75432804
17906,IDVL3,2014-03-31,2014-05-13,58513218,31021907,89535125
17907,IDVL3,2014-06-30,2014-08-12,58513218,31021907,89535125
17908,IDVL3,2014-09-30,2014-11-12,58513218,31021907,89535125
17909,IDVL3,2014-12-31,2015-03-30,58513218,31021907,89535125
17910,IDVL3,2015-03-31,2015-05-07,58513218,31021907,89535125
17911,IDVL3,2015-06-30,2015-08-17,58513218,31021907,89535125
17912,IDVL3,2015-09-30,2015-11-11,58513218,31021907,89535125
17913,IDVL3,2015-12-31,2016-03-28,115033148,37494103,152527251
17914,IDVL3,2016-03-31,2016-05-16,115033148,37494103,152527251
17915,IDVL3,2016-06-30,2016-08-11,115033148,37494103,152527251
17916,IDVL3,2016-09-30,2016-11-11,115033148,37494103,152527251
17917,IDVL3,2016-12-31,2017-03-27,115033148,37494103,152527251
17918,IDVL3,2017-03-31,2017-05-12,115033148,37494103,152527251
17919,IDVL3,2017-06-30,2017-09-13,115033148,37494103,152527251
17920,IDVL3,2017-09-30,2017-12-15,115033148,37494103,152527251
17921,IDVL3,2017-12-31,2018-03-27,115033148,37494103,152527251
17922,IDVL3,2018-03-31,2018-05-18,115033148,37494103,152527251
17923,IDVL3,2018-06-30,2018-08-13,115033148,37494103,152527251
17924,IDVL3,2018-09-30,2018-11-14,115033148,37494103,152527251
17925,IDVL3,2018-12-31,2020-04-17,115033148,37494103,152527251
17926,IDVL3,2019-03-31,2019-05-14,11503315,3749410,15252725
17927,IDVL3,2019-06-30,2019-08-15,83049425,3749410,86798835
17928,IDVL3,2019-09-30,2019-11-14,83049425,3749410,86798835
17929,IDVL3,2019-12-31,2020-03-31,83049425,3749410,86798835
17930,IDVL3,2020-03-31,2020-07-01,83049425,3749410,86798835
17931,IDVL3,2020-06-30,2020-08-28,99072523,3749410,102821933
17932,IDVL3,2020-09-30,2020-11-26,99072523,3749410,102821933
17933,IDVL4,2010-12-31,2011-04-28,27000000,14212984,41212984
17934,IDVL4,2011-03-31,2011-05-11,27000000,14212984,41212984
17935,IDVL4,2011-06-30,2011-08-08,27000000,14212984,41212984
17936,IDVL4,2011-09-30,2011-11-07,36945649,26160044,63105693
17937,IDVL4,2011-12-31,2012-03-26,36945649,26160044,63105693
17938,IDVL4,2012-03-31,2012-05-07,36945649,26160044,63105693
17939,IDVL4,2012-06-30,2012-08-07,36945649,26160044,63105693
17940,IDVL4,2012-09-30,2012-11-06,36945649,26160044,63105693
17941,IDVL4,2012-12-31,2013-03-25,36945649,26160044,63105693
17942,IDVL4,2013-03-31,2013-05-14,36945649,26160044,63105693
17943,IDVL4,2013-06-30,2013-08-15,36945649,26160044,63105693
17944,IDVL4,2013-09-30,2013-11-12,44410897,31021907,75432804
17945,IDVL4,2013-12-31,2014-03-25,44410897,31021907,75432804
17946,IDVL4,2014-03-31,2014-05-13,58513218,31021907,89535125
17947,IDVL4,2014-06-30,2014-08-12,58513218,31021907,89535125
17948,IDVL4,2014-09-30,2014-11-12,58513218,31021907,89535125
17949,IDVL4,2014-12-31,2015-03-30,58513218,31021907,89535125
17950,IDVL4,2015-03-31,2015-05-07,58513218,31021907,89535125
17951,IDVL4,2015-06-30,2015-08-17,58513218,31021907,89535125
17952,IDVL4,2015-09-30,2015-11-11,58513218,31021907,89535125
17953,IDVL4,2015-12-31,2016-03-28,115033148,37494103,152527251
17954,IDVL4,2016-03-31,2016-05-16,115033148,37494103,152527251
17955,IDVL4,2016-06-30,2016-08-11,115033148,37494103,152527251
17956,IDVL4,2016-09-30,2016-11-11,115033148,37494103,152527251
17957,IDVL4,2016-12-31,2017-03-27,115033148,37494103,152527251
17958,IDVL4,2017-03-31,2017-05-12,115033148,37494103,152527251
17959,IDVL4,2017-06-30,2017-09-13,115033148,37494103,152527251
17960,IDVL4,2017-09-30,2017-12-15,115033148,37494103,152527251
17961,IDVL4,2017-12-31,2018-03-27,115033148,37494103,152527251
17962,IDVL4,2018-03-31,2018-05-18,115033148,37494103,152527251
17963,IDVL4,2018-06-30,2018-08-13,115033148,37494103,152527251
17964,IDVL4,2018-09-30,2018-11-14,115033148,37494103,152527251
17965,IDVL4,2018-12-31,2020-04-17,115033148,37494103,152527251
17966,IDVL4,2019-03-31,2019-05-14,11503315,3749410,15252725
17967,IDVL4,2019-06-30,2019-08-15,83049425,3749410,86798835
17968,IDVL4,2019-09-30,2019-11-14,83049425,3749410,86798835
17969,IDVL4,2019-12-31,2020-03-31,83049425,3749410,86798835
17970,IDVL4,2020-03-31,2020-07-01,83049425,3749410,86798835
17971,IDVL4,2020-06-30,2020-08-28,99072523,3749410,102821933
17972,IDVL4,2020-09-30,2020-11-26,99072523,3749410,102821933
17973,MRVE3,2010-12-31,2011-03-30,482435,0,482435
17974,MRVE3,2011-03-31,2011-05-16,482435,0,482435
17975,MRVE3,2011-06-30,2011-08-10,482700,0,482700
17976,MRVE3,2011-09-30,2011-11-16,482709,0,482709
17977,MRVE3,2011-12-31,2012-03-15,482710,0,482710
17978,MRVE3,2012-03-31,2012-05-14,482744,0,482744
17979,MRVE3,2012-06-30,2012-08-13,482744,0,482744
17980,MRVE3,2012-09-30,2012-11-08,482744,0,482744
17981,MRVE3,2012-12-31,2013-03-14,482744,0,482744
17982,MRVE3,2013-03-31,2013-05-24,482880,0,482880
17983,MRVE3,2013-06-30,2013-08-16,483102,0,483102
17984,MRVE3,2013-09-30,2013-11-11,483102,0,483102
17985,MRVE3,2013-12-31,2014-03-13,483102,0,483102
17986,MRVE3,2014-03-31,2014-05-14,477221,0,477221
17987,MRVE3,2014-06-30,2014-08-25,463139,0,463139
17988,MRVE3,2014-09-30,2014-11-12,463139,0,463139
17989,MRVE3,2014-12-31,2015-03-05,449139,0,449139
17990,MRVE3,2015-03-31,2015-05-12,449139,0,449139
17991,MRVE3,2015-06-30,2015-08-14,449139,0,449139
17992,MRVE3,2015-09-30,2015-11-12,449139,0,449139
17993,MRVE3,2015-12-31,2016-03-07,444139,0,444139
17994,MRVE3,2016-03-31,2016-05-12,444139,0,444139
17995,MRVE3,2016-06-30,2016-08-11,444139,0,444139
17996,MRVE3,2016-09-30,2016-11-09,444139,0,444139
17997,MRVE3,2016-12-31,2017-03-13,444139,0,444139
17998,MRVE3,2017-03-31,2017-05-11,444139,0,444139
17999,MRVE3,2017-06-30,2017-08-09,444139,0,444139
18000,MRVE3,2017-09-30,2017-11-07,444139,0,444139
18001,MRVE3,2017-12-31,2018-03-08,444139,0,444139
18002,MRVE3,2018-03-31,2018-05-07,444139,0,444139
18003,MRVE3,2018-06-30,2018-08-09,444139,0,444139
18004,MRVE3,2018-09-30,2018-11-07,444139,0,444139
18005,MRVE3,2018-12-31,2019-02-28,444139,0,444139
18006,MRVE3,2019-03-31,2019-05-08,444139,0,444139
18007,MRVE3,2019-06-30,2019-08-08,444139,0,444139
18008,MRVE3,2019-09-30,2019-11-12,444139,0,444139
18009,MRVE3,2019-12-31,2020-03-02,444139,0,444139
18010,MRVE3,2020-03-31,2020-05-28,481954,0,481954
18011,MRVE3,2020-06-30,2020-08-14,481954,0,481954
18012,MRVE3,2020-09-30,2020-11-11,481954,0,481954
18013,MRVE3,2020-12-31,2021-03-04,481954,0,481954
18014,BEEF3,2010-12-31,2011-07-12,105793418,0,105793418
18015,BEEF3,2011-03-31,2011-07-12,105794018,0,105794018
18016,BEEF3,2011-06-30,2011-08-14,105794018,0,105794018
18017,BEEF3,2011-09-30,2011-11-03,105843818,0,105843818
18018,BEEF3,2011-12-31,2013-03-20,105909718,0,105909718
18019,BEEF3,2012-03-31,2013-03-20,106650412,0,106650412
18020,BEEF3,2012-06-30,2013-03-20,105680310,0,105680310
18021,BEEF3,2012-09-30,2013-03-20,108807556,0,108807556
18022,BEEF3,2012-12-31,2013-03-20,146307556,0,146307556
18023,BEEF3,2013-03-31,2013-05-09,146575057,0,146575057
18024,BEEF3,2013-06-30,2013-08-14,146575057,0,146575057
18025,BEEF3,2013-09-30,2013-11-13,141344525,0,141344525
18026,BEEF3,2013-12-31,2014-03-11,145056023,0,145056023
18027,BEEF3,2014-03-31,2014-05-07,149000090,0,149000090
18028,BEEF3,2014-06-30,2014-07-31,149000090,0,149000090
18029,BEEF3,2014-09-30,2014-11-07,149000000,0,149000000
18030,BEEF3,2014-12-31,2015-03-27,178000090,0,178000090
18031,BEEF3,2015-03-31,2015-04-29,178002062,0,178002062
18032,BEEF3,2015-06-30,2015-08-04,191993702,0,191993702
18033,BEEF3,2015-09-30,2015-11-10,191993702,0,191993702
18034,BEEF3,2015-12-31,2016-03-08,191993702,0,191993702
18035,BEEF3,2016-03-31,2016-05-11,191993702,0,191993702
18036,BEEF3,2016-06-30,2016-08-02,239844659,0,239844659
18037,BEEF3,2016-09-30,2016-11-08,239844659,0,239844659
18038,BEEF3,2016-12-31,2017-02-23,239844659,0,239844659
18039,BEEF3,2017-03-31,2017-06-12,229860259,0,229860259
18040,BEEF3,2017-06-30,2017-08-14,229860259,0,229860259
18041,BEEF3,2017-09-30,2017-11-09,229860259,0,229860259
18042,BEEF3,2017-12-31,2018-03-05,229860259,0,229860259
18043,BEEF3,2018-03-31,2018-05-11,223618459,0,223618459
18044,BEEF3,2018-06-30,2018-08-10,223618459,0,223618459
18045,BEEF3,2018-09-30,2018-11-06,226418459,0,226418459
18046,BEEF3,2018-12-31,2019-03-12,376687157,0,376687157
18047,BEEF3,2019-03-31,2019-05-14,376687410,0,376687410
18048,BEEF3,2019-06-30,2019-07-25,376729949,0,376729949
18049,BEEF3,2019-09-30,2019-11-12,376795131,0,376795131
18050,BEEF3,2019-12-31,2020-02-18,403596575,0,403596575
18051,BEEF3,2020-03-31,2020-04-28,485580177,0,485580177
18052,BEEF3,2020-06-30,2020-07-28,486478283,0,486478283
18053,BEEF3,2020-09-30,2020-11-03,548413533,0,548413533
18054,BEEF3,2020-12-31,2021-02-25,548426499,0,548426499
18055,ABCB4,2010-12-31,2011-04-30,67822120,67822120,135644240
18056,ABCB4,2011-03-31,2011-05-09,67822120,67822120,135644240
18057,ABCB4,2011-06-30,2011-08-08,67822120,67822120,135644240
18058,ABCB4,2011-09-30,2011-11-07,67822120,67822120,135644240
18059,ABCB4,2011-12-31,2012-03-30,67822120,67822120,135644240
18060,ABCB4,2012-03-31,2012-05-02,67822120,67822120,135644240
18061,ABCB4,2012-06-30,2012-07-31,67822120,67822120,135644240
18062,ABCB4,2012-09-30,2012-10-30,70237948,70174452,140412400
18063,ABCB4,2012-12-31,2013-03-27,70237948,70174452,140412400
18064,ABCB4,2013-03-31,2013-05-02,71978166,71868932,143847098
18065,ABCB4,2013-06-30,2013-08-09,71978166,71868932,143847098
18066,ABCB4,2013-09-30,2013-11-01,73697646,73535003,147232649
18067,ABCB4,2013-12-31,2014-03-28,73697646,73535003,147232649
18068,ABCB4,2014-03-31,2014-05-06,75648913,75394106,151043019
18069,ABCB4,2014-06-30,2014-08-01,75648913,75394106,151043019
18070,ABCB4,2014-09-30,2014-11-06,77571835,77195646,154767481
18071,ABCB4,2014-12-31,2015-03-27,77571835,77195646,154767481
18072,ABCB4,2015-03-31,2015-05-08,79715509,79211404,158926913
18073,ABCB4,2015-06-30,2015-08-11,79715509,79211404,158926913
18074,ABCB4,2015-09-30,2015-11-06,82796043,82095379,164891422
18075,ABCB4,2015-12-31,2016-03-29,82796043,82095379,164891422
18076,ABCB4,2016-03-31,2016-05-05,87515454,86482563,173998017
18077,ABCB4,2016-06-30,2016-08-04,87515454,86482563,173998017
18078,ABCB4,2016-09-30,2016-11-04,91773827,90450702,182224529
18079,ABCB4,2016-12-31,2017-03-29,91773827,90450702,182224529
18080,ABCB4,2017-03-31,2017-05-04,95780135,94207966,189988101
18081,ABCB4,2017-06-30,2017-08-03,95780135,94207966,189988101
18082,ABCB4,2017-09-30,2017-11-03,99152654,97402193,196554847
18083,ABCB4,2017-12-31,2018-03-29,99152654,97402193,196554847
18084,ABCB4,2018-03-31,2018-05-04,102749196,100820048,203569244
18085,ABCB4,2018-06-30,2018-08-03,102749196,100820048,203569244
18086,ABCB4,2018-09-30,2018-11-06,106634935,104498015,211132950
18087,ABCB4,2018-12-31,2019-03-29,106634935,104498015,211132950
18088,ABCB4,2019-03-31,2019-05-06,109496432,108862625,218359057
18089,ABCB4,2019-06-30,2019-08-05,109496432,108862625,218359057
18090,ABCB4,2019-09-30,2019-11-06,109496432,108862625,218359057
18091,ABCB4,2019-12-31,2020-03-27,109496432,108862625,218359057
18092,ABCB4,2020-03-31,2020-05-14,109496432,108862625,218359057
18093,ABCB4,2020-06-30,2020-08-07,109496432,108862625,218359057
18094,ABCB4,2020-09-30,2020-11-04,109496432,108862625,218359057
18095,ABCB4,2020-12-31,2021-02-08,110795134,110095733,220890867
18096,SGPS3,2010-12-31,2011-04-18,143647,0,143647
18097,SGPS3,2011-03-31,2011-05-16,143637,0,143637
18098,SGPS3,2011-06-30,2011-08-15,143637,0,143637
18099,SGPS3,2011-09-30,2011-11-14,143637,0,143637
18100,SGPS3,2011-12-31,2012-03-31,143647,0,143647
18101,SGPS3,2012-03-31,2012-05-17,143647,0,143647
18102,SGPS3,2012-06-30,2012-08-14,143647,0,143647
18103,SGPS3,2012-09-30,2012-11-14,143647,0,143647
18104,SGPS3,2012-12-31,2013-03-28,200000,0,200000
18105,SGPS3,2013-03-31,2013-05-15,200000,0,200000
18106,SGPS3,2013-06-30,2013-08-13,200000,0,200000
18107,SGPS3,2013-09-30,2013-11-12,200000,0,200000
18108,SGPS3,2013-12-31,2014-03-26,200000,0,200000
18109,SGPS3,2014-03-31,2014-05-13,200000,0,200000
18110,SGPS3,2014-06-30,2014-08-13,200000,0,200000
18111,SGPS3,2014-09-30,2014-11-11,200000,0,200000
18112,SGPS3,2014-12-31,2015-03-25,200000,0,200000
18113,SGPS3,2015-03-31,2015-05-13,200000,0,200000
18114,SGPS3,2015-06-30,2015-08-12,200000,0,200000
18115,SGPS3,2015-09-30,2015-11-16,200000,0,200000
18116,SGPS3,2015-12-31,2016-03-01,50000,0,50000
18117,SGPS3,2016-03-31,2016-04-19,50000,0,50000
18118,SGPS3,2016-06-30,2016-08-11,50000,0,50000
18119,SGPS3,2016-09-30,2016-11-10,50000,0,50000
18120,SGPS3,2016-12-31,2017-03-27,50000,0,50000
18121,SGPS3,2017-03-31,2017-05-15,50000,0,50000
18122,SGPS3,2017-06-30,2017-08-14,50000,0,50000
18123,SGPS3,2017-09-30,2017-11-13,50000,0,50000
18124,SGPS3,2017-12-31,2018-05-22,50000,0,50000
18125,SGPS3,2018-03-31,2018-05-14,50000,0,50000
18126,SGPS3,2018-06-30,2018-08-14,50000,0,50000
18127,SGPS3,2018-09-30,2018-11-13,50000,0,50000
18128,SGPS3,2018-12-31,2019-04-05,50000,0,50000
18129,SGPS3,2019-03-31,2019-05-18,50000,0,50000
18130,SGPS3,2019-06-30,2019-08-14,50000,0,50000
18131,SGPS3,2019-09-30,2019-11-13,50000,0,50000
18132,SGPS3,2019-12-31,2020-03-30,50000,0,50000
18133,SGPS3,2020-03-31,2020-06-25,50000,0,50000
18134,SGPS3,2020-06-30,2020-08-13,50000,0,50000
18135,SGPS3,2020-09-30,2020-11-12,50000,0,50000
18136,SGPS3,2020-12-31,2021-03-22,50000,0,50000
18137,MULT3,2010-12-31,2011-04-06,167338867,11858347,179197214
18138,MULT3,2011-03-31,2011-05-09,167338867,11858347,179197214
18139,MULT3,2011-06-30,2011-08-10,167338867,11858347,179197214
18140,MULT3,2011-09-30,2011-11-09,167338867,11858347,179197214
18141,MULT3,2011-12-31,2013-02-15,167338867,11858347,179197214
18142,MULT3,2012-03-31,2013-05-06,167338867,11858347,179197214
18143,MULT3,2012-06-30,2013-07-26,167338867,11858347,179197214
18144,MULT3,2012-09-30,2013-10-29,167338867,11858347,179197214
18145,MULT3,2012-12-31,2013-03-15,167338867,11858347,179197214
18146,MULT3,2013-03-31,2013-05-06,167338867,11858347,179197214
18147,MULT3,2013-06-30,2013-07-26,178138867,11858347,189997214
18148,MULT3,2013-09-30,2013-10-29,178138867,11858347,189997214
18149,MULT3,2013-12-31,2014-03-19,178138867,11858347,189997214
18150,MULT3,2014-03-31,2014-05-06,178138867,11858347,189997214
18151,MULT3,2014-06-30,2014-07-28,178138867,11858347,189997214
18152,MULT3,2014-09-30,2014-10-30,178138867,11858347,189997214
18153,MULT3,2014-12-31,2015-02-24,178138867,11858347,189997214
18154,MULT3,2015-03-31,2015-04-29,178138867,11858347,189997214
18155,MULT3,2015-06-30,2015-07-30,178138867,11858347,189997214
18156,MULT3,2015-09-30,2015-10-28,178138867,11858347,189997214
18157,MULT3,2015-12-31,2016-02-24,178138867,11858347,189997214
18158,MULT3,2016-03-31,2016-04-27,178138867,11858347,189997214
18159,MULT3,2016-06-30,2016-07-28,178138867,11858347,189997214
18160,MULT3,2016-09-30,2016-10-31,178138867,11858347,189997214
18161,MULT3,2016-12-31,2017-03-09,178138867,11858347,189997214
18162,MULT3,2017-03-31,2017-04-26,188395278,11858347,200253625
18163,MULT3,2017-06-30,2017-07-27,188395278,11858347,200253625
18164,MULT3,2017-09-30,2017-10-30,188395278,11858347,200253625
18165,MULT3,2017-12-31,2018-02-28,188395278,11858347,200253625
18166,MULT3,2018-03-31,2018-04-25,188395278,11858347,200253625
18167,MULT3,2018-06-30,2018-07-26,188395278,11858347,200253625
18168,MULT3,2018-09-30,2018-10-29,565185834,35575041,600760875
18169,MULT3,2018-12-31,2019-02-21,565185834,35575041,600760875
18170,MULT3,2019-03-31,2019-04-29,565185834,35575041,600760875
18171,MULT3,2019-06-30,2019-07-29,565185834,35575041,600760875
18172,MULT3,2019-09-30,2019-10-29,565185834,35575041,600760875
18173,MULT3,2019-12-31,2020-02-17,565185834,35575041,600760875
18174,MULT3,2020-03-31,2020-04-29,565185834,35575041,600760875
18175,MULT3,2020-06-30,2020-08-06,565185834,35575041,600760875
18176,MULT3,2020-09-30,2020-10-28,565185834,35575041,600760875
18177,MULT3,2020-12-31,2021-02-11,565185834,35575041,600760875
18178,BTOW3,2010-12-31,2011-03-23,113562867,0,113562867
18179,BTOW3,2011-03-31,2011-06-15,113562867,0,113562867
18180,BTOW3,2011-06-30,2011-08-10,159816337,0,159816337
18181,BTOW3,2011-09-30,2011-11-10,159816337,0,159816337
18182,BTOW3,2011-12-31,2012-04-11,159816337,0,159816337
18183,BTOW3,2012-03-31,2012-05-08,156536355,0,156536355
18184,BTOW3,2012-06-30,2012-08-14,156536355,0,156536355
18185,BTOW3,2012-09-30,2012-11-13,156536355,0,156536355
18186,BTOW3,2012-12-31,2013-03-07,156536355,0,156536355
18187,BTOW3,2013-03-31,2013-05-09,156536355,0,156536355
18188,BTOW3,2013-06-30,2013-08-14,156536355,0,156536355
18189,BTOW3,2013-09-30,2013-12-18,158175707,0,158175707
18190,BTOW3,2013-12-31,2014-03-19,158999202,0,158999202
18191,BTOW3,2014-03-31,2014-05-09,158999202,0,158999202
18192,BTOW3,2014-06-30,2014-08-13,158999202,0,158999202
18193,BTOW3,2014-09-30,2014-12-12,255278825,0,255278825
18194,BTOW3,2014-12-31,2015-03-18,255484410,0,255484410
18195,BTOW3,2015-03-31,2015-05-07,255484410,0,255484410
18196,BTOW3,2015-06-30,2015-08-13,256581347,0,256581347
18197,BTOW3,2015-09-30,2015-11-12,257148812,0,257148812
18198,BTOW3,2015-12-31,2016-03-15,257318364,0,257318364
18199,BTOW3,2016-03-31,2016-05-06,257318364,0,257318364
18200,BTOW3,2016-06-30,2016-08-11,257318364,0,257318364
18201,BTOW3,2016-09-30,2016-11-16,341794262,0,341794262
18202,BTOW3,2016-12-31,2017-02-20,342463558,0,342463558
18203,BTOW3,2017-03-31,2017-05-11,342463558,0,342463558
18204,BTOW3,2017-06-30,2017-08-10,452463558,0,452463558
18205,BTOW3,2017-09-30,2017-11-01,453527272,0,453527272
18206,BTOW3,2017-12-31,2018-03-07,453723681,0,453723681
18207,BTOW3,2018-03-31,2018-05-10,453723681,0,453723681
18208,BTOW3,2018-06-30,2018-08-09,453723681,0,453723681
18209,BTOW3,2018-09-30,2018-10-31,456836739,0,456836739
18210,BTOW3,2018-12-31,2019-03-20,457280804,0,457280804
18211,BTOW3,2019-03-31,2019-05-09,457280804,0,457280804
18212,BTOW3,2019-06-30,2019-08-08,457280804,0,457280804
18213,BTOW3,2019-09-30,2019-10-30,458758661,0,458758661
18214,BTOW3,2019-12-31,2020-02-21,523229262,0,523229262
18215,BTOW3,2020-03-31,2020-05-21,523229262,0,523229262
18216,BTOW3,2020-06-30,2020-08-13,524654065,0,524654065
18217,BTOW3,2020-09-30,2020-10-29,559632528,0,559632528
18218,BTOW3,2020-12-31,2021-03-04,559858093,0,559858093
18219,GSHP3,2010-12-31,2011-03-24,50480600,0,50480600
18220,GSHP3,2011-03-31,2011-07-07,50480600,0,50480600
18221,GSHP3,2011-06-30,2011-09-06,50480600,0,50480600
18222,GSHP3,2011-09-30,2011-11-11,50480600,0,50480600
18223,GSHP3,2011-12-31,2012-03-22,50480600,0,50480600
18224,GSHP3,2012-03-31,2012-05-15,50480600,0,50480600
18225,GSHP3,2012-06-30,2012-08-14,50480600,0,50480600
18226,GSHP3,2012-09-30,2012-11-29,50480600,0,50480600
18227,GSHP3,2012-12-31,2013-04-04,50480600,0,50480600
18228,GSHP3,2013-03-31,2013-05-15,50480600,0,50480600
18229,GSHP3,2013-06-30,2013-08-14,50480600,0,50480600
18230,GSHP3,2013-09-30,2013-11-14,50480600,0,50480600
18231,GSHP3,2013-12-31,2014-03-28,50480600,0,50480600
18232,GSHP3,2014-03-31,2014-05-15,50480600,0,50480600
18233,GSHP3,2014-06-30,2014-08-14,50480600,0,50480600
18234,GSHP3,2014-09-30,2014-11-14,50480600,0,50480600
18235,GSHP3,2014-12-31,2015-03-30,50480600,0,50480600
18236,GSHP3,2015-03-31,2015-05-15,50480600,0,50480600
18237,GSHP3,2015-06-30,2015-08-14,50480600,0,50480600
18238,GSHP3,2015-09-30,2015-11-13,50480600,0,50480600
18239,GSHP3,2015-12-31,2016-04-06,65000000,0,65000000
18240,GSHP3,2016-03-31,2016-05-12,65000000,0,65000000
18241,GSHP3,2016-06-30,2016-08-13,65000000,0,65000000
18242,GSHP3,2016-09-30,2016-11-12,76000000,0,76000000
18243,GSHP3,2016-12-31,2017-03-13,76000000,0,76000000
18244,GSHP3,2017-03-31,2017-05-15,76000000,0,76000000
18245,GSHP3,2017-06-30,2017-08-14,76000000,0,76000000
18246,GSHP3,2017-09-30,2017-11-13,69435699,0,69435699
18247,GSHP3,2017-12-31,2018-02-21,69435699,0,69435699
18248,GSHP3,2018-03-31,2018-05-15,69435699,0,69435699
18249,GSHP3,2018-06-30,2018-08-14,69435699,0,69435699
18250,GSHP3,2018-09-30,2018-11-16,69435699,0,69435699
18251,GSHP3,2018-12-31,2019-03-29,69435699,0,69435699
18252,GSHP3,2019-03-31,2019-05-15,69435699,0,69435699
18253,GSHP3,2019-06-30,2019-08-14,69435699,0,69435699
18254,GSHP3,2019-09-30,2019-11-14,69435699,0,69435699
18255,GSHP3,2019-12-31,2020-03-30,69435699,0,69435699
18256,GSHP3,2020-03-31,2020-05-13,1928769,0,1928769
18257,GSHP3,2020-06-30,2020-08-13,1928769,0,1928769
18258,GSHP3,2020-09-30,2020-11-12,1928769,0,1928769
18259,GSHP3,2020-12-31,2021-03-25,1928769,0,1928769
18260,ESTC3,2010-12-31,2011-03-17,82038041,0,82038041
18261,ESTC3,2011-03-31,2011-05-13,82038041,0,82038041
18262,ESTC3,2011-06-30,2011-08-11,82251937,0,82251937
18263,ESTC3,2011-09-30,2013-01-15,82019,0,82019
18264,ESTC3,2011-12-31,2013-01-18,82252,0,82252
18265,ESTC3,2012-03-31,2012-05-11,82251937,0,82251937
18266,ESTC3,2012-06-30,2012-08-08,82434559,0,82434559
18267,ESTC3,2012-09-30,2013-01-15,82215,0,82215
18268,ESTC3,2012-12-31,2013-03-26,82505,0,82505
18269,ESTC3,2013-03-31,2013-05-09,97192,0,97192
18270,ESTC3,2013-06-30,2013-08-20,293698,0,293698
18271,ESTC3,2013-09-30,2013-11-07,295096,0,295096
18272,ESTC3,2013-12-31,2014-03-25,293415,0,293415
18273,ESTC3,2014-03-31,2014-05-08,293415,0,293415
18274,ESTC3,2014-06-30,2014-08-07,295598,0,295598
18275,ESTC3,2014-09-30,2014-11-07,313633,0,313633
18276,ESTC3,2014-12-31,2015-03-19,313077,0,313077
18277,ESTC3,2015-03-31,2015-05-07,307324,0,307324
18278,ESTC3,2015-06-30,2015-08-06,308778,0,308778
18279,ESTC3,2015-09-30,2015-11-05,308816,0,308816
18280,ESTC3,2015-12-31,2016-03-10,307788,0,307788
18281,ESTC3,2016-03-31,2016-05-05,307348,0,307348
18282,ESTC3,2016-06-30,2016-08-12,317178,0,317178
18283,ESTC3,2016-09-30,2016-11-10,317896,0,317896
18284,ESTC3,2016-12-31,2017-03-16,308398360,0,308398360
18285,ESTC3,2017-03-31,2017-04-27,317896,0,317896
18286,ESTC3,2017-06-30,2017-07-27,309206,0,309206
18287,ESTC3,2017-09-30,2017-10-27,309217,0,309217
18288,ESTC3,2017-12-31,2018-03-15,309434,0,309434
18289,ESTC3,2018-03-31,2018-04-27,317896,0,317896
18290,ESTC3,2018-06-30,2018-08-14,309089,0,309089
18291,ESTC3,2018-09-30,2018-11-07,309089,0,309089
18292,ESTC3,2018-12-31,2019-03-14,309089,0,309089
18293,ESTC3,2019-03-31,2019-05-09,309089,0,309089
18294,ESTC3,2019-06-30,2019-08-12,309089,0,309089
18295,ESTC3,2019-09-30,2019-11-11,309089,0,309089
18296,ESTC3,2019-12-31,2020-03-23,309089,0,309089
18297,ESTC3,2020-03-31,2020-05-07,309089,0,309089
18298,ESTC3,2020-06-30,2020-08-26,309089,0,309089
18299,ESTC3,2020-09-30,2020-11-09,309089,0,309089
18300,ESTC3,2020-12-31,2021-03-17,309089,0,309089
18301,YDUQ3,2010-12-31,2011-03-17,82038041,0,82038041
18302,YDUQ3,2011-03-31,2011-05-13,82038041,0,82038041
18303,YDUQ3,2011-06-30,2011-08-11,82251937,0,82251937
18304,YDUQ3,2011-09-30,2013-01-15,82019,0,82019
18305,YDUQ3,2011-12-31,2013-01-18,82252,0,82252
18306,YDUQ3,2012-03-31,2012-05-11,82251937,0,82251937
18307,YDUQ3,2012-06-30,2012-08-08,82434559,0,82434559
18308,YDUQ3,2012-09-30,2013-01-15,82215,0,82215
18309,YDUQ3,2012-12-31,2013-03-26,82505,0,82505
18310,YDUQ3,2013-03-31,2013-05-09,97192,0,97192
18311,YDUQ3,2013-06-30,2013-08-20,293698,0,293698
18312,YDUQ3,2013-09-30,2013-11-07,295096,0,295096
18313,YDUQ3,2013-12-31,2014-03-25,293415,0,293415
18314,YDUQ3,2014-03-31,2014-05-08,293415,0,293415
18315,YDUQ3,2014-06-30,2014-08-07,295598,0,295598
18316,YDUQ3,2014-09-30,2014-11-07,313633,0,313633
18317,YDUQ3,2014-12-31,2015-03-19,313077,0,313077
18318,YDUQ3,2015-03-31,2015-05-07,307324,0,307324
18319,YDUQ3,2015-06-30,2015-08-06,308778,0,308778
18320,YDUQ3,2015-09-30,2015-11-05,308816,0,308816
18321,YDUQ3,2015-12-31,2016-03-10,307788,0,307788
18322,YDUQ3,2016-03-31,2016-05-05,307348,0,307348
18323,YDUQ3,2016-06-30,2016-08-12,317178,0,317178
18324,YDUQ3,2016-09-30,2016-11-10,317896,0,317896
18325,YDUQ3,2016-12-31,2017-03-16,308398360,0,308398360
18326,YDUQ3,2017-03-31,2017-04-27,317896,0,317896
18327,YDUQ3,2017-06-30,2017-07-27,309206,0,309206
18328,YDUQ3,2017-09-30,2017-10-27,309217,0,309217
18329,YDUQ3,2017-12-31,2018-03-15,309434,0,309434
18330,YDUQ3,2018-03-31,2018-04-27,317896,0,317896
18331,YDUQ3,2018-06-30,2018-08-14,309089,0,309089
18332,YDUQ3,2018-09-30,2018-11-07,309089,0,309089
18333,YDUQ3,2018-12-31,2019-03-14,309089,0,309089
18334,YDUQ3,2019-03-31,2019-05-09,309089,0,309089
18335,YDUQ3,2019-06-30,2019-08-12,309089,0,309089
18336,YDUQ3,2019-09-30,2019-11-11,309089,0,309089
18337,YDUQ3,2019-12-31,2020-03-23,309089,0,309089
18338,YDUQ3,2020-03-31,2020-05-07,309089,0,309089
18339,YDUQ3,2020-06-30,2020-08-26,309089,0,309089
18340,YDUQ3,2020-09-30,2020-11-09,309089,0,309089
18341,YDUQ3,2020-12-31,2021-03-17,309089,0,309089
18342,CCPR3,2010-12-31,2011-03-10,86500,0,86500
18343,CCPR3,2011-03-31,2011-05-11,86500,0,86500
18344,CCPR3,2011-06-30,2011-08-04,86500,0,86500
18345,CCPR3,2011-09-30,2011-11-08,86500,0,86500
18346,CCPR3,2011-12-31,2012-03-06,86500,0,86500
18347,CCPR3,2012-03-31,2012-05-09,83000,0,83000
18348,CCPR3,2012-06-30,2012-08-06,83000,0,83000
18349,CCPR3,2012-09-30,2012-11-08,83000,0,83000
18350,CCPR3,2012-12-31,2013-02-28,83000,0,83000
18351,CCPR3,2013-03-31,2013-05-08,83000,0,83000
18352,CCPR3,2013-06-30,2013-08-12,83000,0,83000
18353,CCPR3,2013-09-30,2013-11-06,83000,0,83000
18354,CCPR3,2013-12-31,2014-02-24,83000,0,83000
18355,CCPR3,2014-03-31,2014-05-08,83000,0,83000
18356,CCPR3,2014-06-30,2014-08-11,83000,0,83000
18357,CCPR3,2014-09-30,2014-11-10,83000,0,83000
18358,CCPR3,2014-12-31,2015-03-20,83000,0,83000
18359,CCPR3,2015-03-31,2015-05-13,83000,0,83000
18360,CCPR3,2015-06-30,2015-08-12,83000,0,83000
18361,CCPR3,2015-09-30,2015-11-11,83000,0,83000
18362,CCPR3,2015-12-31,2016-03-10,119664,0,119664
18363,CCPR3,2016-03-31,2016-05-11,119664,0,119664
18364,CCPR3,2016-06-30,2016-08-10,119664,0,119664
18365,CCPR3,2016-09-30,2016-11-10,119664,0,119664
18366,CCPR3,2016-12-31,2017-03-09,119664,0,119664
18367,CCPR3,2017-03-31,2017-05-15,119664,0,119664
18368,CCPR3,2017-06-30,2017-08-09,119664,0,119664
18369,CCPR3,2017-09-30,2017-11-09,119664,0,119664
18370,CCPR3,2017-12-31,2019-08-29,119664,0,119664
18371,CCPR3,2018-03-31,2018-04-26,119664,0,119664
18372,CCPR3,2018-06-30,2018-07-31,119664,0,119664
18373,CCPR3,2018-09-30,2018-10-30,119664,0,119664
18374,CCPR3,2018-12-31,2019-02-14,119664,0,119664
18375,CCPR3,2019-03-31,2019-04-30,119664,0,119664
18376,CCPR3,2019-06-30,2019-08-08,119664,0,119664
18377,CCPR3,2019-09-30,2019-11-11,119664,0,119664
18378,CCPR3,2019-12-31,2020-02-17,165113,0,165113
18379,CCPR3,2020-03-31,2020-05-15,165114,0,165114
18380,CCPR3,2020-06-30,2020-08-06,165114,0,165114
18381,CCPR3,2020-09-30,2020-11-16,158582,0,158582
18382,CCPR3,2020-12-31,2021-02-11,152644,0,152644
18383,MDNE3,2010-12-31,2011-06-07,78993,0,78993
18384,MDNE3,2011-03-31,2011-11-19,78993,0,78993
18385,MDNE3,2011-06-30,2012-02-07,78993,0,78993
18386,MDNE3,2011-09-30,2012-07-04,355075,0,355075
18387,MDNE3,2011-12-31,2012-08-24,355075,0,355075
18388,MDNE3,2012-03-31,2012-09-26,355075,0,355075
18389,MDNE3,2012-06-30,2012-10-05,355076,0,355076
18390,MDNE3,2012-09-30,2012-11-14,355076,0,355076
18391,MDNE3,2012-12-31,2013-03-27,355076,0,355076
18392,MDNE3,2013-03-31,2014-03-30,355076,0,355076
18393,MDNE3,2013-06-30,2014-03-30,355076,0,355076
18394,MDNE3,2013-09-30,2014-03-30,355076,0,355076
18395,MDNE3,2013-12-31,2014-04-14,355076,0,355076
18396,MDNE3,2014-03-31,2014-07-23,377918,0,377918
18397,MDNE3,2014-06-30,2014-08-13,377918,0,377918
18398,MDNE3,2014-09-30,2014-11-13,377918,0,377918
18399,MDNE3,2014-12-31,2015-03-31,377918,0,377918
18400,MDNE3,2015-03-31,2015-05-14,377918,0,377918
18401,MDNE3,2015-06-30,2015-08-12,377918,0,377918
18402,MDNE3,2015-09-30,2015-11-13,377918,0,377918
18403,MDNE3,2015-12-31,2016-03-29,377918,0,377918
18404,MDNE3,2016-03-31,2019-12-07,377918,0,377918
18405,MDNE3,2016-06-30,2019-12-07,377918,0,377918
18406,MDNE3,2016-09-30,2019-12-07,377918,0,377918
18407,MDNE3,2016-12-31,2019-12-07,401377,0,401377
18408,MDNE3,2017-03-31,2019-12-07,401377,0,401377
18409,MDNE3,2017-06-30,2019-12-07,401377,0,401377
18410,MDNE3,2017-09-30,2019-12-07,401377,0,401377
18411,MDNE3,2017-12-31,2019-12-07,401377,0,401377
18412,MDNE3,2018-03-31,2020-01-21,401377,0,401377
18413,MDNE3,2018-06-30,2020-01-21,401377,0,401377
18414,MDNE3,2018-09-30,2020-01-21,401377,0,401377
18415,MDNE3,2018-12-31,2020-02-06,401377,0,401377
18416,MDNE3,2019-03-31,2020-02-06,401377,0,401377
18417,MDNE3,2019-06-30,2020-02-06,401377,0,401377
18418,MDNE3,2019-09-30,2020-02-06,401377,0,401377
18419,MDNE3,2019-12-31,2020-09-02,26758480,0,26758480
18420,MDNE3,2020-03-31,2020-05-14,84909375,0,84909375
18421,MDNE3,2020-06-30,2020-09-02,84909375,0,84909375
18422,MDNE3,2020-09-30,2020-11-12,84909375,0,84909375
18423,MDNE3,2020-12-31,2021-03-11,84909375,0,84909375
18424,DTEX3,2010-12-31,2011-02-15,458362776,0,458362776
18425,DTEX3,2011-03-31,2011-05-06,458363,0,458363
18426,DTEX3,2011-06-30,2011-08-01,550035,0,550035
18427,DTEX3,2011-09-30,2011-11-03,550035,0,550035
18428,DTEX3,2011-12-31,2012-02-17,550035,0,550035
18429,DTEX3,2012-03-31,2012-04-26,550035,0,550035
18430,DTEX3,2012-06-30,2012-07-27,550038,0,550038
18431,DTEX3,2012-09-30,2012-10-25,550054,0,550054
18432,DTEX3,2012-12-31,2013-02-22,550054,0,550054
18433,DTEX3,2013-03-31,2013-04-22,550054,0,550054
18434,DTEX3,2013-06-30,2013-07-22,605059,0,605059
18435,DTEX3,2013-09-30,2013-10-28,605059,0,605059
18436,DTEX3,2013-12-31,2014-02-17,605059,0,605059
18437,DTEX3,2014-03-31,2014-04-23,605059,0,605059
18438,DTEX3,2014-06-30,2014-07-30,665565,0,665565
18439,DTEX3,2014-09-30,2014-10-28,665565,0,665565
18440,DTEX3,2014-12-31,2015-02-05,665565,0,665565
18441,DTEX3,2015-03-31,2015-04-28,665565,0,665565
18442,DTEX3,2015-06-30,2015-07-28,665565,0,665565
18443,DTEX3,2015-09-30,2015-10-29,665565,0,665565
18444,DTEX3,2015-12-31,2016-02-15,665565,0,665565
18445,DTEX3,2016-03-31,2016-04-28,665565,0,665565
18446,DTEX3,2016-06-30,2016-08-01,691785,0,691785
18447,DTEX3,2016-09-30,2016-10-28,691785,0,691785
18448,DTEX3,2016-12-31,2017-02-08,691785,0,691785
18449,DTEX3,2017-03-31,2017-04-26,691785,0,691785
18450,DTEX3,2017-06-30,2017-08-10,691785,0,691785
18451,DTEX3,2017-09-30,2017-10-27,691785,0,691785
18452,DTEX3,2017-12-31,2018-02-05,691785,0,691785
18453,DTEX3,2018-03-31,2018-05-02,691785,0,691785
18454,DTEX3,2018-06-30,2018-08-01,691785,0,691785
18455,DTEX3,2018-09-30,2018-11-05,691785,0,691785
18456,DTEX3,2018-12-31,2019-02-13,691785,0,691785
18457,DTEX3,2019-03-31,2019-05-06,691785,0,691785
18458,DTEX3,2019-06-30,2019-07-31,691785,0,691785
18459,DTEX3,2019-09-30,2019-10-29,691785,0,691785
18460,DTEX3,2019-12-31,2020-02-12,691785,0,691785
18461,DTEX3,2020-03-31,2020-05-06,691785,0,691785
18462,DTEX3,2020-06-30,2020-07-29,691785,0,691785
18463,DTEX3,2020-09-30,2020-11-03,691785,0,691785
18464,DTEX3,2020-12-31,2021-02-08,691785,0,691785
18465,SULA11,2010-12-31,2011-02-25,462115137,369777303,831892440
18466,SULA11,2011-03-31,2011-05-05,462115137,369777303,831892440
18467,SULA11,2011-06-30,2011-08-04,462378037,370303103,832681140
18468,SULA11,2011-09-30,2011-11-21,462378037,370303103,832681140
18469,SULA11,2011-12-31,2012-02-27,461629237,368805503,830434740
18470,SULA11,2012-03-31,2012-04-30,469644043,375208704,844852747
18471,SULA11,2012-06-30,2012-07-30,469544812,375010247,844555059
18472,SULA11,2012-09-30,2012-10-30,468767912,373456447,842224359
18473,SULA11,2012-12-31,2013-02-27,468767912,373456447,842224359
18474,SULA11,2013-03-31,2013-05-24,474206251,384333120,858539371
18475,SULA11,2013-06-30,2013-07-30,564605714,457599779,1022205493
18476,SULA11,2013-09-30,2013-10-30,564605714,457599779,1022205493
18477,SULA11,2013-12-31,2014-03-17,512362664,509842829,1022205493
18478,SULA11,2014-03-31,2014-05-15,512362664,509842829,1022205493
18479,SULA11,2014-06-30,2014-07-31,512362664,509842829,1022205493
18480,SULA11,2014-09-30,2014-10-28,512362664,509842829,1022205493
18481,SULA11,2014-12-31,2015-02-26,512362664,509842829,1022205493
18482,SULA11,2015-03-31,2016-03-01,512362664,509842829,1022205493
18483,SULA11,2015-06-30,2016-03-01,512362664,509842829,1022205493
18484,SULA11,2015-09-30,2016-03-01,512362664,509842829,1022205493
18485,SULA11,2015-12-31,2016-02-24,512362664,509842829,1022205493
18486,SULA11,2016-03-31,2016-04-28,512362664,509842829,1022205493
18487,SULA11,2016-06-30,2016-07-28,512362664,509842829,1022205493
18488,SULA11,2016-09-30,2016-10-26,512362664,509842829,1022205493
18489,SULA11,2016-12-31,2017-02-21,512362664,509842829,1022205493
18490,SULA11,2017-03-31,2017-05-04,592688393,589773510,1182461903
18491,SULA11,2017-06-30,2017-08-03,592688393,589773510,1182461903
18492,SULA11,2017-09-30,2017-10-30,592688393,589773510,1182461903
18493,SULA11,2017-12-31,2018-02-27,592688393,589773510,1182461903
18494,SULA11,2018-03-31,2018-05-03,592688393,589773510,1182461903
18495,SULA11,2018-06-30,2018-08-02,592688393,589773510,1182461903
18496,SULA11,2018-09-30,2018-10-31,592688393,589773510,1182461903
18497,SULA11,2018-12-31,2019-02-26,592688393,589773510,1182461903
18498,SULA11,2019-03-31,2019-05-08,592688393,589773510,1182461903
18499,SULA11,2019-06-30,2019-08-07,592688393,589773510,1182461903
18500,SULA11,2019-09-30,2019-11-07,592688393,589773510,1182461903
18501,SULA11,2019-12-31,2020-02-20,592688393,589773510,1182461903
18502,SULA11,2020-03-31,2020-05-13,592688393,589773510,1182461903
18503,SULA11,2020-06-30,2020-08-05,592688393,589773510,1182461903
18504,SULA11,2020-09-30,2020-11-12,592688393,589773510,1182461903
18505,SULA11,2020-12-31,2021-02-24,603835151,600865447,1204700598
18506,SULA3,2010-12-31,2011-02-25,462115137,369777303,831892440
18507,SULA3,2011-03-31,2011-05-05,462115137,369777303,831892440
18508,SULA3,2011-06-30,2011-08-04,462378037,370303103,832681140
18509,SULA3,2011-09-30,2011-11-21,462378037,370303103,832681140
18510,SULA3,2011-12-31,2012-02-27,461629237,368805503,830434740
18511,SULA3,2012-03-31,2012-04-30,469644043,375208704,844852747
18512,SULA3,2012-06-30,2012-07-30,469544812,375010247,844555059
18513,SULA3,2012-09-30,2012-10-30,468767912,373456447,842224359
18514,SULA3,2012-12-31,2013-02-27,468767912,373456447,842224359
18515,SULA3,2013-03-31,2013-05-24,474206251,384333120,858539371
18516,SULA3,2013-06-30,2013-07-30,564605714,457599779,1022205493
18517,SULA3,2013-09-30,2013-10-30,564605714,457599779,1022205493
18518,SULA3,2013-12-31,2014-03-17,512362664,509842829,1022205493
18519,SULA3,2014-03-31,2014-05-15,512362664,509842829,1022205493
18520,SULA3,2014-06-30,2014-07-31,512362664,509842829,1022205493
18521,SULA3,2014-09-30,2014-10-28,512362664,509842829,1022205493
18522,SULA3,2014-12-31,2015-02-26,512362664,509842829,1022205493
18523,SULA3,2015-03-31,2016-03-01,512362664,509842829,1022205493
18524,SULA3,2015-06-30,2016-03-01,512362664,509842829,1022205493
18525,SULA3,2015-09-30,2016-03-01,512362664,509842829,1022205493
18526,SULA3,2015-12-31,2016-02-24,512362664,509842829,1022205493
18527,SULA3,2016-03-31,2016-04-28,512362664,509842829,1022205493
18528,SULA3,2016-06-30,2016-07-28,512362664,509842829,1022205493
18529,SULA3,2016-09-30,2016-10-26,512362664,509842829,1022205493
18530,SULA3,2016-12-31,2017-02-21,512362664,509842829,1022205493
18531,SULA3,2017-03-31,2017-05-04,592688393,589773510,1182461903
18532,SULA3,2017-06-30,2017-08-03,592688393,589773510,1182461903
18533,SULA3,2017-09-30,2017-10-30,592688393,589773510,1182461903
18534,SULA3,2017-12-31,2018-02-27,592688393,589773510,1182461903
18535,SULA3,2018-03-31,2018-05-03,592688393,589773510,1182461903
18536,SULA3,2018-06-30,2018-08-02,592688393,589773510,1182461903
18537,SULA3,2018-09-30,2018-10-31,592688393,589773510,1182461903
18538,SULA3,2018-12-31,2019-02-26,592688393,589773510,1182461903
18539,SULA3,2019-03-31,2019-05-08,592688393,589773510,1182461903
18540,SULA3,2019-06-30,2019-08-07,592688393,589773510,1182461903
18541,SULA3,2019-09-30,2019-11-07,592688393,589773510,1182461903
18542,SULA3,2019-12-31,2020-02-20,592688393,589773510,1182461903
18543,SULA3,2020-03-31,2020-05-13,592688393,589773510,1182461903
18544,SULA3,2020-06-30,2020-08-05,592688393,589773510,1182461903
18545,SULA3,2020-09-30,2020-11-12,592688393,589773510,1182461903
18546,SULA3,2020-12-31,2021-02-24,603835151,600865447,1204700598
18547,SULA4,2010-12-31,2011-02-25,462115137,369777303,831892440
18548,SULA4,2011-03-31,2011-05-05,462115137,369777303,831892440
18549,SULA4,2011-06-30,2011-08-04,462378037,370303103,832681140
18550,SULA4,2011-09-30,2011-11-21,462378037,370303103,832681140
18551,SULA4,2011-12-31,2012-02-27,461629237,368805503,830434740
18552,SULA4,2012-03-31,2012-04-30,469644043,375208704,844852747
18553,SULA4,2012-06-30,2012-07-30,469544812,375010247,844555059
18554,SULA4,2012-09-30,2012-10-30,468767912,373456447,842224359
18555,SULA4,2012-12-31,2013-02-27,468767912,373456447,842224359
18556,SULA4,2013-03-31,2013-05-24,474206251,384333120,858539371
18557,SULA4,2013-06-30,2013-07-30,564605714,457599779,1022205493
18558,SULA4,2013-09-30,2013-10-30,564605714,457599779,1022205493
18559,SULA4,2013-12-31,2014-03-17,512362664,509842829,1022205493
18560,SULA4,2014-03-31,2014-05-15,512362664,509842829,1022205493
18561,SULA4,2014-06-30,2014-07-31,512362664,509842829,1022205493
18562,SULA4,2014-09-30,2014-10-28,512362664,509842829,1022205493
18563,SULA4,2014-12-31,2015-02-26,512362664,509842829,1022205493
18564,SULA4,2015-03-31,2016-03-01,512362664,509842829,1022205493
18565,SULA4,2015-06-30,2016-03-01,512362664,509842829,1022205493
18566,SULA4,2015-09-30,2016-03-01,512362664,509842829,1022205493
18567,SULA4,2015-12-31,2016-02-24,512362664,509842829,1022205493
18568,SULA4,2016-03-31,2016-04-28,512362664,509842829,1022205493
18569,SULA4,2016-06-30,2016-07-28,512362664,509842829,1022205493
18570,SULA4,2016-09-30,2016-10-26,512362664,509842829,1022205493
18571,SULA4,2016-12-31,2017-02-21,512362664,509842829,1022205493
18572,SULA4,2017-03-31,2017-05-04,592688393,589773510,1182461903
18573,SULA4,2017-06-30,2017-08-03,592688393,589773510,1182461903
18574,SULA4,2017-09-30,2017-10-30,592688393,589773510,1182461903
18575,SULA4,2017-12-31,2018-02-27,592688393,589773510,1182461903
18576,SULA4,2018-03-31,2018-05-03,592688393,589773510,1182461903
18577,SULA4,2018-06-30,2018-08-02,592688393,589773510,1182461903
18578,SULA4,2018-09-30,2018-10-31,592688393,589773510,1182461903
18579,SULA4,2018-12-31,2019-02-26,592688393,589773510,1182461903
18580,SULA4,2019-03-31,2019-05-08,592688393,589773510,1182461903
18581,SULA4,2019-06-30,2019-08-07,592688393,589773510,1182461903
18582,SULA4,2019-09-30,2019-11-07,592688393,589773510,1182461903
18583,SULA4,2019-12-31,2020-02-20,592688393,589773510,1182461903
18584,SULA4,2020-03-31,2020-05-13,592688393,589773510,1182461903
18585,SULA4,2020-06-30,2020-08-05,592688393,589773510,1182461903
18586,SULA4,2020-09-30,2020-11-12,592688393,589773510,1182461903
18587,SULA4,2020-12-31,2021-02-24,603835151,600865447,1204700598
18588,TRIS3,2010-12-31,2011-03-29,81799,0,81799
18589,TRIS3,2011-03-31,2011-05-13,81799,0,81799
18590,TRIS3,2011-06-30,2011-10-13,81799,0,81799
18591,TRIS3,2011-09-30,2011-11-14,81799,0,81799
18592,TRIS3,2011-12-31,2012-03-29,81799,0,81799
18593,TRIS3,2012-03-31,2012-05-15,81799,0,81799
18594,TRIS3,2012-06-30,2012-08-14,81799,0,81799
18595,TRIS3,2012-09-30,2012-11-12,81799,0,81799
18596,TRIS3,2012-12-31,2013-03-21,81799,0,81799
18597,TRIS3,2013-03-31,2013-05-15,81799,0,81799
18598,TRIS3,2013-06-30,2013-08-14,81799,0,81799
18599,TRIS3,2013-09-30,2013-11-12,81799,0,81799
18600,TRIS3,2013-12-31,2014-03-13,81799,0,81799
18601,TRIS3,2014-03-31,2014-05-14,81799,0,81799
18602,TRIS3,2014-06-30,2014-08-13,81799,0,81799
18603,TRIS3,2014-09-30,2014-11-11,81799,0,81799
18604,TRIS3,2014-12-31,2015-03-19,81799,0,81799
18605,TRIS3,2015-03-31,2015-05-14,78759,0,78759
18606,TRIS3,2015-06-30,2015-08-13,78759,0,78759
18607,TRIS3,2015-09-30,2015-11-13,78759,0,78759
18608,TRIS3,2015-12-31,2016-03-18,75758,0,75758
18609,TRIS3,2016-03-31,2016-05-13,75759,0,75759
18610,TRIS3,2016-06-30,2016-08-15,73059,0,73059
18611,TRIS3,2016-09-30,2016-11-11,73059,0,73059
18612,TRIS3,2016-12-31,2017-03-20,73059,0,73059
18613,TRIS3,2017-03-31,2017-05-15,73059,0,73059
18614,TRIS3,2017-06-30,2017-08-14,73059,0,73059
18615,TRIS3,2017-09-30,2017-11-13,73059,0,73059
18616,TRIS3,2017-12-31,2018-03-16,73059,0,73059
18617,TRIS3,2018-03-31,2018-05-15,73059,0,73059
18618,TRIS3,2018-06-30,2018-08-15,146118,0,146118
18619,TRIS3,2018-09-30,2018-11-13,146118,0,146118
18620,TRIS3,2018-12-31,2019-03-12,146118,0,146118
18621,TRIS3,2019-03-31,2019-05-13,146118,0,146118
18622,TRIS3,2019-06-30,2019-08-26,146118,0,146118
18623,TRIS3,2019-09-30,2019-11-12,186618,0,186618
18624,TRIS3,2019-12-31,2020-03-10,186618,0,186618
18625,TRIS3,2020-03-31,2020-05-12,186617,0,186617
18626,TRIS3,2020-06-30,2020-08-13,186617,0,186617
18627,TRIS3,2020-09-30,2020-11-12,186617,0,186617
18628,TRIS3,2020-12-31,2021-03-10,186618,0,186618
18629,TEND3,2010-12-31,2011-03-28,400652,0,400652
18630,TEND3,2011-03-31,2011-05-10,523276,0,523276
18631,TEND3,2011-06-30,2011-08-12,523276,0,523276
18632,TEND3,2011-09-30,2011-11-14,633058,0,633058
18633,TEND3,2011-12-31,2012-04-12,633058,0,633058
18634,TEND3,2012-03-31,2012-05-08,633058,0,633058
18635,TEND3,2012-06-30,2012-08-10,633058,0,633058
18636,TEND3,2012-09-30,2012-11-12,633058,0,633058
18637,TEND3,2012-12-31,2013-03-11,633137,0,633137
18638,TEND3,2013-03-31,2013-05-10,633137,0,633137
18639,TEND3,2013-06-30,2013-08-09,633137,0,633137
18640,TEND3,2013-09-30,2013-11-05,633137,0,633137
18641,TEND3,2013-12-31,2016-10-18,633037801,0,633037801
18642,TEND3,2014-03-31,2014-05-09,633037,0,633037
18643,TEND3,2014-06-30,2014-08-08,633037,0,633037
18644,TEND3,2014-09-30,2014-11-07,633037,0,633037
18645,TEND3,2014-12-31,2016-10-18,633037,0,633037
18646,TEND3,2015-03-31,2015-05-07,633037,0,633037
18647,TEND3,2015-06-30,2015-08-07,633037,0,633037
18648,TEND3,2015-09-30,2015-11-06,633037,0,633037
18649,TEND3,2015-12-31,2016-10-18,633037,0,633037
18650,TEND3,2016-03-31,2016-05-05,633037,0,633037
18651,TEND3,2016-06-30,2016-08-11,633037,0,633037
18652,TEND3,2016-09-30,2016-10-18,633037,0,633037
18653,TEND3,2016-12-31,2017-03-13,54000,0,54000
18654,TEND3,2017-03-31,2017-05-09,54000,0,54000
18655,TEND3,2017-06-30,2017-08-10,54000,0,54000
18656,TEND3,2017-09-30,2017-11-10,54000,0,54000
18657,TEND3,2017-12-31,2018-03-08,54035,0,54035
18658,TEND3,2018-03-31,2018-05-10,54035,0,54035
18659,TEND3,2018-06-30,2018-08-13,54035,0,54035
18660,TEND3,2018-09-30,2018-11-08,54172,0,54172
18661,TEND3,2018-12-31,2019-03-12,52081,0,52081
18662,TEND3,2019-03-31,2019-05-09,104344,0,104344
18663,TEND3,2019-06-30,2019-08-08,104344,0,104344
18664,TEND3,2019-09-30,2019-11-07,104344,0,104344
18665,TEND3,2019-12-31,2020-03-19,104344,0,104344
18666,TEND3,2020-03-31,2020-05-14,104344,0,104344
18667,TEND3,2020-06-30,2020-08-06,104344,0,104344
18668,TEND3,2020-09-30,2020-11-05,104344,0,104344
18669,TEND3,2020-12-31,2021-03-11,104344,0,104344
18670,BBRK3,2010-12-31,2012-02-13,168877,0,168877
18671,BBRK3,2011-03-31,2011-05-18,192840,0,192840
18672,BBRK3,2011-06-30,2011-08-15,192840,0,192840
18673,BBRK3,2011-09-30,2011-11-14,192840,0,192840
18674,BBRK3,2011-12-31,2012-04-05,179043,0,179043
18675,BBRK3,2012-03-31,2012-05-14,191024,0,191024
18676,BBRK3,2012-06-30,2012-08-14,191024,0,191024
18677,BBRK3,2012-09-30,2012-11-13,190814,0,190814
18678,BBRK3,2012-12-31,2013-03-20,190814,0,190814
18679,BBRK3,2013-03-31,2013-05-09,190814,0,190814
18680,BBRK3,2013-06-30,2013-08-13,190814,0,190814
18681,BBRK3,2013-09-30,2013-11-13,190814,0,190814
18682,BBRK3,2013-12-31,2014-03-18,190814,0,190814
18683,BBRK3,2014-03-31,2014-05-07,190840,0,190840
18684,BBRK3,2014-06-30,2014-08-14,190840,0,190840
18685,BBRK3,2014-09-30,2014-11-19,192840,0,192840
18686,BBRK3,2014-12-31,2015-03-20,192840,0,192840
18687,BBRK3,2015-03-31,2015-07-14,192840,0,192840
18688,BBRK3,2015-06-30,2015-08-11,192840,0,192840
18689,BBRK3,2015-09-30,2015-11-13,192840,0,192840
18690,BBRK3,2015-12-31,2016-03-29,192840,0,192840
18691,BBRK3,2016-03-31,2016-05-12,192840,0,192840
18692,BBRK3,2016-06-30,2016-08-11,192840,0,192840
18693,BBRK3,2016-09-30,2016-11-14,192840,0,192840
18694,BBRK3,2016-12-31,2017-03-27,192840,0,192840
18695,BBRK3,2017-03-31,2017-05-11,192840,0,192840
18696,BBRK3,2017-06-30,2017-08-11,192840,0,192840
18697,BBRK3,2017-09-30,2017-11-13,255903,0,255903
18698,BBRK3,2017-12-31,2018-03-28,255903,0,255903
18699,BBRK3,2018-03-31,2018-05-08,255903,0,255903
18700,BBRK3,2018-06-30,2018-08-13,255903,0,255903
18701,BBRK3,2018-09-30,2018-11-13,36278,0,36278
18702,BBRK3,2018-12-31,2019-03-26,36278,0,36278
18703,BBRK3,2019-03-31,2019-05-14,36278,0,36278
18704,BBRK3,2019-06-30,2019-08-13,36278,0,36278
18705,BBRK3,2019-09-30,2019-11-06,36278,0,36278
18706,BBRK3,2019-12-31,2020-03-30,36278,0,36278
18707,BBRK3,2020-03-31,2020-06-29,36278,0,36278
18708,BBRK3,2020-06-30,2020-07-31,36278,0,36278
18709,BBRK3,2020-09-30,2020-11-13,36278,0,36278
18710,BBRK3,2020-12-31,2021-03-01,36278,0,36278
18711,BPAN4,2010-12-31,2011-05-14,131881028,112462912,244343940
18712,BPAN4,2011-03-31,2011-05-16,131881028,112462912,244343940
18713,BPAN4,2011-06-30,2011-08-10,131881028,112462912,244343940
18714,BPAN4,2011-09-30,2011-11-10,131881028,112462912,244343940
18715,BPAN4,2011-12-31,2012-03-30,131881028,112462912,244343940
18716,BPAN4,2012-03-31,2012-05-09,131881028,112462912,244343940
18717,BPAN4,2012-06-30,2012-08-08,292463400,242612675,535076075
18718,BPAN4,2012-09-30,2012-11-05,292463400,242612675,535076075
18719,BPAN4,2012-12-31,2013-03-28,292463400,242612675,535076075
18720,BPAN4,2013-03-31,2013-05-06,292463400,242612675,535076075
18721,BPAN4,2013-06-30,2013-08-05,292463400,242612675,535076075
18722,BPAN4,2013-09-30,2013-11-04,292463400,242612675,535076075
18723,BPAN4,2013-12-31,2014-03-31,292463400,242612675,535076075
18724,BPAN4,2014-03-31,2014-05-05,292463400,242612675,535076075
18725,BPAN4,2014-06-30,2014-08-04,292463400,242612675,535076075
18726,BPAN4,2014-09-30,2014-11-03,535029747,394010416,929040163
18727,BPAN4,2014-12-31,2015-05-29,535029747,394010416,929040163
18728,BPAN4,2015-03-31,2015-05-04,535029747,394010416,929040163
18729,BPAN4,2015-06-30,2015-08-03,535029747,394010416,929040163
18730,BPAN4,2015-09-30,2015-12-01,535029747,394010416,929040163
18731,BPAN4,2015-12-31,2016-03-29,535029747,394010416,929040163
18732,BPAN4,2016-03-31,2016-05-02,535029747,394010416,929040163
18733,BPAN4,2016-06-30,2016-08-01,535029747,394010416,929040163
18734,BPAN4,2016-09-30,2016-11-07,535029747,394010416,929040163
18735,BPAN4,2016-12-31,2017-03-31,535029747,394010416,929040163
18736,BPAN4,2017-03-31,2017-05-08,535029747,394010416,929040163
18737,BPAN4,2017-06-30,2017-07-31,535029747,394010416,929040163
18738,BPAN4,2017-09-30,2017-11-06,535029747,394010416,929040163
18739,BPAN4,2017-12-31,2018-03-29,535029747,394010416,929040163
18740,BPAN4,2018-03-31,2018-05-02,535029747,394010416,929040163
18741,BPAN4,2018-06-30,2018-08-06,657560635,484245486,1141806121
18742,BPAN4,2018-09-30,2018-11-05,657560635,484245486,1141806121
18743,BPAN4,2018-12-31,2019-03-29,657560635,484245486,1141806121
18744,BPAN4,2019-03-31,2019-05-08,657560635,484245486,1141806121
18745,BPAN4,2019-06-30,2019-08-08,657560635,484245486,1141806121
18746,BPAN4,2019-09-30,2019-11-04,657560635,547495486,1205056121
18747,BPAN4,2019-12-31,2020-03-27,657560635,547495486,1205056121
18748,BPAN4,2020-03-31,2020-05-06,657560635,547495486,1205056121
18749,BPAN4,2020-06-30,2020-09-08,657560635,547495486,1205056121
18750,BPAN4,2020-09-30,2020-11-04,657560635,547495486,1205056121
18751,BPAN4,2020-12-31,2021-02-09,657560635,547495486,1205056121
18752,ENEV3,2010-12-31,2011-03-25,136693,0,136693
18753,ENEV3,2011-03-31,2011-05-12,136693,0,136693
18754,ENEV3,2011-06-30,2011-08-12,136721,0,136721
18755,ENEV3,2011-09-30,2011-11-10,136721,0,136721
18756,ENEV3,2011-12-31,2013-05-23,136721,0,136721
18757,ENEV3,2012-03-31,2012-05-14,136736,0,136736
18758,ENEV3,2012-06-30,2012-08-14,170123,0,170123
18759,ENEV3,2012-09-30,2012-11-09,578241,0,578241
18760,ENEV3,2012-12-31,2013-05-24,578242,0,578242
18761,ENEV3,2013-03-31,2013-05-08,578416,0,578416
18762,ENEV3,2013-06-30,2013-08-13,578480,0,578480
18763,ENEV3,2013-09-30,2013-11-13,702511,0,702511
18764,ENEV3,2013-12-31,2014-03-28,702524,0,702524
18765,ENEV3,2014-03-31,2014-05-13,702524,0,702524
18766,ENEV3,2014-06-30,2014-08-13,702524,0,702524
18767,ENEV3,2014-09-30,2014-11-14,840106,0,840106
18768,ENEV3,2014-12-31,2015-03-26,840106,0,840106
18769,ENEV3,2015-03-31,2015-05-14,840106,0,840106
18770,ENEV3,2015-06-30,2015-08-13,840106,0,840106
18771,ENEV3,2015-09-30,2015-11-12,840106,0,840106
18772,ENEV3,2015-12-31,2016-03-24,16176982,0,16176982
18773,ENEV3,2016-03-31,2016-05-12,16176982,0,16176982
18774,ENEV3,2016-06-30,2016-08-12,161770,0,161770
18775,ENEV3,2016-09-30,2016-11-11,161770,0,161770
18776,ENEV3,2016-12-31,2017-09-16,239128,0,239128
18777,ENEV3,2017-03-31,2017-09-16,239128,0,239128
18778,ENEV3,2017-06-30,2017-09-16,239128,0,239128
18779,ENEV3,2017-09-30,2017-11-09,239128,0,239128
18780,ENEV3,2017-12-31,2018-03-14,314990,0,314990
18781,ENEV3,2018-03-31,2018-05-10,314990,0,314990
18782,ENEV3,2018-06-30,2018-08-08,314990,0,314990
18783,ENEV3,2018-09-30,2018-11-08,314990,0,314990
18784,ENEV3,2018-12-31,2019-03-20,314990,0,314990
18785,ENEV3,2019-03-31,2019-05-08,314990,0,314990
18786,ENEV3,2019-06-30,2019-08-14,315276,0,315276
18787,ENEV3,2019-09-30,2019-11-05,315323,0,315323
18788,ENEV3,2019-12-31,2020-04-10,315483,0,315483
18789,ENEV3,2020-03-31,2020-05-15,315483,0,315483
18790,ENEV3,2020-06-30,2020-08-11,315768,0,315768
18791,ENEV3,2020-09-30,2020-11-12,315768,0,315768
18792,ENEV3,2020-12-31,2021-03-10,315836,0,315836
18793,ALSC3,2010-12-31,2011-03-29,139467,0,139467
18794,ALSC3,2011-03-31,2011-05-13,139467,0,139467
18795,ALSC3,2011-06-30,2011-08-08,139467,0,139467
18796,ALSC3,2011-09-30,2011-11-07,139467,0,139467
18797,ALSC3,2011-12-31,2012-12-05,139467,0,139467
18798,ALSC3,2012-03-31,2012-12-05,139467170,0,139467170
18799,ALSC3,2012-06-30,2012-12-05,139467170,0,139467170
18800,ALSC3,2012-09-30,2012-12-05,139667169,0,139667169
18801,ALSC3,2012-12-31,2013-03-26,156408813,0,156408813
18802,ALSC3,2013-03-31,2013-05-13,158920059,0,158920059
18803,ALSC3,2013-06-30,2013-08-13,158975920,0,158975920
18804,ALSC3,2013-09-30,2013-11-13,158975920,0,158975920
18805,ALSC3,2013-12-31,2014-04-03,159025920,0,159025920
18806,ALSC3,2014-03-31,2014-05-12,159025920,0,159025920
18807,ALSC3,2014-06-30,2014-08-13,159025920,0,159025920
18808,ALSC3,2014-09-30,2014-11-11,159060920,0,159060920
18809,ALSC3,2014-12-31,2015-03-26,159060920,0,159060920
18810,ALSC3,2015-03-31,2015-05-06,159060920,0,159060920
18811,ALSC3,2015-06-30,2015-08-13,162735921,0,162735921
18812,ALSC3,2015-09-30,2015-11-05,162735921,0,162735921
18813,ALSC3,2015-12-31,2016-03-28,162735921,0,162735921
18814,ALSC3,2016-03-31,2016-05-09,162735921,0,162735921
18815,ALSC3,2016-06-30,2016-08-08,162735921,0,162735921
18816,ALSC3,2016-09-30,2016-11-07,184725157,0,184725157
18817,ALSC3,2016-12-31,2017-03-27,202735921,0,202735921
18818,ALSC3,2017-03-31,2017-05-10,202735921,0,202735921
18819,ALSC3,2017-06-30,2017-08-09,202735921,0,202735921
18820,ALSC3,2017-09-30,2017-11-08,202735921,0,202735921
18821,ALSC3,2017-12-31,2018-03-12,202735921,0,202735921
18822,ALSC3,2018-03-31,2018-05-04,202735921,0,202735921
18823,ALSC3,2018-06-30,2018-08-08,202735921,0,202735921
18824,ALSC3,2018-09-30,2018-11-08,202735921,0,202735921
18825,ALSC3,2018-12-31,2019-02-26,202735921,0,202735921
18826,ALSC3,2019-03-31,2019-05-08,202735921,0,202735921
18827,ALSC3,2019-06-30,2019-07-29,202735921,0,202735921
18828,NUTR3,2010-12-31,2011-05-04,5212268,0,5212268
18829,NUTR3,2011-03-31,2011-09-21,5212268,0,5212268
18830,NUTR3,2011-06-30,2011-09-21,5212268,0,5212268
18831,NUTR3,2011-09-30,2011-10-28,5212268,0,5212268
18832,NUTR3,2011-12-31,2012-03-29,5212268,0,5212268
18833,NUTR3,2012-03-31,2012-04-27,5212268,0,5212268
18834,NUTR3,2012-06-30,2012-08-14,12409678,0,12409678
18835,NUTR3,2012-09-30,2012-11-14,12403678,0,12403678
18836,NUTR3,2012-12-31,2013-03-05,12414678,0,12414678
18837,NUTR3,2013-03-31,2013-05-15,12414678,0,12414678
18838,NUTR3,2013-06-30,2013-08-14,12414678,0,12414678
18839,NUTR3,2013-09-30,2013-11-14,12414678,0,12414678
18840,NUTR3,2013-12-31,2014-05-12,12414678,0,12414678
18841,NUTR3,2014-03-31,2014-05-12,12414678,0,12414678
18842,NUTR3,2014-06-30,2014-08-11,12414678,0,12414678
18843,NUTR3,2014-09-30,2014-11-14,12414678,0,12414678
18844,NUTR3,2014-12-31,2015-03-20,12794413,0,12794413
18845,NUTR3,2015-03-31,2015-05-11,12794413,0,12794413
18846,NUTR3,2015-06-30,2015-08-10,12794413,0,12794413
18847,NUTR3,2015-09-30,2015-11-13,127944,0,127944
18848,NUTR3,2015-12-31,2016-03-29,127944,0,127944
18849,NUTR3,2016-03-31,2016-05-13,127944,0,127944
18850,NUTR3,2016-06-30,2016-08-12,127944,0,127944
18851,NUTR3,2016-09-30,2016-11-11,127944,0,127944
18852,NUTR3,2016-12-31,2017-03-28,127944,0,127944
18853,NUTR3,2017-03-31,2017-05-12,127944,0,127944
18854,NUTR3,2017-06-30,2017-08-11,127944,0,127944
18855,NUTR3,2017-09-30,2017-11-10,127944,0,127944
18856,NUTR3,2017-12-31,2018-03-30,127944,0,127944
18857,NUTR3,2018-03-31,2018-05-14,127944,0,127944
18858,NUTR3,2018-06-30,2018-08-13,127944,0,127944
18859,NUTR3,2018-09-30,2018-11-23,127944,0,127944
18860,NUTR3,2018-12-31,2019-04-03,127944,0,127944
18861,NUTR3,2019-03-31,2019-05-14,127944,0,127944
18862,NUTR3,2019-06-30,2019-08-13,127944,0,127944
18863,NUTR3,2019-09-30,2019-11-13,127944,0,127944
18864,NUTR3,2019-12-31,2020-04-07,127944,0,127944
18865,NUTR3,2020-03-31,2020-06-01,127944,0,127944
18866,NUTR3,2020-06-30,2020-08-27,127944,0,127944
18867,NUTR3,2020-09-30,2020-11-13,127944,0,127944
18868,OSXB3,2010-12-31,2011-03-15,11212500,0,11212500
18869,OSXB3,2011-03-31,2011-05-10,11212500,0,11212500
18870,OSXB3,2011-06-30,2011-07-28,11212500,0,11212500
18871,OSXB3,2011-09-30,2011-10-27,11223009,0,11223009
18872,OSXB3,2011-12-31,2012-03-30,280575225,0,280575225
18873,OSXB3,2012-03-31,2012-05-03,280792758,0,280792758
18874,OSXB3,2012-06-30,2012-07-26,280792778,0,280792778
18875,OSXB3,2012-09-30,2012-10-29,280792778,0,280792778
18876,OSXB3,2012-12-31,2013-04-05,293712408,0,293712408
18877,OSXB3,2013-03-31,2013-05-15,306508560,0,306508560
18878,OSXB3,2013-06-30,2013-08-14,312563568,0,312563568
18879,OSXB3,2013-09-30,2013-12-19,312563568,0,312563568
18880,OSXB3,2013-12-31,2014-04-17,312564,0,312564
18881,OSXB3,2014-03-31,2014-07-07,312564,0,312564
18882,OSXB3,2014-06-30,2014-08-14,312564,0,312564
18883,OSXB3,2014-09-30,2014-11-27,312564,0,312564
18884,OSXB3,2014-12-31,2015-04-15,312564,0,312564
18885,OSXB3,2015-03-31,2015-06-15,312564,0,312564
18886,OSXB3,2015-06-30,2015-08-14,312564,0,312564
18887,OSXB3,2015-09-30,2015-11-13,312564,0,312564
18888,OSXB3,2015-12-31,2016-04-12,312564,0,312564
18889,OSXB3,2016-03-31,2017-06-13,312564,0,312564
18890,OSXB3,2016-06-30,2017-06-13,3148038,0,3148038
18891,OSXB3,2016-09-30,2017-06-13,3148038,0,3148038
18892,OSXB3,2016-12-31,2017-06-26,3148038,0,3148038
18893,OSXB3,2017-03-31,2017-07-31,3148038,0,3148038
18894,OSXB3,2017-06-30,2017-08-31,3148038,0,3148038
18895,OSXB3,2017-09-30,2017-12-14,3148038,0,3148038
18896,OSXB3,2017-12-31,2018-03-29,3148038,0,3148038
18897,OSXB3,2018-03-31,2018-05-15,3148038,0,3148038
18898,OSXB3,2018-06-30,2018-08-14,3148038,0,3148038
18899,OSXB3,2018-09-30,2018-11-14,3148038,0,3148038
18900,OSXB3,2018-12-31,2019-03-26,3148038,0,3148038
18901,OSXB3,2019-03-31,2019-05-10,3148038,0,3148038
18902,OSXB3,2019-06-30,2019-08-14,3148038,0,3148038
18903,OSXB3,2019-09-30,2019-11-08,3148038,0,3148038
18904,OSXB3,2019-12-31,2020-03-31,3148038,0,3148038
18905,OSXB3,2020-03-31,2020-05-16,3148038,0,3148038
18906,OSXB3,2020-06-30,2020-08-14,3148038,0,3148038
18907,OSXB3,2020-09-30,2020-11-13,3148038,0,3148038
18908,DIRR3,2010-12-31,2011-04-05,133407162,0,133407162
18909,DIRR3,2011-03-31,2011-05-13,154207162,0,154207162
18910,DIRR3,2011-06-30,2011-08-09,154610703,0,154610703
18911,DIRR3,2011-09-30,2011-11-10,153270932,0,153270932
18912,DIRR3,2011-12-31,2012-03-13,153244532,0,153244532
18913,DIRR3,2012-03-31,2012-05-16,153638549,0,153638549
18914,DIRR3,2012-06-30,2012-08-06,153703054,0,153703054
18915,DIRR3,2012-09-30,2012-11-06,153972578,0,153972578
18916,DIRR3,2012-12-31,2013-03-25,153972578,0,153972578
18917,DIRR3,2013-03-31,2013-07-01,154615224,0,154615224
18918,DIRR3,2013-06-30,2013-08-05,155298749,0,155298749
18919,DIRR3,2013-09-30,2013-11-11,155298749,0,155298749
18920,DIRR3,2013-12-31,2014-03-17,155298749,0,155298749
18921,DIRR3,2014-03-31,2014-05-13,155298749,0,155298749
18922,DIRR3,2014-06-30,2014-08-14,153176459,0,153176459
18923,DIRR3,2014-09-30,2014-11-13,153225983,0,153225983
18924,DIRR3,2014-12-31,2015-03-16,153265983,0,153265983
18925,DIRR3,2015-03-31,2015-05-15,151053983,0,151053983
18926,DIRR3,2015-06-30,2015-08-10,153398749,0,153398749
18927,DIRR3,2015-09-30,2015-11-11,153398749,0,153398749
18928,DIRR3,2015-12-31,2016-03-14,153398749,0,153398749
18929,DIRR3,2016-03-31,2016-05-09,153398749,0,153398749
18930,DIRR3,2016-06-30,2016-08-08,153398749,0,153398749
18931,DIRR3,2016-09-30,2016-11-16,146304437,0,146304437
18932,DIRR3,2016-12-31,2017-03-20,146315104,0,146315104
18933,DIRR3,2017-03-31,2017-05-11,146403554,0,146403554
18934,DIRR3,2017-06-30,2017-08-10,146403554,0,146403554
18935,DIRR3,2017-09-30,2017-11-14,146437554,0,146437554
18936,DIRR3,2017-12-31,2018-03-26,153398749,0,153398749
18937,DIRR3,2018-03-31,2018-05-14,153398749,0,153398749
18938,DIRR3,2018-06-30,2018-08-13,153398749,0,153398749
18939,DIRR3,2018-09-30,2018-11-08,153398749,0,153398749
18940,DIRR3,2018-12-31,2019-03-11,153398749,0,153398749
18941,DIRR3,2019-03-31,2019-05-10,153398749,0,153398749
18942,DIRR3,2019-06-30,2019-08-12,153398749,0,153398749
18943,DIRR3,2019-09-30,2019-10-31,153398749,0,153398749
18944,DIRR3,2019-12-31,2020-03-09,147925010,0,147925010
18945,DIRR3,2020-03-31,2020-05-14,153398749,0,153398749
18946,DIRR3,2020-06-30,2020-08-14,153398749,0,153398749
18947,DIRR3,2020-09-30,2020-11-09,153398749,0,153398749
18948,DIRR3,2020-12-31,2021-03-15,153398749,0,153398749
18949,GPAR3,2010-12-31,2011-06-13,32774,0,32774
18950,GPAR3,2011-03-31,2011-09-01,32774,0,32774
18951,GPAR3,2011-06-30,2011-10-04,32774,0,32774
18952,GPAR3,2011-09-30,2012-03-15,32774,0,32774
18953,GPAR3,2011-12-31,2012-06-14,32774,0,32774
18954,GPAR3,2012-03-31,2012-10-05,32774,0,32774
18955,GPAR3,2012-06-30,2013-01-29,32774,0,32774
18956,GPAR3,2012-09-30,2013-05-08,32774,0,32774
18957,GPAR3,2012-12-31,2013-06-18,32774,0,32774
18958,GPAR3,2013-03-31,2013-09-30,32774,0,32774
18959,GPAR3,2013-06-30,2013-09-30,32774,0,32774
18960,GPAR3,2013-09-30,2013-11-14,32774,0,32774
18961,GPAR3,2013-12-31,2014-03-28,32774,0,32774
18962,GPAR3,2014-03-31,2014-05-15,32774,0,32774
18963,GPAR3,2014-06-30,2014-08-14,32774,0,32774
18964,GPAR3,2014-09-30,2014-11-13,32774,0,32774
18965,GPAR3,2014-12-31,2015-04-29,32774,0,32774
18966,GPAR3,2015-03-31,2015-05-15,32774,0,32774
18967,GPAR3,2015-06-30,2015-08-14,32774,0,32774
18968,GPAR3,2015-09-30,2015-11-13,32774,0,32774
18969,GPAR3,2015-12-31,2016-03-28,32774,0,32774
18970,GPAR3,2016-03-31,2016-07-12,32774,0,32774
18971,GPAR3,2016-06-30,2016-08-12,32774,0,32774
18972,GPAR3,2016-09-30,2016-11-14,32774,0,32774
18973,GPAR3,2016-12-31,2017-03-28,32774,0,32774
18974,GPAR3,2017-03-31,2017-07-03,32774,0,32774
18975,GPAR3,2017-06-30,2017-08-14,32774,0,32774
18976,GPAR3,2017-09-30,2017-11-14,32774,0,32774
18977,GPAR3,2017-12-31,2018-04-17,32774,0,32774
18978,GPAR3,2018-03-31,2018-06-20,32774,0,32774
18979,GPAR3,2018-06-30,2018-08-14,32774,0,32774
18980,GPAR3,2018-09-30,2018-11-14,32774,0,32774
18981,GPAR3,2018-12-31,2019-04-24,32774,0,32774
18982,GPAR3,2019-03-31,2019-05-21,32774,0,32774
18983,GPAR3,2019-06-30,2019-08-14,32774,0,32774
18984,GPAR3,2019-09-30,2019-11-14,32774,0,32774
18985,GPAR3,2019-12-31,2020-04-17,32774,0,32774
18986,GPAR3,2020-03-31,2020-05-28,32774,0,32774
18987,GPAR3,2020-06-30,2020-08-14,77928,0,77928
18988,GPAR3,2020-09-30,2020-11-13,77928,0,77928
18989,HYPE3,2010-12-31,2011-03-22,547846,0,547846
18990,HYPE3,2011-03-31,2011-05-09,625860,0,625860
18991,HYPE3,2011-06-30,2011-08-15,626785,0,626785
18992,HYPE3,2011-09-30,2011-11-07,626785,0,626785
18993,HYPE3,2011-12-31,2012-03-10,626784912,0,626784912
18994,HYPE3,2012-03-31,2012-06-11,627396559,0,627396559
18995,HYPE3,2012-06-30,2012-08-13,627396559,0,627396559
18996,HYPE3,2012-09-30,2012-11-09,627396559,0,627396559
18997,HYPE3,2012-12-31,2013-03-06,627396559,0,627396559
18998,HYPE3,2013-03-31,2013-05-03,627396559,0,627396559
18999,HYPE3,2013-06-30,2013-08-02,632100787,0,632100787
19000,HYPE3,2013-09-30,2013-11-01,632100787,0,632100787
19001,HYPE3,2013-12-31,2014-03-19,632100787,0,632100787
19002,HYPE3,2014-03-31,2014-04-25,632100787,0,632100787
19003,HYPE3,2014-06-30,2014-07-25,632100787,0,632100787
19004,HYPE3,2014-09-30,2014-10-24,632100787,0,632100787
19005,HYPE3,2014-12-31,2015-02-06,632100787,0,632100787
19006,HYPE3,2015-03-31,2015-04-24,632100787,0,632100787
19007,HYPE3,2015-06-30,2015-07-24,632117926,0,632117926
19008,HYPE3,2015-09-30,2015-10-30,632238060,0,632238060
19009,HYPE3,2015-12-31,2016-02-26,632238060,0,632238060
19010,HYPE3,2016-03-31,2016-04-27,632238060,0,632238060
19011,HYPE3,2016-06-30,2016-07-22,632238060,0,632238060
19012,HYPE3,2016-09-30,2016-10-28,632238060,0,632238060
19013,HYPE3,2016-12-31,2017-02-17,632238060,0,632238060
19014,HYPE3,2017-03-31,2017-04-28,632238060,0,632238060
19015,HYPE3,2017-06-30,2017-07-28,632238060,0,632238060
19016,HYPE3,2017-09-30,2017-10-27,632238060,0,632238060
19017,HYPE3,2017-12-31,2018-02-23,632238060,0,632238060
19018,HYPE3,2018-03-31,2018-04-26,632238060,0,632238060
19019,HYPE3,2018-06-30,2018-07-27,632238060,0,632238060
19020,HYPE3,2018-09-30,2018-10-26,632238060,0,632238060
19021,HYPE3,2018-12-31,2019-02-21,632238060,0,632238060
19022,HYPE3,2019-03-31,2019-04-26,632238060,0,632238060
19023,HYPE3,2019-06-30,2019-07-26,632238060,0,632238060
19024,HYPE3,2019-09-30,2019-10-25,632238060,0,632238060
19025,HYPE3,2019-12-31,2020-03-06,632238060,0,632238060
19026,HYPE3,2020-03-31,2020-04-24,632238060,0,632238060
19027,HYPE3,2020-06-30,2020-07-24,632238060,0,632238060
19028,HYPE3,2020-09-30,2020-10-23,633320423,0,633320423
19029,HYPE3,2020-12-31,2021-02-26,633420823,0,633420823
19030,LLIS3,2010-12-31,2011-03-11,57250,0,57250
19031,LLIS3,2011-03-31,2011-05-13,57250,0,57250
19032,LLIS3,2011-06-30,2011-08-15,57250,0,57250
19033,LLIS3,2011-09-30,2011-11-14,57250,0,57250
19034,LLIS3,2011-12-31,2012-03-16,57250,0,57250
19035,LLIS3,2012-03-31,2012-05-15,57250,0,57250
19036,LLIS3,2012-06-30,2012-08-14,171750,0,171750
19037,LLIS3,2012-09-30,2012-11-14,171750,0,171750
19038,LLIS3,2012-12-31,2014-12-01,172171,0,172171
19039,LLIS3,2013-03-31,2013-05-14,172171,0,172171
19040,LLIS3,2013-06-30,2013-08-14,172171,0,172171
19041,LLIS3,2013-09-30,2013-11-14,172171,0,172171
19042,LLIS3,2013-12-31,2014-02-24,172171,0,172171
19043,LLIS3,2014-03-31,2014-05-05,172171,0,172171
19044,LLIS3,2014-06-30,2014-08-04,174931,0,174931
19045,LLIS3,2014-09-30,2014-11-05,174931,0,174931
19046,LLIS3,2014-12-31,2015-03-13,349863,0,349863
19047,LLIS3,2015-03-31,2015-05-07,349863,0,349863
19048,LLIS3,2015-06-30,2015-08-13,349863,0,349863
19049,LLIS3,2015-09-30,2015-11-12,349863,0,349863
19050,LLIS3,2015-12-31,2016-03-21,349863,0,349863
19051,LLIS3,2016-03-31,2016-05-10,349863,0,349863
19052,LLIS3,2016-06-30,2016-08-10,349863,0,349863
19053,LLIS3,2016-09-30,2016-11-03,349863,0,349863
19054,LLIS3,2016-12-31,2017-02-23,349863,0,349863
19055,LLIS3,2017-03-31,2017-04-26,326640,0,326640
19056,LLIS3,2017-06-30,2017-08-07,46663,0,46663
19057,LLIS3,2017-09-30,2017-10-24,46663,0,46663
19058,LLIS3,2017-12-31,2018-03-29,51601,0,51601
19059,LLIS3,2018-03-31,2018-05-07,51601,0,51601
19060,LLIS3,2018-06-30,2018-08-02,51601,0,51601
19061,LLIS3,2018-09-30,2018-11-08,51601,0,51601
19062,LLIS3,2018-12-31,2019-03-29,51601,0,51601
19063,LLIS3,2019-03-31,2019-05-16,51601,0,51601
19064,LLIS3,2019-06-30,2019-08-14,51601,0,51601
19065,LLIS3,2019-09-30,2019-11-14,51601,0,51601
19066,LLIS3,2019-12-31,2020-06-01,68851,0,68851
19067,LLIS3,2020-03-31,2020-06-29,68851,0,68851
19068,LLIS3,2020-06-30,2020-08-14,68851,0,68851
19069,LLIS3,2020-09-30,2020-11-13,68851,0,68851
19070,ALUP11,2010-12-31,2011-04-25,163910,0,163910
19071,ALUP11,2011-03-31,2011-05-17,163910,0,163910
19072,ALUP11,2011-06-30,2011-08-11,163910000,0,163910000
19073,ALUP11,2011-09-30,2011-11-11,163910000,0,163910000
19074,ALUP11,2011-12-31,2013-02-25,163910000,0,163910000
19075,ALUP11,2012-03-31,2013-05-16,193910000,0,193910000
19076,ALUP11,2012-06-30,2013-08-13,163910000,0,163910000
19077,ALUP11,2012-09-30,2013-02-25,163910000,0,163910000
19078,ALUP11,2012-12-31,2013-02-23,138951000,24959000,163910000
19079,ALUP11,2013-03-31,2013-05-14,416853000,74877000,491730000
19080,ALUP11,2013-06-30,2013-08-14,461243600,163658200,624901800
19081,ALUP11,2013-09-30,2013-11-12,461243600,163658200,624901800
19082,ALUP11,2013-12-31,2014-03-27,461243600,163658200,624901800
19083,ALUP11,2014-03-31,2014-05-09,461243596,163658204,624901800
19084,ALUP11,2014-06-30,2014-08-07,461243596,163658204,624901800
19085,ALUP11,2014-09-30,2014-11-11,461243596,163658204,624901800
19086,ALUP11,2014-12-31,2015-03-05,461243596,163658204,624901800
19087,ALUP11,2015-03-31,2015-05-15,461243596,163658204,624901800
19088,ALUP11,2015-06-30,2015-08-12,461243596,163658204,624901800
19089,ALUP11,2015-09-30,2015-11-13,461243596,163658204,624901800
19090,ALUP11,2015-12-31,2016-03-10,461243596,163658204,624901800
19091,ALUP11,2016-03-31,2016-05-12,461243596,163658204,624901800
19092,ALUP11,2016-06-30,2016-08-11,491224430,174295987,665520417
19093,ALUP11,2016-09-30,2016-11-11,554233455,196652815,750886270
19094,ALUP11,2016-12-31,2017-03-20,554233455,196652815,750886270
19095,ALUP11,2017-03-31,2017-05-15,554233455,196652815,750886270
19096,ALUP11,2017-06-30,2017-08-14,596955970,282155299,879111269
19097,ALUP11,2017-09-30,2017-11-09,596955970,282155299,879111269
19098,ALUP11,2017-12-31,2018-03-08,596955970,282155299,879111269
19099,ALUP11,2018-03-31,2019-05-14,596955970,282155299,879111269
19100,ALUP11,2018-06-30,2019-05-27,596955970,282155299,879111269
19101,ALUP11,2018-09-30,2019-07-12,596955970,282155299,879111269
19102,ALUP11,2018-12-31,2019-05-15,596955970,282155299,879111269
19103,ALUP11,2019-03-31,2019-05-22,596955970,282155299,879111269
19104,ALUP11,2019-06-30,2019-08-13,596955970,282155299,879111269
19105,ALUP11,2019-09-30,2019-11-13,596955970,282155299,879111269
19106,ALUP11,2019-12-31,2020-03-11,596955970,282155299,879111269
19107,ALUP11,2020-03-31,2020-06-01,596955970,282155299,879111269
19108,ALUP11,2020-06-30,2020-08-12,596955970,282155299,879111269
19109,ALUP11,2020-09-30,2020-11-11,596955970,282155299,879111269
19110,ALUP11,2020-12-31,2021-03-23,596955970,282155299,879111269
19111,ALUP3,2010-12-31,2011-04-25,163910,0,163910
19112,ALUP3,2011-03-31,2011-05-17,163910,0,163910
19113,ALUP3,2011-06-30,2011-08-11,163910000,0,163910000
19114,ALUP3,2011-09-30,2011-11-11,163910000,0,163910000
19115,ALUP3,2011-12-31,2013-02-25,163910000,0,163910000
19116,ALUP3,2012-03-31,2013-05-16,193910000,0,193910000
19117,ALUP3,2012-06-30,2013-08-13,163910000,0,163910000
19118,ALUP3,2012-09-30,2013-02-25,163910000,0,163910000
19119,ALUP3,2012-12-31,2013-02-23,138951000,24959000,163910000
19120,ALUP3,2013-03-31,2013-05-14,416853000,74877000,491730000
19121,ALUP3,2013-06-30,2013-08-14,461243600,163658200,624901800
19122,ALUP3,2013-09-30,2013-11-12,461243600,163658200,624901800
19123,ALUP3,2013-12-31,2014-03-27,461243600,163658200,624901800
19124,ALUP3,2014-03-31,2014-05-09,461243596,163658204,624901800
19125,ALUP3,2014-06-30,2014-08-07,461243596,163658204,624901800
19126,ALUP3,2014-09-30,2014-11-11,461243596,163658204,624901800
19127,ALUP3,2014-12-31,2015-03-05,461243596,163658204,624901800
19128,ALUP3,2015-03-31,2015-05-15,461243596,163658204,624901800
19129,ALUP3,2015-06-30,2015-08-12,461243596,163658204,624901800
19130,ALUP3,2015-09-30,2015-11-13,461243596,163658204,624901800
19131,ALUP3,2015-12-31,2016-03-10,461243596,163658204,624901800
19132,ALUP3,2016-03-31,2016-05-12,461243596,163658204,624901800
19133,ALUP3,2016-06-30,2016-08-11,491224430,174295987,665520417
19134,ALUP3,2016-09-30,2016-11-11,554233455,196652815,750886270
19135,ALUP3,2016-12-31,2017-03-20,554233455,196652815,750886270
19136,ALUP3,2017-03-31,2017-05-15,554233455,196652815,750886270
19137,ALUP3,2017-06-30,2017-08-14,596955970,282155299,879111269
19138,ALUP3,2017-09-30,2017-11-09,596955970,282155299,879111269
19139,ALUP3,2017-12-31,2018-03-08,596955970,282155299,879111269
19140,ALUP3,2018-03-31,2019-05-14,596955970,282155299,879111269
19141,ALUP3,2018-06-30,2019-05-27,596955970,282155299,879111269
19142,ALUP3,2018-09-30,2019-07-12,596955970,282155299,879111269
19143,ALUP3,2018-12-31,2019-05-15,596955970,282155299,879111269
19144,ALUP3,2019-03-31,2019-05-22,596955970,282155299,879111269
19145,ALUP3,2019-06-30,2019-08-13,596955970,282155299,879111269
19146,ALUP3,2019-09-30,2019-11-13,596955970,282155299,879111269
19147,ALUP3,2019-12-31,2020-03-11,596955970,282155299,879111269
19148,ALUP3,2020-03-31,2020-06-01,596955970,282155299,879111269
19149,ALUP3,2020-06-30,2020-08-12,596955970,282155299,879111269
19150,ALUP3,2020-09-30,2020-11-11,596955970,282155299,879111269
19151,ALUP3,2020-12-31,2021-03-23,596955970,282155299,879111269
19152,ALUP4,2010-12-31,2011-04-25,163910,0,163910
19153,ALUP4,2011-03-31,2011-05-17,163910,0,163910
19154,ALUP4,2011-06-30,2011-08-11,163910000,0,163910000
19155,ALUP4,2011-09-30,2011-11-11,163910000,0,163910000
19156,ALUP4,2011-12-31,2013-02-25,163910000,0,163910000
19157,ALUP4,2012-03-31,2013-05-16,193910000,0,193910000
19158,ALUP4,2012-06-30,2013-08-13,163910000,0,163910000
19159,ALUP4,2012-09-30,2013-02-25,163910000,0,163910000
19160,ALUP4,2012-12-31,2013-02-23,138951000,24959000,163910000
19161,ALUP4,2013-03-31,2013-05-14,416853000,74877000,491730000
19162,ALUP4,2013-06-30,2013-08-14,461243600,163658200,624901800
19163,ALUP4,2013-09-30,2013-11-12,461243600,163658200,624901800
19164,ALUP4,2013-12-31,2014-03-27,461243600,163658200,624901800
19165,ALUP4,2014-03-31,2014-05-09,461243596,163658204,624901800
19166,ALUP4,2014-06-30,2014-08-07,461243596,163658204,624901800
19167,ALUP4,2014-09-30,2014-11-11,461243596,163658204,624901800
19168,ALUP4,2014-12-31,2015-03-05,461243596,163658204,624901800
19169,ALUP4,2015-03-31,2015-05-15,461243596,163658204,624901800
19170,ALUP4,2015-06-30,2015-08-12,461243596,163658204,624901800
19171,ALUP4,2015-09-30,2015-11-13,461243596,163658204,624901800
19172,ALUP4,2015-12-31,2016-03-10,461243596,163658204,624901800
19173,ALUP4,2016-03-31,2016-05-12,461243596,163658204,624901800
19174,ALUP4,2016-06-30,2016-08-11,491224430,174295987,665520417
19175,ALUP4,2016-09-30,2016-11-11,554233455,196652815,750886270
19176,ALUP4,2016-12-31,2017-03-20,554233455,196652815,750886270
19177,ALUP4,2017-03-31,2017-05-15,554233455,196652815,750886270
19178,ALUP4,2017-06-30,2017-08-14,596955970,282155299,879111269
19179,ALUP4,2017-09-30,2017-11-09,596955970,282155299,879111269
19180,ALUP4,2017-12-31,2018-03-08,596955970,282155299,879111269
19181,ALUP4,2018-03-31,2019-05-14,596955970,282155299,879111269
19182,ALUP4,2018-06-30,2019-05-27,596955970,282155299,879111269
19183,ALUP4,2018-09-30,2019-07-12,596955970,282155299,879111269
19184,ALUP4,2018-12-31,2019-05-15,596955970,282155299,879111269
19185,ALUP4,2019-03-31,2019-05-22,596955970,282155299,879111269
19186,ALUP4,2019-06-30,2019-08-13,596955970,282155299,879111269
19187,ALUP4,2019-09-30,2019-11-13,596955970,282155299,879111269
19188,ALUP4,2019-12-31,2020-03-11,596955970,282155299,879111269
19189,ALUP4,2020-03-31,2020-06-01,596955970,282155299,879111269
19190,ALUP4,2020-06-30,2020-08-12,596955970,282155299,879111269
19191,ALUP4,2020-09-30,2020-11-11,596955970,282155299,879111269
19192,ALUP4,2020-12-31,2021-03-23,596955970,282155299,879111269
19193,B3SA3,2010-12-31,2011-02-17,2044014295,0,2044014295
19194,B3SA3,2011-03-31,2011-05-12,2044014295,0,2044014295
19195,B3SA3,2011-06-30,2011-08-09,2044014295,0,2044014295
19196,B3SA3,2011-09-30,2011-11-08,2044014295,0,2044014295
19197,B3SA3,2011-12-31,2012-02-14,1980000000,0,1980000000
19198,B3SA3,2012-03-31,2012-05-10,1980000000,0,1980000000
19199,B3SA3,2012-06-30,2012-08-07,1980000000,0,1980000000
19200,B3SA3,2012-09-30,2012-11-06,1980000000,0,1980000000
19201,B3SA3,2012-12-31,2013-02-19,1980000000,0,1980000000
19202,B3SA3,2013-03-31,2013-05-09,1980000000,0,1980000000
19203,B3SA3,2013-06-30,2013-08-08,1980000000,0,1980000000
19204,B3SA3,2013-09-30,2013-11-07,1980000000,0,1980000000
19205,B3SA3,2013-12-31,2014-02-13,1980000000,0,1980000000
19206,B3SA3,2014-03-31,2014-05-08,1900000000,0,1900000000
19207,B3SA3,2014-06-30,2014-08-07,1900000000,0,1900000000
19208,B3SA3,2014-09-30,2014-11-13,1900000000,0,1900000000
19209,B3SA3,2014-12-31,2015-02-10,1900000000,0,1900000000
19210,B3SA3,2015-03-31,2015-05-14,1815000000,0,1815000000
19211,B3SA3,2015-06-30,2015-08-13,1815000000,0,1815000000
19212,B3SA3,2015-09-30,2015-11-12,1815000000,0,1815000000
19213,B3SA3,2015-12-31,2016-02-18,1815000000,0,1815000000
19214,B3SA3,2016-03-31,2016-05-12,1815000000,0,1815000000
19215,B3SA3,2016-06-30,2016-08-11,1815000000,0,1815000000
19216,B3SA3,2016-09-30,2016-11-11,1815000000,0,1815000000
19217,B3SA3,2016-12-31,2017-02-17,1815000000,0,1815000000
19218,B3SA3,2017-03-31,2017-05-12,2059138490,0,2059138490
19219,B3SA3,2017-06-30,2017-08-11,2059138490,0,2059138490
19220,B3SA3,2017-09-30,2017-11-10,2059138490,0,2059138490
19221,B3SA3,2017-12-31,2018-03-01,2059138490,0,2059138490
19222,B3SA3,2018-03-31,2018-05-10,2059138490,0,2059138490
19223,B3SA3,2018-06-30,2018-08-09,2059138490,0,2059138490
19224,B3SA3,2018-09-30,2018-11-08,2059138490,0,2059138490
19225,B3SA3,2018-12-31,2019-02-21,2059138490,0,2059138490
19226,B3SA3,2019-03-31,2019-05-09,2059138490,0,2059138490
19227,B3SA3,2019-06-30,2019-08-08,2059138490,0,2059138490
19228,B3SA3,2019-09-30,2019-11-07,2059138490,0,2059138490
19229,B3SA3,2019-12-31,2020-03-05,2059138490,0,2059138490
19230,B3SA3,2020-03-31,2020-05-14,2059138490,0,2059138490
19231,B3SA3,2020-06-30,2020-08-13,2059138490,0,2059138490
19232,B3SA3,2020-09-30,2020-11-12,2059138490,0,2059138490
19233,B3SA3,2020-12-31,2021-03-04,2059138490,0,2059138490
19234,RNEW11,2010-12-31,2011-03-28,93033067,47730533,140763600
19235,RNEW11,2011-03-31,2011-05-17,93393118,48450635,141843753
19236,RNEW11,2011-06-30,2011-08-05,93518118,48700635,142218753
19237,RNEW11,2011-09-30,2012-10-29,146813876,49075491,195889367
19238,RNEW11,2011-12-31,2013-05-03,145066949,50529299,195596248
19239,RNEW11,2012-03-31,2012-10-16,145087187,50643731,195730918
19240,RNEW11,2012-06-30,2012-08-09,145100899,50697513,195798412
19241,RNEW11,2012-09-30,2012-11-08,170086432,59429640,229516072
19242,RNEW11,2012-12-31,2013-03-18,156469395,73445134,229914529
19243,RNEW11,2013-03-31,2013-05-10,156508015,73523850,230031865
19244,RNEW11,2013-06-30,2013-08-13,156477463,73554402,230031865
19245,RNEW11,2013-09-30,2013-11-05,156896011,74394006,231290017
19246,RNEW11,2013-12-31,2014-03-06,156899210,74408816,231308026
19247,RNEW11,2014-03-31,2014-05-06,150899210,80408816,231308026
19248,RNEW11,2014-06-30,2020-04-28,150899210,80408816,231308026
19249,RNEW11,2014-09-30,2020-04-28,150899210,80408816,231308026
19250,RNEW11,2014-12-31,2015-03-04,236845392,81810030,318655422
19251,RNEW11,2015-03-31,2016-11-16,236844286,81811136,318655422
19252,RNEW11,2015-06-30,2020-04-28,236844286,81811136,318655422
19253,RNEW11,2015-09-30,2020-04-28,236883455,81889474,318772929
19254,RNEW11,2015-12-31,2016-03-28,236874031,81898898,318772929
19255,RNEW11,2016-03-31,2016-05-13,236874031,81898898,318772929
19256,RNEW11,2016-06-30,2016-08-08,278916250,81899063,360815313
19257,RNEW11,2016-09-30,2016-11-09,278916250,81899063,360815313
19258,RNEW11,2016-12-31,2017-03-22,278916250,81899063,360815313
19259,RNEW11,2017-03-31,2017-05-12,278916250,81899063,360815313
19260,RNEW11,2017-06-30,2017-08-10,329805243,87392001,417197244
19261,RNEW11,2017-09-30,2017-11-13,329805243,87392001,417197244
19262,RNEW11,2017-12-31,2018-03-29,329805243,87392001,417197244
19263,RNEW11,2018-03-31,2018-05-11,329805243,87392001,417197244
19264,RNEW11,2018-06-30,2018-08-13,329805243,87392001,417197244
19265,RNEW11,2018-09-30,2018-11-06,329805243,87392001,417197244
19266,RNEW11,2018-12-31,2019-03-27,32980224,8739500,41719724
19267,RNEW11,2019-03-31,2019-05-14,32980224,8739500,41719724
19268,RNEW11,2019-06-30,2019-08-15,32980224,8739500,41719724
19269,RNEW11,2019-09-30,2019-11-13,32980224,8739500,41719724
19270,RNEW11,2019-12-31,2020-08-28,32980224,8739500,41719724
19271,RNEW11,2020-03-31,2020-06-29,31352518,10367206,41719724
19272,RNEW11,2020-06-30,2020-08-28,31352518,10367206,41719724
19273,RNEW11,2020-09-30,2020-11-12,31352518,10367206,41719724
19274,RNEW3,2010-12-31,2011-03-28,93033067,47730533,140763600
19275,RNEW3,2011-03-31,2011-05-17,93393118,48450635,141843753
19276,RNEW3,2011-06-30,2011-08-05,93518118,48700635,142218753
19277,RNEW3,2011-09-30,2012-10-29,146813876,49075491,195889367
19278,RNEW3,2011-12-31,2013-05-03,145066949,50529299,195596248
19279,RNEW3,2012-03-31,2012-10-16,145087187,50643731,195730918
19280,RNEW3,2012-06-30,2012-08-09,145100899,50697513,195798412
19281,RNEW3,2012-09-30,2012-11-08,170086432,59429640,229516072
19282,RNEW3,2012-12-31,2013-03-18,156469395,73445134,229914529
19283,RNEW3,2013-03-31,2013-05-10,156508015,73523850,230031865
19284,RNEW3,2013-06-30,2013-08-13,156477463,73554402,230031865
19285,RNEW3,2013-09-30,2013-11-05,156896011,74394006,231290017
19286,RNEW3,2013-12-31,2014-03-06,156899210,74408816,231308026
19287,RNEW3,2014-03-31,2014-05-06,150899210,80408816,231308026
19288,RNEW3,2014-06-30,2020-04-28,150899210,80408816,231308026
19289,RNEW3,2014-09-30,2020-04-28,150899210,80408816,231308026
19290,RNEW3,2014-12-31,2015-03-04,236845392,81810030,318655422
19291,RNEW3,2015-03-31,2016-11-16,236844286,81811136,318655422
19292,RNEW3,2015-06-30,2020-04-28,236844286,81811136,318655422
19293,RNEW3,2015-09-30,2020-04-28,236883455,81889474,318772929
19294,RNEW3,2015-12-31,2016-03-28,236874031,81898898,318772929
19295,RNEW3,2016-03-31,2016-05-13,236874031,81898898,318772929
19296,RNEW3,2016-06-30,2016-08-08,278916250,81899063,360815313
19297,RNEW3,2016-09-30,2016-11-09,278916250,81899063,360815313
19298,RNEW3,2016-12-31,2017-03-22,278916250,81899063,360815313
19299,RNEW3,2017-03-31,2017-05-12,278916250,81899063,360815313
19300,RNEW3,2017-06-30,2017-08-10,329805243,87392001,417197244
19301,RNEW3,2017-09-30,2017-11-13,329805243,87392001,417197244
19302,RNEW3,2017-12-31,2018-03-29,329805243,87392001,417197244
19303,RNEW3,2018-03-31,2018-05-11,329805243,87392001,417197244
19304,RNEW3,2018-06-30,2018-08-13,329805243,87392001,417197244
19305,RNEW3,2018-09-30,2018-11-06,329805243,87392001,417197244
19306,RNEW3,2018-12-31,2019-03-27,32980224,8739500,41719724
19307,RNEW3,2019-03-31,2019-05-14,32980224,8739500,41719724
19308,RNEW3,2019-06-30,2019-08-15,32980224,8739500,41719724
19309,RNEW3,2019-09-30,2019-11-13,32980224,8739500,41719724
19310,RNEW3,2019-12-31,2020-08-28,32980224,8739500,41719724
19311,RNEW3,2020-03-31,2020-06-29,31352518,10367206,41719724
19312,RNEW3,2020-06-30,2020-08-28,31352518,10367206,41719724
19313,RNEW3,2020-09-30,2020-11-12,31352518,10367206,41719724
19314,RNEW4,2010-12-31,2011-03-28,93033067,47730533,140763600
19315,RNEW4,2011-03-31,2011-05-17,93393118,48450635,141843753
19316,RNEW4,2011-06-30,2011-08-05,93518118,48700635,142218753
19317,RNEW4,2011-09-30,2012-10-29,146813876,49075491,195889367
19318,RNEW4,2011-12-31,2013-05-03,145066949,50529299,195596248
19319,RNEW4,2012-03-31,2012-10-16,145087187,50643731,195730918
19320,RNEW4,2012-06-30,2012-08-09,145100899,50697513,195798412
19321,RNEW4,2012-09-30,2012-11-08,170086432,59429640,229516072
19322,RNEW4,2012-12-31,2013-03-18,156469395,73445134,229914529
19323,RNEW4,2013-03-31,2013-05-10,156508015,73523850,230031865
19324,RNEW4,2013-06-30,2013-08-13,156477463,73554402,230031865
19325,RNEW4,2013-09-30,2013-11-05,156896011,74394006,231290017
19326,RNEW4,2013-12-31,2014-03-06,156899210,74408816,231308026
19327,RNEW4,2014-03-31,2014-05-06,150899210,80408816,231308026
19328,RNEW4,2014-06-30,2020-04-28,150899210,80408816,231308026
19329,RNEW4,2014-09-30,2020-04-28,150899210,80408816,231308026
19330,RNEW4,2014-12-31,2015-03-04,236845392,81810030,318655422
19331,RNEW4,2015-03-31,2016-11-16,236844286,81811136,318655422
19332,RNEW4,2015-06-30,2020-04-28,236844286,81811136,318655422
19333,RNEW4,2015-09-30,2020-04-28,236883455,81889474,318772929
19334,RNEW4,2015-12-31,2016-03-28,236874031,81898898,318772929
19335,RNEW4,2016-03-31,2016-05-13,236874031,81898898,318772929
19336,RNEW4,2016-06-30,2016-08-08,278916250,81899063,360815313
19337,RNEW4,2016-09-30,2016-11-09,278916250,81899063,360815313
19338,RNEW4,2016-12-31,2017-03-22,278916250,81899063,360815313
19339,RNEW4,2017-03-31,2017-05-12,278916250,81899063,360815313
19340,RNEW4,2017-06-30,2017-08-10,329805243,87392001,417197244
19341,RNEW4,2017-09-30,2017-11-13,329805243,87392001,417197244
19342,RNEW4,2017-12-31,2018-03-29,329805243,87392001,417197244
19343,RNEW4,2018-03-31,2018-05-11,329805243,87392001,417197244
19344,RNEW4,2018-06-30,2018-08-13,329805243,87392001,417197244
19345,RNEW4,2018-09-30,2018-11-06,329805243,87392001,417197244
19346,RNEW4,2018-12-31,2019-03-27,32980224,8739500,41719724
19347,RNEW4,2019-03-31,2019-05-14,32980224,8739500,41719724
19348,RNEW4,2019-06-30,2019-08-15,32980224,8739500,41719724
19349,RNEW4,2019-09-30,2019-11-13,32980224,8739500,41719724
19350,RNEW4,2019-12-31,2020-08-28,32980224,8739500,41719724
19351,RNEW4,2020-03-31,2020-06-29,31352518,10367206,41719724
19352,RNEW4,2020-06-30,2020-08-28,31352518,10367206,41719724
19353,RNEW4,2020-09-30,2020-11-12,31352518,10367206,41719724
19354,TRPN3,2010-12-31,2011-09-02,41207,0,41207
19355,TRPN3,2011-03-31,2011-05-12,45759895,0,45759895
19356,TRPN3,2011-06-30,2011-09-14,45760,0,45760
19357,TRPN3,2011-09-30,2011-11-10,48193,0,48193
19358,TRPN3,2011-12-31,2012-02-07,48193,0,48193
19359,TRPN3,2012-03-31,2012-05-08,48193,0,48193
19360,TRPN3,2012-06-30,2012-08-08,46023,0,46023
19361,TRPN3,2012-09-30,2012-11-12,47849,0,47849
19362,TRPN3,2012-12-31,2013-01-28,47849,0,47849
19363,TRPN3,2013-03-31,2013-04-29,46387,0,46387
19364,TRPN3,2013-06-30,2013-07-29,45556,0,45556
19365,TRPN3,2013-09-30,2013-11-05,46150,0,46150
19366,TRPN3,2013-12-31,2014-01-28,46288,0,46288
19367,TRPN3,2014-03-31,2014-05-08,46667,0,46667
19368,TRPN3,2014-06-30,2014-07-29,46667,0,46667
19369,TRPN3,2014-09-30,2014-10-30,47097,0,47097
19370,TRPN3,2014-12-31,2015-02-10,46555,0,46555
19371,TRPN3,2015-03-31,2015-05-06,46579,0,46579
19372,TRPN3,2015-06-30,2015-08-10,45999,0,45999
19373,TRPN3,2015-09-30,2015-11-04,45999,0,45999
19374,TRPN3,2015-12-31,2016-02-11,46040,0,46040
19375,TRPN3,2016-03-31,2016-04-29,46197,0,46197
19376,TRPN3,2016-06-30,2016-08-02,45498,0,45498
19377,TRPN3,2016-09-30,2016-11-03,44115,0,44115
19378,TRPN3,2016-12-31,2017-02-23,44115,0,44115
19379,TRPN3,2017-03-31,2017-04-27,44115,0,44115
19380,TRPN3,2017-06-30,2017-08-14,44115,0,44115
19381,TRPN3,2017-09-30,2017-11-14,44115,0,44115
19382,TRPN3,2017-12-31,2018-02-09,43959,0,43959
19383,TRPN3,2018-03-31,2018-05-15,44115,0,44115
19384,TRPN3,2018-06-30,2018-07-24,44219,0,44219
19385,TRPN3,2018-09-30,2018-11-14,44116,0,44116
19386,TRPN3,2018-12-31,2019-03-13,45299,0,45299
19387,TRPN3,2019-03-31,2019-05-15,45299,0,45299
19388,CIEL3,2010-12-31,2011-04-19,1364783800,0,1364783800
19389,CIEL3,2011-03-31,2011-05-04,1364783800,0,1364783800
19390,CIEL3,2011-06-30,2011-07-26,545913520,0,545913520
19391,CIEL3,2011-09-30,2011-11-01,545913520,0,545913520
19392,CIEL3,2011-12-31,2012-02-08,545913520,0,545913520
19393,CIEL3,2012-03-31,2012-04-25,545913520,0,545913520
19394,CIEL3,2012-06-30,2012-07-25,653861218,0,653861218
19395,CIEL3,2012-09-30,2012-10-23,654345737,0,654345737
19396,CIEL3,2012-12-31,2013-02-06,655096224,0,655096224
19397,CIEL3,2013-03-31,2013-05-02,655096224,0,655096224
19398,CIEL3,2013-06-30,2013-08-06,784523090,0,784523090
19399,CIEL3,2013-09-30,2013-11-04,786115469,0,786115469
19400,CIEL3,2013-12-31,2014-01-28,786115469,0,786115469
19401,CIEL3,2014-03-31,2014-05-06,1565901704,0,1565901704
19402,CIEL3,2014-06-30,2014-07-29,1565882893,0,1565882893
19403,CIEL3,2014-09-30,2014-10-28,1566258985,0,1566258985
19404,CIEL3,2014-12-31,2015-01-28,1566433971,0,1566433971
19405,CIEL3,2015-03-31,2015-04-29,1566764252,0,1566764252
19406,CIEL3,2015-06-30,2015-07-29,1880483926,0,1880483926
19407,CIEL3,2015-09-30,2015-11-05,1881696240,0,1881696240
19408,CIEL3,2015-12-31,2016-02-01,1881830814,0,1881830814
19409,CIEL3,2016-03-31,2016-05-02,1881443238,0,1881443238
19410,CIEL3,2016-06-30,2016-08-01,2258567830,0,2258567830
19411,CIEL3,2016-09-30,2016-11-08,2259623845,0,2259623845
19412,CIEL3,2016-12-31,2017-01-30,2259768045,0,2259768045
19413,CIEL3,2017-03-31,2017-05-02,2260253774,0,2260253774
19414,CIEL3,2017-06-30,2017-08-01,2712679297,0,2712679297
19415,CIEL3,2017-09-30,2017-10-30,2713932157,0,2713932157
19416,CIEL3,2017-12-31,2018-03-05,2716815061,0,2716815061
19417,CIEL3,2018-03-31,2018-05-02,2716815061,0,2716815061
19418,CIEL3,2018-06-30,2018-07-30,2716815061,0,2716815061
19419,CIEL3,2018-09-30,2018-10-30,2716815061,0,2716815061
19420,CIEL3,2018-12-31,2019-01-28,2716815061,0,2716815061
19421,CIEL3,2019-03-31,2019-04-23,2716815061,0,2716815061
19422,CIEL3,2019-06-30,2019-07-24,2716815061,0,2716815061
19423,CIEL3,2019-09-30,2019-10-29,2716815061,0,2716815061
19424,CIEL3,2019-12-31,2020-02-27,2716815061,0,2716815061
19425,CIEL3,2020-03-31,2020-04-28,2716815061,0,2716815061
19426,CIEL3,2020-06-30,2020-07-28,2716815061,0,2716815061
19427,CIEL3,2020-09-30,2020-10-27,2716815061,0,2716815061
19428,CIEL3,2020-12-31,2021-02-26,2716815061,0,2716815061
19429,FLRY3,2010-12-31,2011-03-14,131298550,0,131298550
19430,FLRY3,2011-03-31,2011-05-05,131298550,0,131298550
19431,FLRY3,2011-06-30,2011-08-04,131298550,0,131298550
19432,FLRY3,2011-09-30,2011-11-03,131298550,0,131298550
19433,FLRY3,2011-12-31,2012-03-01,156203919,0,156203919
19434,FLRY3,2012-03-31,2012-05-03,156203919,0,156203919
19435,FLRY3,2012-06-30,2012-08-02,156293356,0,156293356
19436,FLRY3,2012-09-30,2012-10-31,156236544,0,156236544
19437,FLRY3,2012-12-31,2013-03-07,156318136,0,156318136
19438,FLRY3,2013-03-31,2013-05-03,156293356,0,156293356
19439,FLRY3,2013-06-30,2013-08-01,156293356,0,156293356
19440,FLRY3,2013-09-30,2013-10-31,156293356,0,156293356
19441,FLRY3,2013-12-31,2014-03-13,156293356,0,156293356
19442,FLRY3,2014-03-31,2014-05-08,156293356,0,156293356
19443,FLRY3,2014-06-30,2014-07-31,156293356,0,156293356
19444,FLRY3,2014-09-30,2014-10-30,156293356,0,156293356
19445,FLRY3,2014-12-31,2015-03-25,156293356,0,156293356
19446,FLRY3,2015-03-31,2015-04-29,156293356,0,156293356
19447,FLRY3,2015-06-30,2015-07-30,156293356,0,156293356
19448,FLRY3,2015-09-30,2015-10-29,156293356,0,156293356
19449,FLRY3,2015-12-31,2016-03-03,156293356,0,156293356
19450,FLRY3,2016-03-31,2016-04-28,156293356,0,156293356
19451,FLRY3,2016-06-30,2016-07-29,156293356,0,156293356
19452,FLRY3,2016-09-30,2016-10-27,156293356,0,156293356
19453,FLRY3,2016-12-31,2017-03-09,157115125,0,157115125
19454,FLRY3,2017-03-31,2017-04-27,157115125,0,157115125
19455,FLRY3,2017-06-30,2017-07-27,314791538,0,314791538
19456,FLRY3,2017-09-30,2017-10-26,314791538,0,314791538
19457,FLRY3,2017-12-31,2018-03-05,315312192,0,315312192
19458,FLRY3,2018-03-31,2018-04-26,315312192,0,315312192
19459,FLRY3,2018-06-30,2018-07-26,315312192,0,315312192
19460,FLRY3,2018-09-30,2018-10-25,315654796,0,315654796
19461,FLRY3,2018-12-31,2019-04-18,316113442,0,316113442
19462,FLRY3,2019-03-31,2019-04-25,316113442,0,316113442
19463,FLRY3,2019-06-30,2019-07-25,316113442,0,316113442
19464,FLRY3,2019-09-30,2019-10-24,316744460,0,316744460
19465,FLRY3,2019-12-31,2020-02-19,316744460,0,316744460
19466,FLRY3,2020-03-31,2020-05-14,316788210,0,316788210
19467,FLRY3,2020-06-30,2020-07-30,316788210,0,316788210
19468,FLRY3,2020-09-30,2020-10-29,317366103,0,317366103
19469,FLRY3,2020-12-31,2021-02-25,317266103,0,317266103
19470,MPLU3,2010-12-31,2011-02-11,161294000,0,161294000
19471,MPLU3,2011-03-31,2011-05-03,161294,0,161294
19472,MPLU3,2011-06-30,2011-08-04,161294,0,161294
19473,MPLU3,2011-09-30,2011-11-03,161294,0,161294
19474,MPLU3,2011-12-31,2012-02-14,161371285,0,161371285
19475,MPLU3,2012-03-31,2012-05-02,161371,0,161371
19476,MPLU3,2012-06-30,2012-08-09,161371,0,161371
19477,MPLU3,2012-09-30,2012-11-07,161855,0,161855
19478,MPLU3,2012-12-31,2013-03-16,161964306,0,161964306
19479,MPLU3,2013-03-31,2013-05-10,161964,0,161964
19480,MPLU3,2013-06-30,2013-08-08,161964,0,161964
19481,MPLU3,2013-09-30,2013-11-07,161964,0,161964
19482,MPLU3,2013-12-31,2014-02-27,162004630,0,162004630
19483,MPLU3,2014-03-31,2014-05-12,162125601,0,162125601
19484,MPLU3,2014-06-30,2014-08-05,162166,0,162166
19485,MPLU3,2014-09-30,2014-11-05,162166,0,162166
19486,MPLU3,2014-12-31,2015-02-26,162246573,0,162246573
19487,MPLU3,2015-03-31,2015-05-04,162160202,0,162160202
19488,MPLU3,2015-06-30,2015-08-03,162160202,0,162160202
19489,MPLU3,2015-09-30,2016-10-28,162246573,0,162246573
19490,MPLU3,2015-12-31,2016-02-25,162246573,0,162246573
19491,MPLU3,2016-03-31,2016-05-05,162246573,0,162246573
19492,MPLU3,2016-06-30,2016-08-18,162246573,0,162246573
19493,MPLU3,2016-09-30,2017-05-23,162246573,0,162246573
19494,MPLU3,2016-12-31,2017-03-06,162246573,0,162246573
19495,MPLU3,2017-03-31,2017-05-02,162246573,0,162246573
19496,MPLU3,2017-06-30,2017-08-04,162246573,0,162246573
19497,MPLU3,2017-09-30,2017-11-07,162246573,0,162246573
19498,MPLU3,2017-12-31,2018-03-07,162246873,0,162246873
19499,MPLU3,2018-03-31,2018-05-08,162246573,0,162246573
19500,MPLU3,2018-06-30,2018-08-06,162246573,0,162246573
19501,MPLU3,2018-09-30,2018-11-07,162246573,0,162246573
19502,MPLU3,2018-12-31,2019-03-11,162246573,0,162246573
19503,MILS3,2010-12-31,2011-04-07,125495,0,125495
19504,MILS3,2011-03-31,2011-05-13,125495,0,125495
19505,MILS3,2011-06-30,2011-08-08,125495,0,125495
19506,MILS3,2011-09-30,2011-11-09,125591,0,125591
19507,MILS3,2011-12-31,2012-02-13,125657,0,125657
19508,MILS3,2012-03-31,2012-05-10,125689646,0,125689646
19509,MILS3,2012-06-30,2012-08-08,126148646,0,126148646
19510,MILS3,2012-09-30,2012-11-08,126314250,0,126314250
19511,MILS3,2012-12-31,2013-03-04,126399,0,126399
19512,MILS3,2013-03-31,2013-05-08,126491654,0,126491654
19513,MILS3,2013-06-30,2013-08-06,127120372,0,127120372
19514,MILS3,2013-09-30,2013-11-06,127314202,0,127314202
19515,MILS3,2013-12-31,2014-03-11,127386,0,127386
19516,MILS3,2014-03-31,2014-05-06,127490508,0,127490508
19517,MILS3,2014-06-30,2014-08-06,128026080,0,128026080
19518,MILS3,2014-09-30,2014-11-05,128057925,0,128057925
19519,MILS3,2014-12-31,2015-03-10,128057,0,128057
19520,MILS3,2015-03-31,2015-05-06,128057925,0,128057925
19521,MILS3,2015-06-30,2015-08-05,128057925,0,128057925
19522,MILS3,2015-09-30,2015-11-05,128057095,0,128057095
19523,MILS3,2015-12-31,2016-03-09,128057,0,128057
19524,MILS3,2016-03-31,2016-05-05,128057,0,128057
19525,MILS3,2016-06-30,2016-08-03,175586,0,175586
19526,MILS3,2016-09-30,2016-11-07,175586,0,175586
19527,MILS3,2016-12-31,2017-03-14,175586,0,175586
19528,MILS3,2017-03-31,2017-05-10,175586,0,175586
19529,MILS3,2017-06-30,2017-08-08,175586,0,175586
19530,MILS3,2017-09-30,2017-11-08,175586,0,175586
19531,MILS3,2017-12-31,2018-03-19,175586,0,175586
19532,MILS3,2018-03-31,2018-05-09,175586,0,175586
19533,MILS3,2018-06-30,2018-08-08,175586,0,175586
19534,MILS3,2018-09-30,2018-11-07,175586,0,175586
19535,MILS3,2018-12-31,2019-03-14,175586,0,175586
19536,MILS3,2019-03-31,2019-05-09,175586,0,175586
19537,MILS3,2019-06-30,2019-08-14,251862,0,251862
19538,MILS3,2019-09-30,2019-11-13,251866,0,251866
19539,MILS3,2019-12-31,2020-03-25,251866,0,251866
19540,MILS3,2020-03-31,2020-05-14,251866,0,251866
19541,MILS3,2020-06-30,2020-08-13,251907,0,251907
19542,MILS3,2020-09-30,2020-11-12,251954,0,251954
19543,MILS3,2020-12-31,2021-03-17,251954,0,251954
19544,JSLG11,2010-12-31,2011-11-29,198890,0,198890
19545,JSLG11,2011-03-31,2011-08-01,198890,0,198890
19546,JSLG11,2011-06-30,2011-08-10,198890,0,198890
19547,JSLG11,2011-09-30,2011-11-09,198890,0,198890
19548,JSLG11,2011-12-31,2012-06-28,201329600,0,201329600
19549,JSLG11,2012-03-31,2012-06-14,216799134,0,216799134
19550,JSLG11,2012-06-30,2012-08-14,216799134,0,216799134
19551,JSLG11,2012-09-30,2012-11-08,216799134,0,216799134
19552,JSLG11,2012-12-31,2013-07-17,216799134,0,216799134
19553,JSLG11,2013-03-31,2013-07-17,216799134,0,216799134
19554,JSLG11,2013-06-30,2013-08-12,216799134,0,216799134
19555,JSLG11,2013-09-30,2013-10-31,216799134,0,216799134
19556,JSLG11,2013-12-31,2014-02-26,216799134,0,216799134
19557,JSLG11,2014-03-31,2014-04-24,216799134,0,216799134
19558,JSLG11,2014-06-30,2014-07-28,216799134,0,216799134
19559,JSLG11,2014-09-30,2014-11-13,216799134,0,216799134
19560,JSLG11,2014-12-31,2015-02-11,216799134,0,216799134
19561,JSLG11,2015-03-31,2015-04-30,216799134,0,216799134
19562,JSLG11,2015-06-30,2015-08-07,216799134,0,216799134
19563,JSLG11,2015-09-30,2015-10-28,211000000,0,211000000
19564,JSLG11,2015-12-31,2016-03-03,211000000,0,211000000
19565,JSLG11,2016-03-31,2016-05-09,211000000,0,211000000
19566,JSLG11,2016-06-30,2016-08-08,206000000,0,206000000
19567,JSLG11,2016-09-30,2016-11-08,202500000,0,202500000
19568,JSLG11,2016-12-31,2017-05-08,202500000,0,202500000
19569,JSLG11,2017-03-31,2017-05-12,202500000,0,202500000
19570,JSLG11,2017-06-30,2017-08-11,202500000,0,202500000
19571,JSLG11,2017-09-30,2017-11-10,202500000,0,202500000
19572,JSLG11,2017-12-31,2018-03-29,202500000,0,202500000
19573,JSLG11,2018-03-31,2018-05-14,202500000,0,202500000
19574,JSLG11,2018-06-30,2018-08-09,202500000,0,202500000
19575,JSLG11,2018-09-30,2018-11-23,202500000,0,202500000
19576,JSLG11,2018-12-31,2019-03-11,205114532,0,205114532
19577,JSLG11,2019-03-31,2019-05-08,205114532,0,205114532
19578,JSLG11,2019-06-30,2019-08-27,205537500,0,205537500
19579,JSLG11,2019-09-30,2019-11-07,206746161,0,206746161
19580,JSLG11,2019-12-31,2020-03-30,206788866,0,206788866
19581,JSLG11,2020-03-31,2020-05-15,206798715,0,206798715
19582,JSLG11,2020-06-30,2020-08-13,207735316,0,207735316
19583,JSLG11,2020-09-30,2020-11-11,279991078,0,279991078
19584,JSLG11,2020-12-31,2021-03-08,278287843,0,278287843
19585,JSLG3,2010-12-31,2011-11-29,198890,0,198890
19586,JSLG3,2011-03-31,2011-08-01,198890,0,198890
19587,JSLG3,2011-06-30,2011-08-10,198890,0,198890
19588,JSLG3,2011-09-30,2011-11-09,198890,0,198890
19589,JSLG3,2011-12-31,2012-06-28,201329600,0,201329600
19590,JSLG3,2012-03-31,2012-06-14,216799134,0,216799134
19591,JSLG3,2012-06-30,2012-08-14,216799134,0,216799134
19592,JSLG3,2012-09-30,2012-11-08,216799134,0,216799134
19593,JSLG3,2012-12-31,2013-07-17,216799134,0,216799134
19594,JSLG3,2013-03-31,2013-07-17,216799134,0,216799134
19595,JSLG3,2013-06-30,2013-08-12,216799134,0,216799134
19596,JSLG3,2013-09-30,2013-10-31,216799134,0,216799134
19597,JSLG3,2013-12-31,2014-02-26,216799134,0,216799134
19598,JSLG3,2014-03-31,2014-04-24,216799134,0,216799134
19599,JSLG3,2014-06-30,2014-07-28,216799134,0,216799134
19600,JSLG3,2014-09-30,2014-11-13,216799134,0,216799134
19601,JSLG3,2014-12-31,2015-02-11,216799134,0,216799134
19602,JSLG3,2015-03-31,2015-04-30,216799134,0,216799134
19603,JSLG3,2015-06-30,2015-08-07,216799134,0,216799134
19604,JSLG3,2015-09-30,2015-10-28,211000000,0,211000000
19605,JSLG3,2015-12-31,2016-03-03,211000000,0,211000000
19606,JSLG3,2016-03-31,2016-05-09,211000000,0,211000000
19607,JSLG3,2016-06-30,2016-08-08,206000000,0,206000000
19608,JSLG3,2016-09-30,2016-11-08,202500000,0,202500000
19609,JSLG3,2016-12-31,2017-05-08,202500000,0,202500000
19610,JSLG3,2017-03-31,2017-05-12,202500000,0,202500000
19611,JSLG3,2017-06-30,2017-08-11,202500000,0,202500000
19612,JSLG3,2017-09-30,2017-11-10,202500000,0,202500000
19613,JSLG3,2017-12-31,2018-03-29,202500000,0,202500000
19614,JSLG3,2018-03-31,2018-05-14,202500000,0,202500000
19615,JSLG3,2018-06-30,2018-08-09,202500000,0,202500000
19616,JSLG3,2018-09-30,2018-11-23,202500000,0,202500000
19617,JSLG3,2018-12-31,2019-03-11,205114532,0,205114532
19618,JSLG3,2019-03-31,2019-05-08,205114532,0,205114532
19619,JSLG3,2019-06-30,2019-08-27,205537500,0,205537500
19620,JSLG3,2019-09-30,2019-11-07,206746161,0,206746161
19621,JSLG3,2019-12-31,2020-03-30,206788866,0,206788866
19622,JSLG3,2020-03-31,2020-05-15,206798715,0,206798715
19623,JSLG3,2020-06-30,2020-08-13,207735316,0,207735316
19624,JSLG3,2020-09-30,2020-11-11,279991078,0,279991078
19625,JSLG3,2020-12-31,2021-03-08,278287843,0,278287843
19626,AMAR3,2010-12-31,2011-02-18,184551,0,184551
19627,AMAR3,2011-03-31,2011-05-03,184551,0,184551
19628,AMAR3,2011-06-30,2011-08-03,184551,0,184551
19629,AMAR3,2011-09-30,2011-11-07,184551,0,184551
19630,AMAR3,2011-12-31,2012-03-08,184551,0,184551
19631,AMAR3,2012-03-31,2012-05-03,185301,0,185301
19632,AMAR3,2012-06-30,2012-08-02,185449,0,185449
19633,AMAR3,2012-09-30,2012-10-31,185449,0,185449
19634,AMAR3,2012-12-31,2013-02-05,185449,0,185449
19635,AMAR3,2013-03-31,2013-04-30,185448,0,185448
19636,AMAR3,2013-06-30,2013-08-14,185532,0,185532
19637,AMAR3,2013-09-30,2013-11-14,185532,0,185532
19638,AMAR3,2013-12-31,2014-03-17,185533,0,185533
19639,AMAR3,2014-03-31,2014-05-08,185532,0,185532
19640,AMAR3,2014-06-30,2014-08-07,185532,0,185532
19641,AMAR3,2014-09-30,2014-11-06,185532,0,185532
19642,AMAR3,2014-12-31,2015-02-12,185533,0,185533
19643,AMAR3,2015-03-31,2015-05-04,185532,0,185532
19644,AMAR3,2015-06-30,2015-09-21,185532,0,185532
19645,AMAR3,2015-09-30,2015-10-27,204086,0,204086
19646,AMAR3,2015-12-31,2016-02-25,204086,0,204086
19647,AMAR3,2016-03-31,2016-05-02,204086,0,204086
19648,AMAR3,2016-06-30,2016-08-04,204086,0,204086
19649,AMAR3,2016-09-30,2016-10-27,204086,0,204086
19650,AMAR3,2016-12-31,2017-02-24,204086,0,204086
19651,AMAR3,2017-03-31,2017-05-11,204086,0,204086
19652,AMAR3,2017-06-30,2017-08-10,899597,0,899597
19653,AMAR3,2017-09-30,2017-10-26,204086,0,204086
19654,AMAR3,2017-12-31,2018-03-08,204086,0,204086
19655,AMAR3,2018-03-31,2018-05-11,204086,0,204086
19656,AMAR3,2018-06-30,2018-08-09,204086,0,204086
19657,AMAR3,2018-09-30,2018-11-13,204086,0,204086
19658,AMAR3,2018-12-31,2019-03-14,204086,0,204086
19659,AMAR3,2019-03-31,2019-05-13,204086,0,204086
19660,AMAR3,2019-06-30,2019-08-09,204086,0,204086
19661,AMAR3,2019-09-30,2019-11-07,204085999,0,204085999
19662,AMAR3,2019-12-31,2020-03-25,260857,0,260857
19663,AMAR3,2020-03-31,2020-05-29,261667,0,261667
19664,AMAR3,2020-06-30,2020-08-24,261667,0,261667
19665,AMAR3,2020-09-30,2020-11-09,261667,0,261667
19666,AMAR3,2020-12-31,2021-03-22,261667,0,261667
19667,AFLT3,2010-12-31,2011-03-29,63085,0,63085
19668,AFLT3,2011-03-31,2011-05-16,63085,0,63085
19669,AFLT3,2011-06-30,2011-07-29,63085,0,63085
19670,AFLT3,2011-09-30,2011-10-31,63085,0,63085
19671,AFLT3,2011-12-31,2012-02-29,63085,0,63085
19672,AFLT3,2012-03-31,2012-05-08,63085,0,63085
19673,AFLT3,2012-06-30,2012-07-27,63085,0,63085
19674,AFLT3,2012-09-30,2012-11-14,63085,0,63085
19675,AFLT3,2012-12-31,2013-03-25,63085,0,63085
19676,AFLT3,2013-03-31,2013-05-16,63085,0,63085
19677,AFLT3,2013-06-30,2013-08-14,63095,0,63095
19678,AFLT3,2013-09-30,2013-11-08,63095,0,63095
19679,AFLT3,2013-12-31,2014-03-25,63085,0,63085
19680,AFLT3,2014-03-31,2014-05-19,63085,0,63085
19681,AFLT3,2014-06-30,2014-08-14,63085,0,63085
19682,AFLT3,2014-09-30,2014-11-12,63085,0,63085
19683,AFLT3,2014-12-31,2015-02-25,63085,0,63085
19684,AFLT3,2015-03-31,2015-05-14,63085,0,63085
19685,AFLT3,2015-06-30,2015-08-13,63085,0,63085
19686,AFLT3,2015-09-30,2015-11-12,63085,0,63085
19687,AFLT3,2015-12-31,2016-02-22,63085,0,63085
19688,AFLT3,2016-03-31,2016-05-12,63085,0,63085
19689,AFLT3,2016-06-30,2016-08-11,63085,0,63085
19690,AFLT3,2016-09-30,2016-11-11,63085,0,63085
19691,AFLT3,2016-12-31,2017-02-23,63085,0,63085
19692,AFLT3,2017-03-31,2017-05-15,63085,0,63085
19693,AFLT3,2017-06-30,2017-08-10,33085,0,33085
19694,AFLT3,2017-09-30,2017-11-06,63085,0,63085
19695,AFLT3,2017-12-31,2018-02-19,63085,0,63085
19696,AFLT3,2018-03-31,2018-04-23,63085,0,63085
19697,AFLT3,2018-06-30,2018-07-23,63085,0,63085
19698,AFLT3,2018-09-30,2018-10-22,63085,0,63085
19699,AFLT3,2018-12-31,2019-02-14,63085,0,63085
19700,AFLT3,2019-03-31,2019-04-23,63085,0,63085
19701,AFLT3,2019-06-30,2019-07-24,63084700,0,63084700
19702,AFLT3,2019-09-30,2019-10-18,63084700,0,63084700
19703,AFLT3,2019-12-31,2020-02-17,63085,0,63085
19704,AFLT3,2020-03-31,2020-04-27,63085,0,63085
19705,AFLT3,2020-06-30,2020-07-21,63085,0,63085
19706,AFLT3,2020-09-30,2020-10-20,63085,0,63085
19707,AFLT3,2020-12-31,2021-02-09,63085,0,63085
19708,PRIO3,2010-12-31,2011-05-06,4619349,0,4619349
19709,PRIO3,2011-03-31,2011-05-14,4684758,0,4684758
19710,PRIO3,2011-06-30,2011-08-11,5547770,0,5547770
19711,PRIO3,2011-09-30,2011-11-10,5751372,0,5751372
19712,PRIO3,2011-12-31,2012-03-12,5856247,0,5856247
19713,PRIO3,2012-03-31,2012-05-10,5882409,0,5882409
19714,PRIO3,2012-06-30,2012-08-09,294308450,0,294308450
19715,PRIO3,2012-09-30,2012-11-12,294711250,0,294711250
19716,PRIO3,2012-12-31,2013-03-04,295412650,0,295412650
19717,PRIO3,2013-03-31,2013-05-15,296185963,0,296185963
19718,PRIO3,2013-06-30,2013-08-14,297462579,0,297462579
19719,PRIO3,2013-09-30,2013-11-13,297466746,0,297466746
19720,PRIO3,2013-12-31,2014-03-31,297466746,0,297466746
19721,PRIO3,2014-03-31,2014-05-14,297466746,0,297466746
19722,PRIO3,2014-06-30,2014-08-14,29746675,0,29746675
19723,PRIO3,2014-09-30,2014-11-13,29748449,0,29748449
19724,PRIO3,2014-12-31,2015-03-30,29748449,0,29748449
19725,PRIO3,2015-03-31,2015-05-14,29748449,0,29748449
19726,PRIO3,2015-06-30,2015-08-20,29748449,0,29748449
19727,PRIO3,2015-09-30,2015-11-12,29748449,0,29748449
19728,PRIO3,2015-12-31,2016-03-23,65940277,0,65940277
19729,PRIO3,2016-03-31,2016-05-12,65945675,0,65945675
19730,PRIO3,2016-06-30,2016-08-11,13790747,0,13790747
19731,PRIO3,2016-09-30,2016-11-14,13190747,0,13190747
19732,PRIO3,2016-12-31,2017-03-28,13190748,0,13190748
19733,PRIO3,2017-03-31,2017-05-12,13190748,0,13190748
19734,PRIO3,2017-06-30,2017-08-09,13190747,0,13190747
19735,PRIO3,2017-09-30,2017-11-09,13191869,0,13191869
19736,PRIO3,2017-12-31,2020-11-03,13191932,0,13191932
19737,PRIO3,2018-03-31,2018-05-10,13337039,0,13337039
19738,PRIO3,2018-06-30,2018-08-09,13336517,0,13336517
19739,PRIO3,2018-09-30,2018-10-30,13336517,0,13336517
19740,PRIO3,2018-12-31,2019-03-11,13336517,0,13336517
19741,PRIO3,2019-03-31,2019-05-15,137294543,0,137294543
19742,PRIO3,2019-06-30,2020-08-28,140964679,0,140964679
19743,PRIO3,2019-09-30,2020-11-04,140964679,0,140964679
19744,PRIO3,2019-12-31,2020-08-28,143185890,0,143185890
19745,PRIO3,2020-03-31,2020-11-04,144685660,0,144685660
19746,PRIO3,2020-06-30,2020-08-28,143185890,0,143185890
19747,PRIO3,2020-09-30,2020-11-18,144685660,0,144685660
19748,PRIO3,2020-12-31,2021-03-02,144685660,0,144685660
19749,APER3,2010-12-31,2011-05-25,936216,0,936216
19750,APER3,2011-03-31,2011-05-25,936216,0,936216
19751,APER3,2011-06-30,2011-08-16,943314,0,943314
19752,APER3,2011-09-30,2011-11-15,90549130,0,90549130
19753,APER3,2011-12-31,2012-04-03,95028140,0,95028140
19754,APER3,2012-03-31,2012-05-15,95404983,0,95404983
19755,APER3,2012-06-30,2012-08-13,95961559,0,95961559
19756,APER3,2012-09-30,2012-11-14,96002504,0,96002504
19757,APER3,2012-12-31,2013-03-27,96743021,0,96743021
19758,APER3,2013-03-31,2013-05-15,97053961,0,97053961
19759,APER3,2013-06-30,2014-08-18,97601650,0,97601650
19760,APER3,2013-09-30,2014-08-18,97744763,0,97744763
19761,APER3,2013-12-31,2014-03-28,98312688,0,98312688
19762,APER3,2014-03-31,2014-05-16,99128905,0,99128905
19763,APER3,2014-06-30,2014-08-13,99512851,0,99512851
19764,APER3,2014-09-30,2015-07-27,99853019,0,99853019
19765,APER3,2014-12-31,2015-03-30,99953713,0,99953713
19766,APER3,2015-03-31,2015-05-15,96657589,0,96657589
19767,APER3,2015-06-30,2015-08-13,96823071,0,96823071
19768,APER3,2015-09-30,2015-11-12,97255431,0,97255431
19769,APER3,2015-12-31,2016-03-30,5172939,0,5172939
19770,APER3,2016-03-31,2016-05-12,7528449,0,7528449
19771,APER3,2016-06-30,2016-08-10,7581958,0,7581958
19772,APER3,2016-09-30,2016-11-10,7657970,0,7657970
19773,APER3,2016-12-31,2017-03-27,7657970,0,7657970
19774,APER3,2017-03-31,2017-05-11,7668192,0,7668192
19775,APER3,2017-06-30,2017-08-10,7668192,0,7668192
19776,APER3,2017-09-30,2017-11-09,7668716,0,7668716
19777,APER3,2017-12-31,2018-03-22,7668764,0,7668764
19778,APER3,2018-03-31,2018-05-10,7678388,0,7678388
19779,APER3,2018-06-30,2018-08-10,7678388,0,7678388
19780,APER3,2018-09-30,2018-11-08,7678388,0,7678388
19781,APER3,2018-12-31,2019-03-26,7678388,0,7678388
19782,APER3,2019-03-31,2019-05-15,7678388,0,7678388
19783,APER3,2019-06-30,2019-08-09,7678388,0,7678388
19784,APER3,2019-09-30,2019-11-07,7678388,0,7678388
19785,APER3,2019-12-31,2020-03-28,11480134,0,11480134
19786,APER3,2020-03-31,2020-05-07,11480134,0,11480134
19787,APER3,2020-06-30,2020-08-13,11480134,0,11480134
19788,APER3,2020-09-30,2020-11-04,11480134,0,11480134
19789,APER3,2020-12-31,2021-03-25,11480134,0,11480134
19790,ARZZ3,2010-12-31,2011-03-29,78248,0,78248
19791,ARZZ3,2011-03-31,2011-05-11,88542,0,88542
19792,ARZZ3,2011-06-30,2011-08-10,88542,0,88542
19793,ARZZ3,2011-09-30,2011-11-09,88542,0,88542
19794,ARZZ3,2011-12-31,2012-03-01,88542,0,88542
19795,ARZZ3,2012-03-31,2012-05-02,88542,0,88542
19796,ARZZ3,2012-06-30,2012-08-01,88542,0,88542
19797,ARZZ3,2012-09-30,2012-10-31,88587,0,88587
19798,ARZZ3,2012-12-31,2013-03-06,88587,0,88587
19799,ARZZ3,2013-03-31,2013-04-25,88587,0,88587
19800,ARZZ3,2013-06-30,2013-07-31,88587,0,88587
19801,ARZZ3,2013-09-30,2013-10-30,88637,0,88637
19802,ARZZ3,2013-12-31,2014-03-19,88637,0,88637
19803,ARZZ3,2014-03-31,2014-04-29,88637,0,88637
19804,ARZZ3,2014-06-30,2014-07-30,88637,0,88637
19805,ARZZ3,2014-09-30,2014-10-29,88682,0,88682
19806,ARZZ3,2014-12-31,2015-03-03,88682,0,88682
19807,ARZZ3,2015-03-31,2015-05-06,88682,0,88682
19808,ARZZ3,2015-06-30,2015-08-05,88682,0,88682
19809,ARZZ3,2015-09-30,2015-11-05,88735,0,88735
19810,ARZZ3,2015-12-31,2016-03-02,88735,0,88735
19811,ARZZ3,2016-03-31,2016-05-04,88735,0,88735
19812,ARZZ3,2016-06-30,2016-08-03,88783,0,88783
19813,ARZZ3,2016-09-30,2016-11-03,88836,0,88836
19814,ARZZ3,2016-12-31,2017-03-08,88836,0,88836
19815,ARZZ3,2017-03-31,2017-05-09,88836,0,88836
19816,ARZZ3,2017-06-30,2017-08-02,89766,0,89766
19817,ARZZ3,2017-09-30,2017-10-31,89766,0,89766
19818,ARZZ3,2017-12-31,2018-03-07,89766,0,89766
19819,ARZZ3,2018-03-31,2018-05-09,89766,0,89766
19820,ARZZ3,2018-06-30,2018-08-01,90303,0,90303
19821,ARZZ3,2018-09-30,2018-10-31,90303,0,90303
19822,ARZZ3,2018-12-31,2019-02-20,90303,0,90303
19823,ARZZ3,2019-03-31,2019-05-08,90303,0,90303
19824,ARZZ3,2019-06-30,2019-08-06,90954,0,90954
19825,ARZZ3,2019-09-30,2019-10-30,90954,0,90954
19826,ARZZ3,2019-12-31,2020-05-08,90954,0,90954
19827,ARZZ3,2020-03-31,2020-05-29,90954,0,90954
19828,ARZZ3,2020-06-30,2020-08-13,90954,0,90954
19829,ARZZ3,2020-09-30,2020-11-12,90954,0,90954
19830,ARZZ3,2020-12-31,2021-03-04,99631,0,99631
19831,ALSO3,2010-12-31,2011-05-10,531728,0,531728
19832,ALSO3,2011-03-31,2011-05-16,76423831,0,76423831
19833,ALSO3,2011-06-30,2011-08-10,76423831,0,76423831
19834,ALSO3,2011-09-30,2011-11-08,76423831,0,76423831
19835,ALSO3,2011-12-31,2012-04-12,76423831,0,76423831
19836,ALSO3,2012-03-31,2012-05-10,76423831,0,76423831
19837,ALSO3,2012-06-30,2012-08-09,76423831,0,76423831
19838,ALSO3,2012-09-30,2012-11-05,76423831,0,76423831
19839,ALSO3,2012-12-31,2013-03-07,76423831,0,76423831
19840,ALSO3,2013-03-31,2013-05-08,76423831,0,76423831
19841,ALSO3,2013-06-30,2013-08-07,76423831,0,76423831
19842,ALSO3,2013-09-30,2013-11-06,76423831,0,76423831
19843,ALSO3,2013-12-31,2014-03-13,76423831,0,76423831
19844,ALSO3,2014-03-31,2014-05-14,76423831,0,76423831
19845,ALSO3,2014-06-30,2014-08-13,76423831,0,76423831
19846,ALSO3,2014-09-30,2014-11-05,76423831,0,76423831
19847,ALSO3,2014-12-31,2015-03-04,76423831,0,76423831
19848,ALSO3,2015-03-31,2015-05-06,76423831,0,76423831
19849,ALSO3,2015-06-30,2015-08-05,76423831,0,76423831
19850,ALSO3,2015-09-30,2015-11-09,76423831,0,76423831
19851,ALSO3,2015-12-31,2016-03-03,76423831,0,76423831
19852,ALSO3,2016-03-31,2016-05-09,76423831,0,76423831
19853,ALSO3,2016-06-30,2016-08-03,76423831,0,76423831
19854,ALSO3,2016-09-30,2016-11-03,76423831,0,76423831
19855,ALSO3,2016-12-31,2017-03-06,76423831,0,76423831
19856,ALSO3,2017-03-31,2017-05-11,76423831,0,76423831
19857,ALSO3,2017-06-30,2017-08-07,76423831,0,76423831
19858,ALSO3,2017-09-30,2017-11-08,76423831,0,76423831
19859,ALSO3,2017-12-31,2018-03-13,76423831,0,76423831
19860,ALSO3,2018-03-31,2018-05-09,76423831,0,76423831
19861,ALSO3,2018-06-30,2018-08-08,76423831,0,76423831
19862,ALSO3,2018-09-30,2018-11-06,76423831,0,76423831
19863,ALSO3,2018-12-31,2019-04-08,76423831,0,76423831
19864,ALSO3,2019-03-31,2019-05-14,76423831,0,76423831
19865,ALSO3,2019-06-30,2019-07-30,76423831,0,76423831
19866,ALSO3,2019-09-30,2019-11-13,238080470,0,238080470
19867,ALSO3,2019-12-31,2020-03-11,265772778,0,265772778
19868,ALSO3,2020-03-31,2020-05-20,265772778,0,265772778
19869,ALSO3,2020-06-30,2020-08-12,265785681,0,265785681
19870,ALSO3,2020-09-30,2020-11-11,265772778,0,265772778
19871,ALSO3,2020-12-31,2021-03-10,265772778,0,265772778
19872,SSBR3,2010-12-31,2011-05-10,531728,0,531728
19873,SSBR3,2011-03-31,2011-05-16,76423831,0,76423831
19874,SSBR3,2011-06-30,2011-08-10,76423831,0,76423831
19875,SSBR3,2011-09-30,2011-11-08,76423831,0,76423831
19876,SSBR3,2011-12-31,2012-04-12,76423831,0,76423831
19877,SSBR3,2012-03-31,2012-05-10,76423831,0,76423831
19878,SSBR3,2012-06-30,2012-08-09,76423831,0,76423831
19879,SSBR3,2012-09-30,2012-11-05,76423831,0,76423831
19880,SSBR3,2012-12-31,2013-03-07,76423831,0,76423831
19881,SSBR3,2013-03-31,2013-05-08,76423831,0,76423831
19882,SSBR3,2013-06-30,2013-08-07,76423831,0,76423831
19883,SSBR3,2013-09-30,2013-11-06,76423831,0,76423831
19884,SSBR3,2013-12-31,2014-03-13,76423831,0,76423831
19885,SSBR3,2014-03-31,2014-05-14,76423831,0,76423831
19886,SSBR3,2014-06-30,2014-08-13,76423831,0,76423831
19887,SSBR3,2014-09-30,2014-11-05,76423831,0,76423831
19888,SSBR3,2014-12-31,2015-03-04,76423831,0,76423831
19889,SSBR3,2015-03-31,2015-05-06,76423831,0,76423831
19890,SSBR3,2015-06-30,2015-08-05,76423831,0,76423831
19891,SSBR3,2015-09-30,2015-11-09,76423831,0,76423831
19892,SSBR3,2015-12-31,2016-03-03,76423831,0,76423831
19893,SSBR3,2016-03-31,2016-05-09,76423831,0,76423831
19894,SSBR3,2016-06-30,2016-08-03,76423831,0,76423831
19895,SSBR3,2016-09-30,2016-11-03,76423831,0,76423831
19896,SSBR3,2016-12-31,2017-03-06,76423831,0,76423831
19897,SSBR3,2017-03-31,2017-05-11,76423831,0,76423831
19898,SSBR3,2017-06-30,2017-08-07,76423831,0,76423831
19899,SSBR3,2017-09-30,2017-11-08,76423831,0,76423831
19900,SSBR3,2017-12-31,2018-03-13,76423831,0,76423831
19901,SSBR3,2018-03-31,2018-05-09,76423831,0,76423831
19902,SSBR3,2018-06-30,2018-08-08,76423831,0,76423831
19903,SSBR3,2018-09-30,2018-11-06,76423831,0,76423831
19904,SSBR3,2018-12-31,2019-04-08,76423831,0,76423831
19905,SSBR3,2019-03-31,2019-05-14,76423831,0,76423831
19906,SSBR3,2019-06-30,2019-07-30,76423831,0,76423831
19907,SSBR3,2019-09-30,2019-11-13,238080470,0,238080470
19908,SSBR3,2019-12-31,2020-03-11,265772778,0,265772778
19909,SSBR3,2020-03-31,2020-05-20,265772778,0,265772778
19910,SSBR3,2020-06-30,2020-08-12,265785681,0,265785681
19911,SSBR3,2020-09-30,2020-11-11,265772778,0,265772778
19912,SSBR3,2020-12-31,2021-03-10,265772778,0,265772778
19913,ENAT3,2010-12-31,2011-05-13,62021962,0,62021962
19914,ENAT3,2011-03-31,2011-05-12,265806905,0,265806905
19915,ENAT3,2011-06-30,2011-08-10,265806905,0,265806905
19916,ENAT3,2011-09-30,2011-11-09,265806905,0,265806905
19917,ENAT3,2011-12-31,2012-03-14,265806905,0,265806905
19918,ENAT3,2012-03-31,2012-05-09,265806905,0,265806905
19919,ENAT3,2012-06-30,2012-08-15,265806905,0,265806905
19920,ENAT3,2012-09-30,2012-11-08,265806905,0,265806905
19921,ENAT3,2012-12-31,2013-03-13,265806905,0,265806905
19922,ENAT3,2013-03-31,2013-05-08,265806905,0,265806905
19923,ENAT3,2013-06-30,2013-08-07,265806905,0,265806905
19924,ENAT3,2013-09-30,2013-11-06,265806905,0,265806905
19925,ENAT3,2013-12-31,2014-02-26,265806905,0,265806905
19926,ENAT3,2014-03-31,2014-05-07,265806905,0,265806905
19927,ENAT3,2014-06-30,2014-08-13,265806905,0,265806905
19928,ENAT3,2014-09-30,2014-11-12,265806905,0,265806905
19929,ENAT3,2014-12-31,2015-03-16,265806905,0,265806905
19930,ENAT3,2015-03-31,2016-03-10,265806905,0,265806905
19931,ENAT3,2015-06-30,2016-03-10,265806905,0,265806905
19932,ENAT3,2015-09-30,2016-03-10,265806905,0,265806905
19933,ENAT3,2015-12-31,2016-03-10,265806905,0,265806905
19934,ENAT3,2016-03-31,2016-05-11,265806905,0,265806905
19935,ENAT3,2016-06-30,2016-08-10,265806905,0,265806905
19936,ENAT3,2016-09-30,2016-11-09,265806905,0,265806905
19937,ENAT3,2016-12-31,2017-03-15,265806905,0,265806905
19938,ENAT3,2017-03-31,2017-05-10,265806905,0,265806905
19939,ENAT3,2017-06-30,2017-08-10,265806905,0,265806905
19940,ENAT3,2017-09-30,2017-11-08,265806905,0,265806905
19941,ENAT3,2017-12-31,2018-03-08,265806905,0,265806905
19942,ENAT3,2018-03-31,2018-05-09,265806805,0,265806805
19943,ENAT3,2018-06-30,2018-08-08,265806905,0,265806905
19944,ENAT3,2018-09-30,2018-11-12,265806905,0,265806905
19945,ENAT3,2018-12-31,2019-03-18,265806905,0,265806905
19946,ENAT3,2019-03-31,2019-05-08,265806905,0,265806905
19947,ENAT3,2019-06-30,2019-08-07,265806905,0,265806905
19948,ENAT3,2019-09-30,2019-11-11,265806905,0,265806905
19949,ENAT3,2019-12-31,2020-03-11,265806905,0,265806905
19950,ENAT3,2020-03-31,2020-05-14,265806905,0,265806905
19951,ENAT3,2020-06-30,2020-08-05,265806905,0,265806905
19952,ENAT3,2020-09-30,2020-11-11,265806905,0,265806905
19953,QGEP3,2010-12-31,2011-05-13,62021962,0,62021962
19954,QGEP3,2011-03-31,2011-05-12,265806905,0,265806905
19955,QGEP3,2011-06-30,2011-08-10,265806905,0,265806905
19956,QGEP3,2011-09-30,2011-11-09,265806905,0,265806905
19957,QGEP3,2011-12-31,2012-03-14,265806905,0,265806905
19958,QGEP3,2012-03-31,2012-05-09,265806905,0,265806905
19959,QGEP3,2012-06-30,2012-08-15,265806905,0,265806905
19960,QGEP3,2012-09-30,2012-11-08,265806905,0,265806905
19961,QGEP3,2012-12-31,2013-03-13,265806905,0,265806905
19962,QGEP3,2013-03-31,2013-05-08,265806905,0,265806905
19963,QGEP3,2013-06-30,2013-08-07,265806905,0,265806905
19964,QGEP3,2013-09-30,2013-11-06,265806905,0,265806905
19965,QGEP3,2013-12-31,2014-02-26,265806905,0,265806905
19966,QGEP3,2014-03-31,2014-05-07,265806905,0,265806905
19967,QGEP3,2014-06-30,2014-08-13,265806905,0,265806905
19968,QGEP3,2014-09-30,2014-11-12,265806905,0,265806905
19969,QGEP3,2014-12-31,2015-03-16,265806905,0,265806905
19970,QGEP3,2015-03-31,2016-03-10,265806905,0,265806905
19971,QGEP3,2015-06-30,2016-03-10,265806905,0,265806905
19972,QGEP3,2015-09-30,2016-03-10,265806905,0,265806905
19973,QGEP3,2015-12-31,2016-03-10,265806905,0,265806905
19974,QGEP3,2016-03-31,2016-05-11,265806905,0,265806905
19975,QGEP3,2016-06-30,2016-08-10,265806905,0,265806905
19976,QGEP3,2016-09-30,2016-11-09,265806905,0,265806905
19977,QGEP3,2016-12-31,2017-03-15,265806905,0,265806905
19978,QGEP3,2017-03-31,2017-05-10,265806905,0,265806905
19979,QGEP3,2017-06-30,2017-08-10,265806905,0,265806905
19980,QGEP3,2017-09-30,2017-11-08,265806905,0,265806905
19981,QGEP3,2017-12-31,2018-03-08,265806905,0,265806905
19982,QGEP3,2018-03-31,2018-05-09,265806805,0,265806805
19983,QGEP3,2018-06-30,2018-08-08,265806905,0,265806905
19984,QGEP3,2018-09-30,2018-11-12,265806905,0,265806905
19985,QGEP3,2018-12-31,2019-03-18,265806905,0,265806905
19986,QGEP3,2019-03-31,2019-05-08,265806905,0,265806905
19987,QGEP3,2019-06-30,2019-08-07,265806905,0,265806905
19988,QGEP3,2019-09-30,2019-11-11,265806905,0,265806905
19989,QGEP3,2019-12-31,2020-03-11,265806905,0,265806905
19990,QGEP3,2020-03-31,2020-05-14,265806905,0,265806905
19991,QGEP3,2020-06-30,2020-08-05,265806905,0,265806905
19992,QGEP3,2020-09-30,2020-11-11,265806905,0,265806905
19993,SHOW3,2010-12-31,2011-04-13,57466,0,57466
19994,SHOW3,2011-03-31,2011-05-13,57466,0,57466
19995,SHOW3,2011-06-30,2011-08-12,69190,0,69190
19996,SHOW3,2011-09-30,2011-11-07,69290,0,69290
19997,SHOW3,2011-12-31,2012-02-16,69290,0,69290
19998,SHOW3,2012-03-31,2012-05-10,69290,0,69290
19999,SHOW3,2012-06-30,2012-08-08,69290,0,69290
20000,SHOW3,2012-09-30,2012-11-08,69791,0,69791
20001,SHOW3,2012-12-31,2013-02-21,69791,0,69791
20002,SHOW3,2013-03-31,2013-05-09,69791,0,69791
20003,SHOW3,2013-06-30,2013-08-08,69791,0,69791
20004,SHOW3,2013-09-30,2013-11-07,69791,0,69791
20005,SHOW3,2013-12-31,2014-02-25,69791,0,69791
20006,SHOW3,2014-03-31,2014-08-08,69791,0,69791
20007,SHOW3,2014-06-30,2014-08-08,69791,0,69791
20008,SHOW3,2014-09-30,2014-11-06,69791,0,69791
20009,SHOW3,2014-12-31,2015-03-02,67949,0,67949
20010,SHOW3,2015-03-31,2015-05-11,67500,0,67500
20011,SHOW3,2015-06-30,2015-08-10,69728,0,69728
20012,SHOW3,2015-09-30,2015-11-09,67501,0,67501
20013,SHOW3,2015-12-31,2016-04-07,67501,0,67501
20014,SHOW3,2016-03-31,2016-05-11,67501,0,67501
20015,SHOW3,2016-06-30,2016-08-10,67501,0,67501
20016,SHOW3,2016-09-30,2017-03-09,67501,0,67501
20017,SHOW3,2016-12-31,2017-03-08,67501,0,67501
20018,SHOW3,2017-03-31,2017-05-10,67501,0,67501
20019,SHOW3,2017-06-30,2017-08-10,67501,0,67501
20020,SHOW3,2017-09-30,2017-11-08,67501,0,67501
20021,SHOW3,2017-12-31,2018-04-11,67501,0,67501
20022,SHOW3,2018-03-31,2018-05-09,67501,0,67501
20023,SHOW3,2018-06-30,2018-08-08,67501,0,67501
20024,SHOW3,2018-09-30,2018-11-07,67501,0,67501
20025,SHOW3,2018-12-31,2019-03-01,67501,0,67501
20026,SHOW3,2019-03-31,2019-05-08,67501,0,67501
20027,SHOW3,2019-06-30,2019-08-07,67501,0,67501
20028,SHOW3,2019-09-30,2019-11-06,67501,0,67501
20029,SHOW3,2019-12-31,2020-03-11,67501,0,67501
20030,SHOW3,2020-03-31,2020-05-15,67501,0,67501
20031,SHOW3,2020-06-30,2020-08-12,67501,0,67501
20032,SHOW3,2020-09-30,2020-11-11,67413,0,67413
20033,MGLU3,2010-12-31,2011-05-05,150000,0,150000
20034,MGLU3,2011-03-31,2011-05-16,150000,0,150000
20035,MGLU3,2011-06-30,2011-08-15,186494,0,186494
20036,MGLU3,2011-09-30,2011-11-16,186494,0,186494
20037,MGLU3,2011-12-31,2012-04-04,186494,0,186494
20038,MGLU3,2012-03-31,2012-05-14,186494,0,186494
20039,MGLU3,2012-06-30,2012-08-14,186494467,0,186494467
20040,MGLU3,2012-09-30,2012-11-12,186494,0,186494
20041,MGLU3,2012-12-31,2013-03-26,186494,0,186494
20042,MGLU3,2013-03-31,2013-05-13,186494,0,186494
20043,MGLU3,2013-06-30,2013-08-12,186494,0,186494
20044,MGLU3,2013-09-30,2013-10-31,186494,0,186494
20045,MGLU3,2013-12-31,2014-02-24,186494,0,186494
20046,MGLU3,2014-03-31,2014-05-08,186494467,0,186494467
20047,MGLU3,2014-06-30,2014-07-31,181494467,0,181494467
20048,MGLU3,2014-09-30,2014-10-30,181494467,0,181494467
20049,MGLU3,2014-12-31,2015-02-26,181494467,0,181494467
20050,MGLU3,2015-03-31,2015-05-07,181494467,0,181494467
20051,MGLU3,2015-06-30,2015-07-30,177991467,0,177991467
20052,MGLU3,2015-09-30,2015-11-09,22248933,0,22248933
20053,MGLU3,2015-12-31,2017-05-31,22248933,0,22248933
20054,MGLU3,2016-03-31,2016-05-05,22248933,0,22248933
20055,MGLU3,2016-06-30,2016-08-03,21623933,0,21623933
20056,MGLU3,2016-09-30,2016-10-31,21623933,0,21623933
20057,MGLU3,2016-12-31,2017-05-31,21623933,0,21623933
20058,MGLU3,2017-03-31,2017-05-31,21623933,0,21623933
20059,MGLU3,2017-06-30,2017-09-12,172991464,0,172991464
20060,MGLU3,2017-09-30,2017-10-31,190591464,0,190591464
20061,MGLU3,2017-12-31,2018-02-22,190591464,0,190591464
20062,MGLU3,2018-03-31,2018-05-07,190591494,0,190591494
20063,MGLU3,2018-06-30,2018-08-06,190591464,0,190591464
20064,MGLU3,2018-09-30,2018-11-05,190591464,0,190591464
20065,MGLU3,2018-12-31,2019-02-25,190591464,0,190591464
20066,MGLU3,2019-03-31,2019-05-06,190591464,0,190591464
20067,MGLU3,2019-06-30,2019-08-12,1524731712,0,1524731712
20068,MGLU3,2019-09-30,2019-10-29,1524731712,0,1524731712
20069,MGLU3,2019-12-31,2020-02-17,1624731712,0,1624731712
20070,MGLU3,2020-03-31,2020-05-25,1624731712,0,1624731712
20071,MGLU3,2020-06-30,2020-08-17,1624731712,0,1624731712
20072,MGLU3,2020-09-30,2020-11-09,6498926848,0,6498926848
20073,MGLU3,2020-12-31,2021-03-08,6498926848,0,6498926848
20074,QUAL3,2010-12-31,2011-06-22,1614883,0,1614883
20075,QUAL3,2011-03-31,2011-06-22,1614883,0,1614883
20076,QUAL3,2011-06-30,2011-08-15,258631234,0,258631234
20077,QUAL3,2011-09-30,2011-11-18,258631234,0,258631234
20078,QUAL3,2011-12-31,2012-02-27,260083463,0,260083463
20079,QUAL3,2012-03-31,2012-05-15,260083463,0,260083463
20080,QUAL3,2012-06-30,2012-08-13,263142831,0,263142831
20081,QUAL3,2012-09-30,2012-11-13,263329770,0,263329770
20082,QUAL3,2012-12-31,2013-03-27,263401198,0,263401198
20083,QUAL3,2013-03-31,2013-05-15,264115480,0,264115480
20084,QUAL3,2013-06-30,2013-08-12,265995495,0,265995495
20085,QUAL3,2013-09-30,2013-11-13,266209780,0,266209780
20086,QUAL3,2013-12-31,2014-03-17,266602637,0,266602637
20087,QUAL3,2014-03-31,2014-05-13,266602637,0,266602637
20088,QUAL3,2014-06-30,2014-08-14,267984987,0,267984987
20089,QUAL3,2014-09-30,2014-11-13,273387588,0,273387588
20090,QUAL3,2014-12-31,2015-03-26,273412588,0,273412588
20091,QUAL3,2015-03-31,2015-05-14,273662588,0,273662588
20092,QUAL3,2015-06-30,2015-08-13,274325088,0,274325088
20093,QUAL3,2015-09-30,2015-11-12,274325088,0,274325088
20094,QUAL3,2015-12-31,2016-03-29,274325088,0,274325088
20095,QUAL3,2016-03-31,2016-05-11,274325088,0,274325088
20096,QUAL3,2016-06-30,2016-08-01,274325088,0,274325088
20097,QUAL3,2016-09-30,2016-11-07,278794088,0,278794088
20098,QUAL3,2016-12-31,2017-03-20,278794088,0,278794088
20099,QUAL3,2017-03-31,2017-05-11,278794088,0,278794088
20100,QUAL3,2017-06-30,2017-08-14,285491088,0,285491088
20101,QUAL3,2017-09-30,2017-11-07,288332588,0,288332588
20102,QUAL3,2017-12-31,2018-03-15,288967088,0,288967088
20103,QUAL3,2018-03-31,2018-05-10,282176825,0,282176825
20104,QUAL3,2018-06-30,2018-08-14,283176825,0,283176825
20105,QUAL3,2018-09-30,2018-11-09,283176825,0,283176825
20106,QUAL3,2018-12-31,2019-03-25,283176825,0,283176825
20107,QUAL3,2019-03-31,2019-05-09,283176825,0,283176825
20108,QUAL3,2019-06-30,2019-08-13,283239325,0,283239325
20109,QUAL3,2019-09-30,2019-11-13,283339225,0,283339225
20110,QUAL3,2019-12-31,2020-03-12,284014325,0,284014325
20111,QUAL3,2020-03-31,2020-05-07,284014325,0,284014325
20112,QUAL3,2020-06-30,2020-08-25,284014325,0,284014325
20113,QUAL3,2020-09-30,2020-11-24,284014325,0,284014325
20114,BPHA3,2010-12-31,2011-06-30,73950000,0,73950000
20115,BPHA3,2011-03-31,2012-05-04,334008405,0,334008405
20116,BPHA3,2011-06-30,2012-05-04,79849579,0,79849579
20117,BPHA3,2011-09-30,2012-05-04,79849579,0,79849579
20118,BPHA3,2011-12-31,2012-03-19,159699158,0,159699158
20119,BPHA3,2012-03-31,2012-06-03,183711518,0,183711518
20120,BPHA3,2012-06-30,2012-08-15,230173719,0,230173719
20121,BPHA3,2012-09-30,2012-11-13,254649970,0,254649970
20122,BPHA3,2012-12-31,2013-10-10,254649970,0,254649970
20123,BPHA3,2013-03-31,2013-05-15,254649970,0,254649970
20124,BPHA3,2013-06-30,2013-10-10,256384419,0,256384419
20125,BPHA3,2013-09-30,2013-11-14,256384419,0,256384419
20126,BPHA3,2013-12-31,2016-01-22,256384419,0,256384419
20127,BPHA3,2014-03-31,2014-05-15,256384419,0,256384419
20128,BPHA3,2014-06-30,2014-08-13,363051086,0,363051086
20129,BPHA3,2014-09-30,2014-11-12,363051086,0,363051086
20130,BPHA3,2014-12-31,2015-03-25,363051086,0,363051086
20131,BPHA3,2015-03-31,2015-05-13,363051086,0,363051086
20132,BPHA3,2015-06-30,2015-08-12,363051086,0,363051086
20133,BPHA3,2015-09-30,2015-11-12,363051086,0,363051086
20134,BPHA3,2015-12-31,2016-03-23,7261021,0,7261021
20135,BPHA3,2016-03-31,2016-05-11,113081127,0,113081127
20136,BPHA3,2016-06-30,2016-08-10,113081127,0,113081127
20137,BPHA3,2016-09-30,2016-11-09,113081127,0,113081127
20138,BPHA3,2016-12-31,2017-03-23,113081127,0,113081127
20139,BPHA3,2017-03-31,2017-05-10,113081127,0,113081127
20140,BPHA3,2017-06-30,2017-08-10,113081127,0,113081127
20141,BPHA3,2017-09-30,2017-11-16,113081127,0,113081127
20142,BPHA3,2017-12-31,2018-03-29,113081127,0,113081127
20143,BPHA3,2018-03-31,2018-06-19,113081127,0,113081127
20144,BPHA3,2018-06-30,2018-10-05,113081027,0,113081027
20145,BPHA3,2018-09-30,2018-11-13,113081027,0,113081027
20146,BPHA3,2018-12-31,2019-03-29,113081127,0,113081127
20147,BPHA3,2019-03-31,2019-05-22,113081127,0,113081127
20148,TECN3,2010-12-31,2011-06-30,128591827,0,128591827
20149,TECN3,2011-03-31,2011-06-30,128591827,0,128591827
20150,TECN3,2011-06-30,2011-08-10,65229260,0,65229260
20151,TECN3,2011-09-30,2011-11-09,76175206,0,76175206
20152,TECN3,2011-12-31,2012-03-26,76175206,0,76175206
20153,TECN3,2012-03-31,2012-05-09,76175206,0,76175206
20154,TECN3,2012-06-30,2012-08-10,77094076,0,77094076
20155,TECN3,2012-09-30,2012-11-12,77183412,0,77183412
20156,TECN3,2012-12-31,2013-08-30,77183412,0,77183412
20157,TECN3,2013-03-31,2013-05-15,77183412,0,77183412
20158,TECN3,2013-06-30,2013-09-12,77636196,0,77636196
20159,TECN3,2013-09-30,2013-11-27,77636196,0,77636196
20160,TECN3,2013-12-31,2014-03-20,77636196,0,77636196
20161,TECN3,2014-03-31,2014-04-29,77749055,0,77749055
20162,TECN3,2014-06-30,2014-07-31,77964577,0,77964577
20163,TECN3,2014-09-30,2014-10-30,78506215,0,78506215
20164,TECN3,2014-12-31,2015-02-26,78506215,0,78506215
20165,TECN3,2015-03-31,2015-04-29,78506215,0,78506215
20166,TECN3,2015-06-30,2015-07-30,78506215,0,78506215
20167,TECN3,2015-09-30,2015-10-29,78506215,0,78506215
20168,TECN3,2015-12-31,2016-02-29,78506215,0,78506215
20169,TECN3,2016-03-31,2016-04-28,78506215,0,78506215
20170,TECN3,2016-06-30,2016-07-28,78506215,0,78506215
20171,TECN3,2016-09-30,2016-10-27,78506215,0,78506215
20172,TECN3,2016-12-31,2017-02-23,78506215,0,78506215
20173,TECN3,2017-03-31,2017-05-11,78506215,0,78506215
20174,TECN3,2017-06-30,2017-07-27,78506215,0,78506215
20175,TECN3,2017-09-30,2017-10-26,78506215,0,78506215
20176,TECN3,2017-12-31,2018-03-27,78506215,0,78506215
20177,TECN3,2018-03-31,2018-05-08,78506215,0,78506215
20178,TECN3,2018-06-30,2018-08-14,78506215,0,78506215
20179,TECN3,2018-09-30,2018-11-22,78506215,0,78506215
20180,TECN3,2018-12-31,2019-03-29,78506215,0,78506215
20181,TECN3,2019-03-31,2019-04-26,78506215,0,78506215
20182,TECN3,2019-06-30,2019-08-13,78506215,0,78506215
20183,TECN3,2019-09-30,2019-11-11,78506215,0,78506215
20184,TECN3,2019-12-31,2020-04-01,78506215,0,78506215
20185,TECN3,2020-03-31,2020-06-29,78506215,0,78506215
20186,TECN3,2020-06-30,2020-08-31,78506215,0,78506215
20187,TECN3,2020-09-30,2020-12-29,78506215,0,78506215
20188,TECN3,2020-12-31,2021-03-18,78506215,0,78506215
20189,SEDU3,2010-12-31,2013-04-11,169683477,169683477,339366954
20190,SEDU3,2011-03-31,2011-08-26,169683476,169683477,339366953
20191,SEDU3,2011-06-30,2011-08-15,105647572,65153374,170800946
20192,SEDU3,2011-09-30,2011-11-14,124204274,102266778,226471052
20193,SEDU3,2011-12-31,2012-03-30,124204274,102266778,226471052
20194,SEDU3,2012-03-31,2012-05-11,124204274,102266778,226471052
20195,SEDU3,2012-06-30,2012-08-14,124204274,102266778,226471052
20196,SEDU3,2012-09-30,2012-11-13,124204274,102266778,226471052
20197,SEDU3,2012-12-31,2013-04-16,124390519,102639268,227029787
20198,SEDU3,2013-03-31,2013-05-13,124390519,102639268,227029787
20199,SEDU3,2013-06-30,2013-08-12,135562357,124982944,260545301
20200,SEDU3,2013-09-30,2013-11-13,135799807,125457844,261257651
20201,SEDU3,2013-12-31,2014-02-27,135799807,125457844,261257651
20202,SEDU3,2014-03-31,2014-05-12,135799807,125457844,261257651
20203,SEDU3,2014-06-30,2014-08-11,135799807,125457844,261257651
20204,SEDU3,2014-09-30,2014-11-10,261257651,0,261257651
20205,SEDU3,2014-12-31,2015-05-12,261257651,0,261257651
20206,SEDU3,2015-03-31,2015-05-11,261257651,0,261257651
20207,SEDU3,2015-06-30,2015-08-14,261257651,0,261257651
20208,SEDU3,2015-09-30,2015-11-13,261257651,0,261257651
20209,SEDU3,2015-12-31,2016-03-29,261257651,0,261257651
20210,SEDU3,2016-03-31,2016-05-13,261257651,0,261257651
20211,SEDU3,2016-06-30,2016-08-15,261257651,0,261257651
20212,SEDU3,2016-09-30,2016-11-11,261257651,0,261257651
20213,SEDU3,2016-12-31,2017-03-28,261257651,0,261257651
20214,SEDU3,2017-03-31,2017-05-15,262128900,0,262128900
20215,SEDU3,2017-06-30,2017-08-14,262198900,0,262198900
20216,SEDU3,2017-09-30,2017-11-10,262128900,0,262128900
20217,SEDU3,2017-12-31,2018-02-21,262128900,0,262128900
20218,SEDU3,2018-03-31,2018-05-14,262128900,0,262128900
20219,SEDU3,2018-06-30,2018-08-14,262128900,0,262128900
20220,SEDU3,2018-09-30,2018-11-09,262128900,0,262128900
20221,SEDU3,2018-12-31,2019-03-29,262128900,0,262128900
20222,SEDU3,2019-03-31,2019-05-15,262128900,0,262128900
20223,STKF3,2010-12-31,2011-09-22,100000000,0,100000000
20224,STKF3,2011-03-31,2011-09-22,100000000,0,100000000
20225,STKF3,2011-06-30,2011-09-22,100000000,0,100000000
20226,STKF3,2011-09-30,2011-12-15,100000000,0,100000000
20227,STKF3,2011-12-31,2012-11-30,100000000,0,100000000
20228,STKF3,2012-03-31,2012-05-16,107439555,0,107439555
20229,STKF3,2012-06-30,2012-08-15,107439555,0,107439555
20230,STKF3,2012-09-30,2013-01-07,107439555,0,107439555
20231,STKF3,2012-12-31,2013-04-12,107439555,0,107439555
20232,STKF3,2013-03-31,2013-06-18,107439555,0,107439555
20233,STKF3,2013-06-30,2013-08-14,107439555,0,107439555
20234,STKF3,2013-09-30,2013-11-14,107439555,0,107439555
20235,STKF3,2013-12-31,2014-05-08,117001722,0,117001722
20236,STKF3,2014-03-31,2014-05-15,117001722,0,117001722
20237,STKF3,2014-06-30,2014-08-14,117001722,0,117001722
20238,STKF3,2014-09-30,2014-11-14,117001722,0,117001722
20239,STKF3,2014-12-31,2015-03-20,117001722,0,117001722
20240,STKF3,2015-03-31,2015-04-30,117001722,0,117001722
20241,STKF3,2015-06-30,2015-08-12,123120677,0,123120677
20242,STKF3,2015-09-30,2015-11-04,143347224,0,143347224
20243,STKF3,2015-12-31,2016-05-20,143347224,0,143347224
20244,STKF3,2016-03-31,2016-06-02,143347224,0,143347224
20245,STKF3,2016-06-30,2016-08-11,143347224,0,143347224
20246,STKF3,2016-09-30,2016-11-10,143347224,0,143347224
20247,STKF3,2016-12-31,2017-03-13,143347224,0,143347224
20248,STKF3,2017-03-31,2017-05-09,143347224,0,143347224
20249,STKF3,2017-06-30,2017-09-12,143347224,0,143347224
20250,STKF3,2017-09-30,2017-11-14,143347224,0,143347224
20251,STKF3,2017-12-31,2018-03-14,143347224,0,143347224
20252,STKF3,2018-03-31,2018-05-14,143347224,0,143347224
20253,STKF3,2018-06-30,2018-08-13,143347224,0,143347224
20254,STKF3,2018-09-30,2018-11-09,143347224,0,143347224
20255,STKF3,2018-12-31,2019-03-13,218370694,0,218370694
20256,STKF3,2019-03-31,2019-05-15,218370694,0,218370694
20257,STKF3,2019-06-30,2019-08-14,218370694,0,218370694
20258,STKF3,2019-09-30,2019-11-13,218370694,0,218370694
20259,STKF3,2019-12-31,2020-03-17,218370694,0,218370694
20260,STKF3,2020-03-31,2020-05-14,218370694,0,218370694
20261,STKF3,2020-06-30,2020-08-13,218370694,0,218370694
20262,STKF3,2020-09-30,2020-11-12,218370694,0,218370694
20263,STKF3,2020-12-31,2021-03-18,218370694,0,218370694
20264,PGMN3,2010-12-31,2011-10-26,50000000,0,50000000
20265,PGMN3,2011-03-31,2011-10-26,150000000,0,150000000
20266,PGMN3,2011-06-30,2011-10-26,150000000,0,150000000
20267,PGMN3,2011-09-30,2011-11-14,150000000,0,150000000
20268,PGMN3,2011-12-31,2012-03-30,150000000,0,150000000
20269,PGMN3,2012-03-31,2012-05-19,140000000,0,140000000
20270,PGMN3,2012-06-30,2012-08-30,300000000,0,300000000
20271,PGMN3,2012-09-30,2012-11-14,300000000,0,300000000
20272,PGMN3,2012-12-31,2013-03-27,300000000,0,300000000
20273,PGMN3,2013-03-31,2013-05-15,300000000,0,300000000
20274,PGMN3,2013-06-30,2013-08-14,300000000,0,300000000
20275,PGMN3,2013-09-30,2013-11-14,300000000,0,300000000
20276,PGMN3,2013-12-31,2014-03-28,300000000,0,300000000
20277,PGMN3,2014-03-31,2014-05-15,300000000,0,300000000
20278,PGMN3,2014-06-30,2014-08-14,300000000,0,300000000
20279,PGMN3,2014-09-30,2014-11-13,300000,0,300000
20280,PGMN3,2014-12-31,2015-03-31,300000,0,300000
20281,PGMN3,2015-03-31,2015-05-14,300000000,0,300000000
20282,PGMN3,2015-06-30,2015-08-24,300000000,0,300000000
20283,PGMN3,2015-09-30,2017-03-24,300000000,0,300000000
20284,PGMN3,2015-12-31,2017-03-24,300000,0,300000
20285,PGMN3,2016-03-31,2017-03-24,300000000,0,300000000
20286,PGMN3,2016-06-30,2017-03-24,342726580,0,342726580
20287,PGMN3,2016-09-30,2016-11-14,342726580,0,342726580
20288,PGMN3,2016-12-31,2017-03-30,342726580,0,342726580
20289,PGMN3,2017-03-31,2017-05-12,342726580,0,342726580
20290,PGMN3,2017-06-30,2017-08-11,342726580,0,342726580
20291,PGMN3,2017-09-30,2017-11-14,342726580,0,342726580
20292,PGMN3,2017-12-31,2018-07-04,342726580,0,342726580
20293,PGMN3,2018-03-31,2018-05-14,342726580,0,342726580
20294,PGMN3,2018-06-30,2018-08-14,342726580,0,342726580
20295,PGMN3,2018-09-30,2018-11-09,342726580,0,342726580
20296,PGMN3,2018-12-31,2020-06-25,342726580,0,342726580
20297,PGMN3,2019-03-31,2019-05-16,342726580,0,342726580
20298,PGMN3,2019-06-30,2019-08-14,342726580,0,342726580
20299,PGMN3,2019-09-30,2019-11-14,342726580,0,342726580
20300,PGMN3,2019-12-31,2020-07-27,342726580,0,342726580
20301,PGMN3,2020-03-31,2020-06-25,342726580,0,342726580
20302,PGMN3,2020-06-30,2020-07-27,342726580,0,342726580
20303,PGMN3,2020-09-30,2020-10-30,430600043,0,430600043
20304,PGMN3,2020-12-31,2021-03-02,443781062,0,443781062
20305,BPAC11,2010-12-31,2011-11-14,1200160000,1199840000,2400000000
20306,BPAC11,2011-03-31,2011-11-14,1200160000,1199840000,2400000000
20307,BPAC11,2011-06-30,2012-02-07,1200160000,1199840000,2400000000
20308,BPAC11,2011-09-30,2011-12-12,1200160000,1199840000,2400000000
20309,BPAC11,2011-12-31,2012-04-03,2400000,0,2400000
20310,BPAC11,2012-03-31,2012-05-11,1200160000,1199840000,2400000000
20311,BPAC11,2012-06-30,2012-08-09,1368504000,1279896000,2648400000
20312,BPAC11,2012-09-30,2012-11-06,1368504000,1279896000,2648400000
20313,BPAC11,2012-12-31,2013-02-19,1390671404,1324230808,2714902212
20314,BPAC11,2013-03-31,2013-05-07,1390671404,1324230808,2714902212
20315,BPAC11,2013-06-30,2013-08-06,1390671404,1324230808,2714902212
20316,BPAC11,2013-09-30,2013-11-05,1390671404,1324230808,2714902212
20317,BPAC11,2013-12-31,2014-02-19,1390671404,1324230808,2714902212
20318,BPAC11,2014-03-31,2014-05-06,1390671404,1324230808,2714902212
20319,BPAC11,2014-06-30,2014-08-05,1390671404,1324230808,2714902212
20320,BPAC11,2014-09-30,2014-11-04,1390671404,1324230808,2714902212
20321,BPAC11,2014-12-31,2015-02-25,1390671404,1324230808,2714902212
20322,BPAC11,2015-03-31,2015-05-06,1390671404,1324230808,2714902212
20323,BPAC11,2015-06-30,2015-08-05,1390671404,1324230808,2714902212
20324,BPAC11,2015-09-30,2015-11-04,1424305814,1391499628,2815805442
20325,BPAC11,2015-12-31,2016-03-30,1404405002,1351698004,2756103006
20326,BPAC11,2016-03-31,2016-05-11,1384479472,1311847544,2696327016
20327,BPAC11,2016-06-30,2016-08-09,1384479772,1311847544,2696327316
20328,BPAC11,2016-09-30,2016-11-08,1352401464,2065217411,3417618875
20329,BPAC11,2016-12-31,2017-03-31,1352401604,2065217271,3417618875
20330,BPAC11,2017-03-31,2017-05-10,1778353202,1000112209,2778465411
20331,BPAC11,2017-06-30,2017-08-29,1762281522,967968849,2730250371
20332,BPAC11,2017-09-30,2017-11-08,1746065322,935536450,2681601772
20333,BPAC11,2017-12-31,2018-12-28,1746065322,935536450,2681601772
20334,BPAC11,2018-03-31,2018-05-17,1746065322,935536450,2681601772
20335,BPAC11,2018-06-30,2018-08-07,1746065322,935536450,2681601772
20336,BPAC11,2018-09-30,2018-11-05,1746065322,935536450,2681601772
20337,BPAC11,2018-12-31,2019-03-29,1731276922,905959650,2637236572
20338,BPAC11,2019-03-31,2019-05-09,1731276922,905959650,2637236572
20339,BPAC11,2019-06-30,2019-08-13,1731276922,905959650,2637236572
20340,BPAC11,2019-09-30,2019-11-05,1731276922,905959650,2637236572
20341,BPAC11,2019-12-31,2020-06-26,1731276922,905959650,2637236572
20342,BPAC11,2020-03-31,2020-06-05,1731276922,905959650,2637236572
20343,BPAC11,2020-06-30,2020-08-11,1756433722,956273250,2712706972
20344,BPAC11,2020-09-30,2020-11-10,1756433722,956273250,2712706972
20345,BPAC11,2020-12-31,2021-02-09,1756433722,956273250,2712706972
20346,BPAC3,2010-12-31,2011-11-14,1200160000,1199840000,2400000000
20347,BPAC3,2011-03-31,2011-11-14,1200160000,1199840000,2400000000
20348,BPAC3,2011-06-30,2012-02-07,1200160000,1199840000,2400000000
20349,BPAC3,2011-09-30,2011-12-12,1200160000,1199840000,2400000000
20350,BPAC3,2011-12-31,2012-04-03,2400000,0,2400000
20351,BPAC3,2012-03-31,2012-05-11,1200160000,1199840000,2400000000
20352,BPAC3,2012-06-30,2012-08-09,1368504000,1279896000,2648400000
20353,BPAC3,2012-09-30,2012-11-06,1368504000,1279896000,2648400000
20354,BPAC3,2012-12-31,2013-02-19,1390671404,1324230808,2714902212
20355,BPAC3,2013-03-31,2013-05-07,1390671404,1324230808,2714902212
20356,BPAC3,2013-06-30,2013-08-06,1390671404,1324230808,2714902212
20357,BPAC3,2013-09-30,2013-11-05,1390671404,1324230808,2714902212
20358,BPAC3,2013-12-31,2014-02-19,1390671404,1324230808,2714902212
20359,BPAC3,2014-03-31,2014-05-06,1390671404,1324230808,2714902212
20360,BPAC3,2014-06-30,2014-08-05,1390671404,1324230808,2714902212
20361,BPAC3,2014-09-30,2014-11-04,1390671404,1324230808,2714902212
20362,BPAC3,2014-12-31,2015-02-25,1390671404,1324230808,2714902212
20363,BPAC3,2015-03-31,2015-05-06,1390671404,1324230808,2714902212
20364,BPAC3,2015-06-30,2015-08-05,1390671404,1324230808,2714902212
20365,BPAC3,2015-09-30,2015-11-04,1424305814,1391499628,2815805442
20366,BPAC3,2015-12-31,2016-03-30,1404405002,1351698004,2756103006
20367,BPAC3,2016-03-31,2016-05-11,1384479472,1311847544,2696327016
20368,BPAC3,2016-06-30,2016-08-09,1384479772,1311847544,2696327316
20369,BPAC3,2016-09-30,2016-11-08,1352401464,2065217411,3417618875
20370,BPAC3,2016-12-31,2017-03-31,1352401604,2065217271,3417618875
20371,BPAC3,2017-03-31,2017-05-10,1778353202,1000112209,2778465411
20372,BPAC3,2017-06-30,2017-08-29,1762281522,967968849,2730250371
20373,BPAC3,2017-09-30,2017-11-08,1746065322,935536450,2681601772
20374,BPAC3,2017-12-31,2018-12-28,1746065322,935536450,2681601772
20375,BPAC3,2018-03-31,2018-05-17,1746065322,935536450,2681601772
20376,BPAC3,2018-06-30,2018-08-07,1746065322,935536450,2681601772
20377,BPAC3,2018-09-30,2018-11-05,1746065322,935536450,2681601772
20378,BPAC3,2018-12-31,2019-03-29,1731276922,905959650,2637236572
20379,BPAC3,2019-03-31,2019-05-09,1731276922,905959650,2637236572
20380,BPAC3,2019-06-30,2019-08-13,1731276922,905959650,2637236572
20381,BPAC3,2019-09-30,2019-11-05,1731276922,905959650,2637236572
20382,BPAC3,2019-12-31,2020-06-26,1731276922,905959650,2637236572
20383,BPAC3,2020-03-31,2020-06-05,1731276922,905959650,2637236572
20384,BPAC3,2020-06-30,2020-08-11,1756433722,956273250,2712706972
20385,BPAC3,2020-09-30,2020-11-10,1756433722,956273250,2712706972
20386,BPAC3,2020-12-31,2021-02-09,1756433722,956273250,2712706972
20387,BPAC5,2010-12-31,2011-11-14,1200160000,1199840000,2400000000
20388,BPAC5,2011-03-31,2011-11-14,1200160000,1199840000,2400000000
20389,BPAC5,2011-06-30,2012-02-07,1200160000,1199840000,2400000000
20390,BPAC5,2011-09-30,2011-12-12,1200160000,1199840000,2400000000
20391,BPAC5,2011-12-31,2012-04-03,2400000,0,2400000
20392,BPAC5,2012-03-31,2012-05-11,1200160000,1199840000,2400000000
20393,BPAC5,2012-06-30,2012-08-09,1368504000,1279896000,2648400000
20394,BPAC5,2012-09-30,2012-11-06,1368504000,1279896000,2648400000
20395,BPAC5,2012-12-31,2013-02-19,1390671404,1324230808,2714902212
20396,BPAC5,2013-03-31,2013-05-07,1390671404,1324230808,2714902212
20397,BPAC5,2013-06-30,2013-08-06,1390671404,1324230808,2714902212
20398,BPAC5,2013-09-30,2013-11-05,1390671404,1324230808,2714902212
20399,BPAC5,2013-12-31,2014-02-19,1390671404,1324230808,2714902212
20400,BPAC5,2014-03-31,2014-05-06,1390671404,1324230808,2714902212
20401,BPAC5,2014-06-30,2014-08-05,1390671404,1324230808,2714902212
20402,BPAC5,2014-09-30,2014-11-04,1390671404,1324230808,2714902212
20403,BPAC5,2014-12-31,2015-02-25,1390671404,1324230808,2714902212
20404,BPAC5,2015-03-31,2015-05-06,1390671404,1324230808,2714902212
20405,BPAC5,2015-06-30,2015-08-05,1390671404,1324230808,2714902212
20406,BPAC5,2015-09-30,2015-11-04,1424305814,1391499628,2815805442
20407,BPAC5,2015-12-31,2016-03-30,1404405002,1351698004,2756103006
20408,BPAC5,2016-03-31,2016-05-11,1384479472,1311847544,2696327016
20409,BPAC5,2016-06-30,2016-08-09,1384479772,1311847544,2696327316
20410,BPAC5,2016-09-30,2016-11-08,1352401464,2065217411,3417618875
20411,BPAC5,2016-12-31,2017-03-31,1352401604,2065217271,3417618875
20412,BPAC5,2017-03-31,2017-05-10,1778353202,1000112209,2778465411
20413,BPAC5,2017-06-30,2017-08-29,1762281522,967968849,2730250371
20414,BPAC5,2017-09-30,2017-11-08,1746065322,935536450,2681601772
20415,BPAC5,2017-12-31,2018-12-28,1746065322,935536450,2681601772
20416,BPAC5,2018-03-31,2018-05-17,1746065322,935536450,2681601772
20417,BPAC5,2018-06-30,2018-08-07,1746065322,935536450,2681601772
20418,BPAC5,2018-09-30,2018-11-05,1746065322,935536450,2681601772
20419,BPAC5,2018-12-31,2019-03-29,1731276922,905959650,2637236572
20420,BPAC5,2019-03-31,2019-05-09,1731276922,905959650,2637236572
20421,BPAC5,2019-06-30,2019-08-13,1731276922,905959650,2637236572
20422,BPAC5,2019-09-30,2019-11-05,1731276922,905959650,2637236572
20423,BPAC5,2019-12-31,2020-06-26,1731276922,905959650,2637236572
20424,BPAC5,2020-03-31,2020-06-05,1731276922,905959650,2637236572
20425,BPAC5,2020-06-30,2020-08-11,1756433722,956273250,2712706972
20426,BPAC5,2020-09-30,2020-11-10,1756433722,956273250,2712706972
20427,BPAC5,2020-12-31,2021-02-09,1756433722,956273250,2712706972
20428,HBSA3,2010-12-31,2011-12-15,395000,0,395000
20429,HBSA3,2011-03-31,2011-12-15,16795000,0,16795000
20430,HBSA3,2011-06-30,2011-12-15,16795000,0,16795000
20431,HBSA3,2011-09-30,2011-12-15,108000000,0,108000000
20432,HBSA3,2011-12-31,2012-04-05,108000,0,108000
20433,HBSA3,2012-03-31,2012-05-15,162874,0,162874
20434,HBSA3,2012-06-30,2012-08-15,162874,0,162874
20435,HBSA3,2012-09-30,2012-11-14,219974,0,219974
20436,HBSA3,2012-12-31,2013-03-27,219974,0,219974
20437,HBSA3,2013-03-31,2013-05-15,219974,0,219974
20438,HBSA3,2013-06-30,2013-08-14,283095,0,283095
20439,HBSA3,2013-09-30,2013-11-13,334031,0,334031
20440,HBSA3,2013-12-31,2014-03-07,404165,0,404165
20441,HBSA3,2014-03-31,2014-05-15,538822,0,538822
20442,HBSA3,2014-06-30,2014-08-15,538822,0,538822
20443,HBSA3,2014-09-30,2014-11-14,538822,0,538822
20444,HBSA3,2014-12-31,2015-03-24,538822389,0,538822389
20445,HBSA3,2015-03-31,2015-05-15,584829,0,584829
20446,HBSA3,2015-06-30,2015-08-14,584829,0,584829
20447,HBSA3,2015-09-30,2015-11-13,630835,0,630835
20448,HBSA3,2015-12-31,2016-03-28,630834792,0,630834792
20449,HBSA3,2016-03-31,2016-05-16,630835,0,630835
20450,HBSA3,2016-06-30,2016-08-15,630835,0,630835
20451,HBSA3,2016-09-30,2016-11-14,630835,0,630835
20452,HBSA3,2016-12-31,2017-12-22,692483,0,692483
20453,HBSA3,2017-03-31,2018-08-13,692483,0,692483
20454,HBSA3,2017-06-30,2018-08-13,692483,0,692483
20455,HBSA3,2017-09-30,2017-11-16,692483,0,692483
20456,HBSA3,2017-12-31,2018-04-02,721006,0,721006
20457,HBSA3,2018-03-31,2018-05-16,721006,0,721006
20458,HBSA3,2018-06-30,2020-12-02,721006,0,721006
20459,HBSA3,2018-09-30,2020-12-02,721006,0,721006
20460,HBSA3,2018-12-31,2019-04-13,748610,0,748610
20461,HBSA3,2019-03-31,2019-05-15,748610,0,748610
20462,HBSA3,2019-06-30,2019-08-13,748610,0,748610
20463,HBSA3,2019-09-30,2019-11-14,748610,0,748610
20464,HBSA3,2019-12-31,2020-02-19,748610,0,748610
20465,HBSA3,2020-03-31,2020-05-29,748610,0,748610
20466,HBSA3,2020-06-30,2020-07-30,748610,0,748610
20467,HBSA3,2020-09-30,2020-11-13,760382,0,760382
20468,HBSA3,2020-12-31,2021-03-15,760383,0,760383
20469,LCAM3,2010-12-31,2012-05-15,20390561,10799329,31189890
20470,LCAM3,2011-03-31,2012-05-15,20390561,10799329,31189890
20471,LCAM3,2011-06-30,2012-05-15,20390561,10799329,31189890
20472,LCAM3,2011-09-30,2012-05-15,20390000,10799000,31189000
20473,LCAM3,2011-12-31,2012-05-15,20390561,10799329,31189890
20474,LCAM3,2012-03-31,2012-05-15,46784835,0,46784835
20475,LCAM3,2012-06-30,2012-08-14,64966653,0,64966653
20476,LCAM3,2012-09-30,2012-11-12,64991199,0,64991199
20477,LCAM3,2012-12-31,2013-03-13,65044293,0,65044293
20478,LCAM3,2013-03-31,2013-05-09,65044293,0,65044293
20479,LCAM3,2013-06-30,2013-08-14,65044293,0,65044293
20480,LCAM3,2013-09-30,2013-11-11,65052757,0,65052757
20481,LCAM3,2013-12-31,2014-03-20,65075322,0,65075322
20482,LCAM3,2014-03-31,2014-05-08,65075322,0,65075322
20483,LCAM3,2014-06-30,2014-08-05,64838922,0,64838922
20484,LCAM3,2014-09-30,2014-11-12,65075322,0,65075322
20485,LCAM3,2014-12-31,2015-03-25,65075322,0,65075322
20486,LCAM3,2015-03-31,2015-05-06,65075322,0,65075322
20487,LCAM3,2015-06-30,2015-08-14,65075322,0,65075322
20488,LCAM3,2015-09-30,2015-11-10,65075322,0,65075322
20489,LCAM3,2015-12-31,2016-03-21,65075322,0,65075322
20490,LCAM3,2016-03-31,2016-04-26,65075322,0,65075322
20491,LCAM3,2016-06-30,2016-08-10,65075322,0,65075322
20492,LCAM3,2016-09-30,2016-10-26,65075322,0,65075322
20493,LCAM3,2016-12-31,2017-05-25,65075322,0,65075322
20494,LCAM3,2017-03-31,2017-05-03,65075322,0,65075322
20495,LCAM3,2017-06-30,2017-07-24,82469138,0,82469138
20496,LCAM3,2017-09-30,2017-10-25,82469138,0,82469138
20497,LCAM3,2017-12-31,2018-03-29,82469138,0,82469138
20498,LCAM3,2018-03-31,2018-08-13,116863827,0,116863827
20499,LCAM3,2018-06-30,2018-08-13,116863827,0,116863827
20500,LCAM3,2018-09-30,2018-11-06,116863827,0,116863827
20501,LCAM3,2018-12-31,2019-04-22,147863827,0,147863827
20502,LCAM3,2019-03-31,2019-05-06,149243137,0,149243137
20503,LCAM3,2019-06-30,2019-08-05,149243137,0,149243137
20504,LCAM3,2019-09-30,2019-11-21,149243137,0,149243137
20505,LCAM3,2019-12-31,2020-03-12,508729411,0,508729411
20506,LCAM3,2020-03-31,2020-05-20,508729411,0,508729411
20507,LCAM3,2020-06-30,2020-08-13,508729411,0,508729411
20508,LCAM3,2020-09-30,2020-10-26,508729411,0,508729411
20509,LCAM3,2020-12-31,2021-02-23,508729411,0,508729411
20510,UCAS3,2011-12-31,2012-04-26,5499900,0,5499900
20511,UCAS3,2012-03-31,2012-05-10,56950000,0,56950000
20512,UCAS3,2012-06-30,2012-08-06,66086364,0,66086364
20513,UCAS3,2012-09-30,2012-11-13,66086364,0,66086364
20514,UCAS3,2012-12-31,2013-04-05,66086364,0,66086364
20515,UCAS3,2013-03-31,2013-05-13,66086364,0,66086364
20516,UCAS3,2013-06-30,2013-08-06,66086364,0,66086364
20517,UCAS3,2013-09-30,2014-05-22,66086364,0,66086364
20518,UCAS3,2013-12-31,2014-03-25,66086364,0,66086364
20519,UCAS3,2014-03-31,2014-05-22,66086364,0,66086364
20520,UCAS3,2014-06-30,2014-08-11,66086364,0,66086364
20521,UCAS3,2014-09-30,2014-11-18,66086364,0,66086364
20522,UCAS3,2014-12-31,2015-03-19,66086364,0,66086364
20523,UCAS3,2015-03-31,2015-05-07,66086364,0,66086364
20524,UCAS3,2015-06-30,2015-08-13,66086364,0,66086364
20525,UCAS3,2015-09-30,2015-11-12,66086364,0,66086364
20526,UCAS3,2015-12-31,2016-03-17,66086364,0,66086364
20527,UCAS3,2016-03-31,2016-05-12,66086346,0,66086346
20528,UCAS3,2016-06-30,2016-08-11,66086346,0,66086346
20529,UCAS3,2016-09-30,2016-11-22,66086346,0,66086346
20530,UCAS3,2016-12-31,2017-03-17,66086364,0,66086364
20531,UCAS3,2017-03-31,2017-05-11,66086346,0,66086346
20532,UCAS3,2017-06-30,2017-08-10,66086346,0,66086346
20533,UCAS3,2017-09-30,2017-11-09,66086346,0,66086346
20534,UCAS3,2017-12-31,2018-03-15,66086364,0,66086364
20535,UCAS3,2018-03-31,2018-05-11,66086364,0,66086364
20536,UCAS3,2018-06-30,2018-11-07,66086364,0,66086364
20537,UCAS3,2018-09-30,2018-11-13,66086364,0,66086364
20538,UCAS3,2018-12-31,2019-03-14,66086364,0,66086364
20539,UCAS3,2019-03-31,2019-05-09,66086364,0,66086364
20540,UCAS3,2019-06-30,2019-08-06,66086364,0,66086364
20541,UCAS3,2019-09-30,2019-11-13,66086364,0,66086364
20542,UCAS3,2019-12-31,2020-03-12,66086364,0,66086364
20543,UCAS3,2020-03-31,2020-05-28,66086364,0,66086364
20544,UCAS3,2020-06-30,2020-08-06,66086364,0,66086364
20545,UCAS3,2020-09-30,2020-11-12,66086364,0,66086364
20546,UCAS3,2020-09-30,2020-11-12,66086364,0,66086364
20547,UCAS3,2020-12-31,2021-03-11,66086364,0,66086364
20548,SQIA3,2011-12-31,2012-05-07,805539,220387,1025926
20549,SQIA3,2012-03-31,2012-06-01,805539,220387,1025926
20550,SQIA3,2012-06-30,2012-08-09,805539,220387,1025926
20551,SQIA3,2012-09-30,2012-11-08,1025926,0,1025926
20552,SQIA3,2012-12-31,2013-04-19,8207408,0,8207408
20553,SQIA3,2013-03-31,2013-05-14,11655683,0,11655683
20554,SQIA3,2013-06-30,2013-08-14,11655683,0,11655683
20555,SQIA3,2013-09-30,2013-11-13,11787203,0,11787203
20556,SQIA3,2013-12-31,2014-03-27,11655683,0,11655683
20557,SQIA3,2014-03-31,2014-05-14,11787203,0,11787203
20558,SQIA3,2014-06-30,2014-08-13,11787203,0,11787203
20559,SQIA3,2014-09-30,2014-11-13,11787203,0,11787203
20560,SQIA3,2014-12-31,2015-12-10,11787203,0,11787203
20561,SQIA3,2015-03-31,2015-12-10,11787203,0,11787203
20562,SQIA3,2015-06-30,2015-12-10,11787203,0,11787203
20563,SQIA3,2015-09-30,2015-11-11,11787203,0,11787203
20564,SQIA3,2015-12-31,2016-03-15,11787203,0,11787203
20565,SQIA3,2016-03-31,2016-05-10,11787203,0,11787203
20566,SQIA3,2016-06-30,2016-08-09,11787203,0,11787203
20567,SQIA3,2016-09-30,2016-11-08,11787203,0,11787203
20568,SQIA3,2016-12-31,2017-03-22,11787203,0,11787203
20569,SQIA3,2017-03-31,2017-05-09,11787203,0,11787203
20570,SQIA3,2017-06-30,2017-08-09,11787203,0,11787203
20571,SQIA3,2017-09-30,2017-11-09,11787203,0,11787203
20572,SQIA3,2017-12-31,2018-02-28,11787203,0,11787203
20573,SQIA3,2018-03-31,2018-05-09,11787203,0,11787203
20574,SQIA3,2018-06-30,2018-08-08,11787203,0,11787203
20575,SQIA3,2018-09-30,2018-11-07,11787203,0,11787203
20576,SQIA3,2018-12-31,2019-08-16,11787203,0,11787203
20577,SQIA3,2019-03-31,2019-05-15,11787203,0,11787203
20578,SQIA3,2019-06-30,2019-08-14,11787203,0,11787203
20579,SQIA3,2019-09-30,2019-11-13,70548812,0,70548812
20580,SQIA3,2019-12-31,2020-03-04,70548812,0,70548812
20581,SQIA3,2020-03-31,2020-05-12,70548812,0,70548812
20582,SQIA3,2020-06-30,2020-08-11,70548812,0,70548812
20583,SQIA3,2020-09-30,2020-11-12,70548812,0,70548812
20584,SQIA3,2020-12-31,2021-03-10,70548812,0,70548812
20585,BSEV3,2012-03-31,2012-07-13,10800757666,848913804,11649671470
20586,BSEV3,2012-06-30,2013-02-14,11178970585,848913804,12027884389
20587,BSEV3,2012-09-30,2013-02-14,11178970585,848913804,12027884389
20588,BSEV3,2012-12-31,2013-02-15,11178970585,817774304,11996744889
20589,BSEV3,2013-03-31,2013-06-12,15196620363,817774304,16014394667
20590,BSEV3,2013-06-30,2013-08-14,206810613,0,206810613
20591,BSEV3,2013-09-30,2013-11-12,206810613,0,206810613
20592,BSEV3,2013-12-31,2014-02-13,206810613,0,206810613
20593,BSEV3,2014-03-31,2014-06-10,206810613,0,206810613
20594,BSEV3,2014-06-30,2014-08-14,206810613,0,206810613
20595,BSEV3,2014-09-30,2014-11-12,206810613,0,206810613
20596,BSEV3,2014-12-31,2015-02-10,206810613,0,206810613
20597,BSEV3,2015-03-31,2015-06-11,219628363,0,219628363
20598,BSEV3,2015-06-30,2015-08-13,219628363,0,219628363
20599,BSEV3,2015-09-30,2015-11-10,219628363,0,219628363
20600,BSEV3,2015-12-31,2016-02-11,219628363,0,219628363
20601,BSEV3,2016-03-31,2016-06-06,219628363,0,219628363
20602,BSEV3,2016-06-30,2016-08-15,219628363,0,219628363
20603,BSEV3,2016-09-30,2016-11-09,219628363,0,219628363
20604,BSEV3,2016-12-31,2017-02-09,219628363,0,219628363
20605,BSEV3,2017-03-31,2017-06-01,219628363,0,219628363
20606,BSEV3,2017-06-30,2017-08-09,219628363,0,219628363
20607,BSEV3,2017-09-30,2017-11-09,219628363,0,219628363
20608,BSEV3,2017-12-31,2018-02-08,219628363,0,219628363
20609,BSEV3,2018-03-31,2018-06-12,1020380677,0,1020380677
20610,BSEV3,2018-06-30,2018-08-09,1020429426,0,1020429426
20611,BSEV3,2018-09-30,2018-11-07,1020429426,0,1020429426
20612,BSEV3,2018-12-31,2019-02-12,1020429426,0,1020429426
20613,BSEV3,2019-03-31,2019-06-06,1020429426,0,1020429426
20614,BSEV3,2019-06-30,2019-08-14,1020429426,0,1020429426
20615,BSEV3,2019-09-30,2019-11-12,1020429426,0,1020429426
20616,BSEV3,2019-12-31,2020-02-13,1020429426,0,1020429426
20617,BSEV3,2020-03-31,2020-07-27,1020429426,0,1020429426
20618,BSEV3,2020-06-30,2020-09-17,1020429426,0,1020429426
20619,BSEV3,2020-09-30,2020-11-12,1020429426,0,1020429426
20620,BSEV3,2020-12-31,2021-02-11,1020429426,0,1020429426
20621,NRTQ3,2011-12-31,2012-11-27,9502,2735,12237
20622,NRTQ3,2012-03-30,2012-11-27,9502,2375,11877
20623,NRTQ3,2012-06-30,2012-11-27,9502,2375,11877
20624,NRTQ3,2012-09-30,2012-11-27,9502,2375,11877
20625,NRTQ3,2012-12-31,2013-04-04,9502,2375,11877
20626,NRTQ3,2013-03-31,2013-05-13,11877,0,11877
20627,NRTQ3,2013-06-30,2013-10-21,11877,0,11877
20628,NRTQ3,2013-09-30,2013-11-12,11877,0,11877
20629,NRTQ3,2013-12-31,2014-03-28,11877,0,11877
20630,NRTQ3,2014-03-31,2014-05-19,11877,0,11877
20631,NRTQ3,2014-06-30,2014-08-14,11877,0,11877
20632,NRTQ3,2014-09-30,2014-11-17,11877,0,11877
20633,NRTQ3,2014-12-31,2015-04-17,11877,0,11877
20634,NRTQ3,2015-03-31,2015-05-14,11877,0,11877
20635,NRTQ3,2015-06-30,2015-08-13,11877,0,11877
20636,NRTQ3,2015-09-30,2015-11-16,11877,0,11877
20637,NRTQ3,2015-12-31,2016-03-29,11877,0,11877
20638,NRTQ3,2016-03-31,2016-05-13,11877,0,11877
20639,NRTQ3,2016-06-30,2016-08-12,11877,0,11877
20640,NRTQ3,2016-09-30,2016-11-14,11877,0,11877
20641,NRTQ3,2016-12-31,2017-04-11,11877,0,11877
20642,NRTQ3,2017-03-31,2017-05-15,11877,0,11877
20643,NRTQ3,2017-06-30,2017-08-14,11877,0,11877
20644,NRTQ3,2017-09-30,2017-11-14,11877,0,11877
20645,NRTQ3,2017-12-31,2018-04-02,11877,0,11877
20646,NRTQ3,2018-03-31,2018-05-29,11877,0,11877
20647,NRTQ3,2018-06-30,2018-08-14,11877,0,11877
20648,NRTQ3,2018-09-30,2018-11-14,11877,0,11877
20649,NRTQ3,2018-12-31,2019-03-27,11877,0,11877
20650,NRTQ3,2019-03-31,2019-05-15,11877,0,11877
20651,NRTQ3,2019-06-30,2019-08-14,11877,0,11877
20652,NRTQ3,2019-09-30,2019-11-14,11877,0,11877
20653,NRTQ3,2019-12-31,2020-03-27,11877,0,11877
20654,NRTQ3,2020-03-31,2020-06-29,11877,0,11877
20655,NRTQ3,2020-06-30,2020-08-31,11877,0,11877
20656,NRTQ3,2020-09-30,2020-11-13,11877,0,11877
20657,LINX3,2011-12-31,2013-02-08,7829987,5694902,13524889
20658,LINX3,2012-03-31,2013-02-08,7829987,5694902,13524889
20659,LINX3,2012-06-30,2013-02-08,7829987,5694902,13524889
20660,LINX3,2012-09-30,2013-02-08,7829989,5694902,13524891
20661,LINX3,2012-12-31,2013-04-22,7829987,5694902,13524889
20662,LINX3,2013-03-31,2013-05-10,46519720,0,46519720
20663,LINX3,2013-06-30,2013-08-07,46520,0,46520
20664,LINX3,2013-09-30,2013-11-07,46556,0,46556
20665,LINX3,2013-12-31,2014-02-13,46556,0,46556
20666,LINX3,2014-03-31,2014-05-08,46576,0,46576
20667,LINX3,2014-06-30,2014-08-07,46576,0,46576
20668,LINX3,2014-09-30,2014-11-06,46765,0,46765
20669,LINX3,2014-12-31,2015-02-12,46765,0,46765
20670,LINX3,2015-03-31,2015-05-07,46773377,0,46773377
20671,LINX3,2015-06-30,2015-08-06,46773377,0,46773377
20672,LINX3,2015-09-30,2015-11-05,46836541,0,46836541
20673,LINX3,2015-12-31,2016-02-18,46837,0,46837
20674,LINX3,2016-03-31,2016-05-09,47069132,0,47069132
20675,LINX3,2016-06-30,2016-08-08,141207396,0,141207396
20676,LINX3,2016-09-30,2016-11-07,165207396,0,165207396
20677,LINX3,2016-12-31,2017-02-13,165609951,0,165609951
20678,LINX3,2017-03-31,2017-05-16,165820161,0,165820161
20679,LINX3,2017-06-30,2017-08-07,165820161,0,165820161
20680,LINX3,2017-09-30,2017-11-06,166110342,0,166110342
20681,LINX3,2017-12-31,2018-02-19,166110342,0,166110342
20682,LINX3,2018-03-31,2018-05-07,166212210,0,166212210
20683,LINX3,2018-06-30,2018-08-28,166212210,0,166212210
20684,LINX3,2018-09-30,2018-11-12,166283382,0,166283382
20685,LINX3,2018-12-31,2019-06-11,166283382,0,166283382
20686,LINX3,2019-03-31,2019-05-02,166308960,0,166308960
20687,LINX3,2019-06-30,2019-08-14,189408960,0,189408960
20688,LINX3,2019-09-30,2019-11-13,189408960,0,189408960
20689,LINX3,2019-12-31,2020-03-30,189408960,0,189408960
20690,LINX3,2020-03-31,2020-06-08,189408960,0,189408960
20691,LINX3,2020-06-30,2020-08-21,189408960,0,189408960
20692,LINX3,2020-09-30,2020-11-09,189408960,0,189408960
20693,BBSE3,2012-12-31,2013-04-29,470563927,0,470563927
20694,BBSE3,2013-03-31,2013-05-14,2000000000,0,2000000000
20695,BBSE3,2013-06-30,2015-08-12,2000000000,0,2000000000
20696,BBSE3,2013-09-30,2013-11-11,2000000000,0,2000000000
20697,BBSE3,2013-12-31,2014-02-12,2000000000,0,2000000000
20698,BBSE3,2014-03-31,2014-05-06,2000000000,0,2000000000
20699,BBSE3,2014-06-30,2015-08-12,2000000000,0,2000000000
20700,BBSE3,2014-09-30,2014-11-25,2000000000,0,2000000000
20701,BBSE3,2014-12-31,2015-02-10,2000000000,0,2000000000
20702,BBSE3,2015-03-31,2015-05-07,2000000000,0,2000000000
20703,BBSE3,2015-06-30,2015-08-11,2000000000,0,2000000000
20704,BBSE3,2015-09-30,2015-11-10,2000000000,0,2000000000
20705,BBSE3,2015-12-31,2016-02-26,2000000000,0,2000000000
20706,BBSE3,2016-03-31,2016-05-09,2000000000,0,2000000000
20707,BBSE3,2016-06-30,2016-08-08,2000000000,0,2000000000
20708,BBSE3,2016-09-30,2016-11-07,2000000000,0,2000000000
20709,BBSE3,2016-12-31,2017-02-13,2000000000,0,2000000000
20710,BBSE3,2017-03-31,2017-05-08,2000000000,0,2000000000
20711,BBSE3,2017-06-30,2017-08-07,2000000000,0,2000000000
20712,BBSE3,2017-09-30,2017-11-06,2000000000,0,2000000000
20713,BBSE3,2017-12-31,2018-02-19,2000000000,0,2000000000
20714,BBSE3,2018-03-31,2018-05-07,2000000000,0,2000000000
20715,BBSE3,2018-06-30,2018-08-06,2000000000,0,2000000000
20716,BBSE3,2018-09-30,2018-11-05,2000000000,0,2000000000
20717,BBSE3,2018-12-31,2019-02-11,2000000000,0,2000000000
20718,BBSE3,2019-03-31,2019-05-06,2000000000,0,2000000000
20719,BBSE3,2019-06-30,2019-08-06,2000000000,0,2000000000
20720,BBSE3,2019-09-30,2019-11-04,2000000000,0,2000000000
20721,BBSE3,2019-12-31,2020-02-10,2000000000,0,2000000000
20722,BBSE3,2020-03-31,2020-05-04,2000000000,0,2000000000
20723,BBSE3,2020-06-30,2020-08-03,2000000000,0,2000000000
20724,BBSE3,2020-09-30,2020-11-03,2000000000,0,2000000000
20725,BBSE3,2020-12-31,2021-02-08,2000000000,0,2000000000
20726,IGSN3,2012-12-31,2013-05-15,61266737,0,61266737
20727,IGSN3,2013-03-31,2013-05-15,61266737,0,61266737
20728,IGSN3,2013-06-30,2013-12-23,61266737,0,61266737
20729,IGSN3,2013-09-30,2013-12-23,61266737,0,61266737
20730,IGSN3,2013-12-31,2014-03-31,61266737,0,61266737
20731,IGSN3,2014-03-31,2014-05-15,61266737,0,61266737
20732,IGSN3,2014-06-30,2014-08-15,61266737,0,61266737
20733,IGSN3,2014-09-30,2014-11-14,61266737,0,61266737
20734,IGSN3,2014-12-31,2015-03-27,61266737,0,61266737
20735,IGSN3,2015-03-31,2015-05-15,61266737,0,61266737
20736,IGSN3,2015-06-30,2015-08-14,61266737,0,61266737
20737,IGSN3,2015-09-30,2015-11-10,61266737,0,61266737
20738,IGSN3,2015-12-31,2016-03-29,61266737,0,61266737
20739,IGSN3,2016-03-31,2016-05-13,61266737,0,61266737
20740,IGSN3,2016-06-30,2016-10-07,61266737,0,61266737
20741,IGSN3,2016-09-30,2016-11-11,61266737,0,61266737
20742,IGSN3,2016-12-31,2017-09-05,61266737,0,61266737
20743,IGSN3,2017-03-31,2017-09-06,61266737,0,61266737
20744,IGSN3,2017-06-30,2017-09-27,61266737,0,61266737
20745,IGSN3,2017-09-30,2017-11-14,129436505,0,129436505
20746,IGSN3,2017-12-31,2018-03-12,129436505,0,129436505
20747,IGSN3,2018-03-31,2018-05-15,129436505,0,129436505
20748,IGSN3,2018-06-30,2018-08-15,129436505,0,129436505
20749,IGSN3,2018-09-30,2018-11-21,129436505,0,129436505
20750,IGSN3,2018-12-31,2019-04-17,169739941,0,169739941
20751,IGSN3,2019-03-31,2019-05-15,177800628,0,177800628
20752,IGSN3,2019-06-30,2019-08-14,185861315,0,185861315
20753,IGSN3,2019-09-30,2019-11-14,199192402,0,199192402
20754,IGSN3,2019-12-31,2020-03-09,199192402,0,199192402
20755,IGSN3,2020-03-31,2020-05-26,199192402,0,199192402
20756,IGSN3,2020-06-30,2020-08-28,199192402,0,199192402
20757,IGSN3,2020-09-30,2020-11-25,207017884,0,207017884
20758,IGSN3,2020-12-31,2021-03-24,207017884,0,207017884
20759,SEER3,2010-12-31,2013-10-23,107515296,0,107515296
20760,SEER3,2011-12-31,2013-10-30,107515296,0,107515296
20761,SEER3,2012-12-31,2013-10-23,107515296,0,107515296
20762,SEER3,2013-03-31,2013-10-23,107515296,0,107515296
20763,SEER3,2013-06-30,2013-10-23,107515296,0,107515296
20764,SEER3,2013-09-30,2013-11-20,122904816,0,122904816
20765,SEER3,2013-12-31,2014-03-26,125213244,0,125213244
20766,SEER3,2014-03-31,2014-05-15,125213244,0,125213244
20767,SEER3,2014-06-30,2014-08-14,125213244,0,125213244
20768,SEER3,2014-09-30,2014-11-17,125213244,0,125213244
20769,SEER3,2014-12-31,2015-04-01,125213244,0,125213244
20770,SEER3,2015-03-31,2015-05-15,124863944,0,124863944
20771,SEER3,2015-06-30,2015-08-14,124863944,0,124863944
20772,SEER3,2015-09-30,2015-11-18,125213244,0,125213244
20773,SEER3,2015-12-31,2016-03-19,125213244,0,125213244
20774,SEER3,2016-03-31,2016-05-06,125213244,0,125213244
20775,SEER3,2016-06-30,2016-08-05,125213244,0,125213244
20776,SEER3,2016-09-30,2016-11-04,125213244,0,125213244
20777,SEER3,2016-12-31,2017-03-17,125213244,0,125213244
20778,SEER3,2017-03-31,2017-05-05,125213244,0,125213244
20779,SEER3,2017-06-30,2017-08-04,125213244,0,125213244
20780,SEER3,2017-09-30,2017-11-08,125213244,0,125213244
20781,SEER3,2017-12-31,2018-03-23,138812000,0,138812000
20782,SEER3,2018-03-31,2018-05-09,138812000,0,138812000
20783,SEER3,2018-06-30,2018-08-09,138812000,0,138812000
20784,SEER3,2018-09-30,2018-11-07,138812000,0,138812000
20785,SEER3,2018-12-31,2019-03-28,132951860,0,132951860
20786,SEER3,2019-03-31,2019-05-10,132951860,0,132951860
20787,SEER3,2019-06-30,2019-08-09,128721560,0,128721560
20788,SEER3,2019-09-30,2019-11-12,128721560,0,128721560
20789,SEER3,2019-12-31,2020-03-27,128721560,0,128721560
20790,SEER3,2020-03-31,2020-05-15,128721560,0,128721560
20791,SEER3,2020-06-30,2020-08-24,128721560,0,128721560
20792,SEER3,2020-09-30,2020-11-13,128721560,0,128721560
20793,SEER3,2020-12-31,2021-03-26,128721560,0,128721560
20794,ANIM3,2012-12-31,2013-10-25,1693109,0,1693109
20795,ANIM3,2013-03-31,2013-10-25,1742380,0,1742380
20796,ANIM3,2013-06-30,2013-10-25,1735487,0,1735487
20797,ANIM3,2013-09-30,2013-11-14,59838232,0,59838232
20798,ANIM3,2013-12-31,2014-03-20,82866371,0,82866371
20799,ANIM3,2014-03-31,2014-05-08,82866371,0,82866371
20800,ANIM3,2014-06-30,2014-08-11,82866371,0,82866371
20801,ANIM3,2014-09-30,2014-11-12,82865891,0,82865891
20802,ANIM3,2014-12-31,2015-02-26,82865891,0,82865891
20803,ANIM3,2015-03-31,2015-05-07,82865982,0,82865982
20804,ANIM3,2015-06-30,2015-08-05,82865982,0,82865982
20805,ANIM3,2015-09-30,2015-11-09,82865982,0,82865982
20806,ANIM3,2015-12-31,2016-03-08,82592482,0,82592482
20807,ANIM3,2016-03-31,2016-05-12,81872582,0,81872582
20808,ANIM3,2016-06-30,2016-08-11,82866371,0,82866371
20809,ANIM3,2016-09-30,2016-11-08,82866371,0,82866371
20810,ANIM3,2016-12-31,2017-03-14,80944571,0,80944571
20811,ANIM3,2017-03-31,2017-05-10,80944571,0,80944571
20812,ANIM3,2017-06-30,2017-08-10,80944571,0,80944571
20813,ANIM3,2017-09-30,2017-11-13,80944571,0,80944571
20814,ANIM3,2017-12-31,2018-03-21,80944571,0,80944571
20815,ANIM3,2018-03-31,2018-05-09,80944571,0,80944571
20816,ANIM3,2018-06-30,2018-08-15,80944571,0,80944571
20817,ANIM3,2018-09-30,2018-11-12,78556015,0,78556015
20818,ANIM3,2018-12-31,2019-03-21,77632254,0,77632254
20819,ANIM3,2019-03-31,2019-05-13,78556015,0,78556015
20820,ANIM3,2019-06-30,2019-08-13,78556015,0,78556015
20821,ANIM3,2019-09-30,2019-11-11,78556015,0,78556015
20822,ANIM3,2019-12-31,2020-03-11,80208517,0,80208517
20823,ANIM3,2020-03-31,2020-05-14,110559237,0,110559237
20824,ANIM3,2020-06-30,2020-08-13,111122935,0,111122935
20825,ANIM3,2020-09-30,2020-11-09,107622935,0,107622935
20826,ANIM3,2020-12-31,2021-03-17,134622935,0,134622935
20827,ABEV3,2012-12-31,2013-10-31,249061,0,249061
20828,ABEV3,2013-03-31,2013-10-31,249061,0,249061
20829,ABEV3,2013-06-30,2013-10-31,9693598,0,9693598
20830,ABEV3,2013-09-30,2013-10-31,9693598,0,9693598
20831,ABEV3,2013-12-31,2014-03-24,15644280,0,15644280
20832,ABEV3,2014-03-31,2014-05-07,15666170,0,15666170
20833,ABEV3,2014-06-30,2014-07-31,15670883,0,15670883
20834,ABEV3,2014-09-30,2014-10-31,15699508,0,15699508
20835,ABEV3,2014-12-31,2015-02-26,15712619,0,15712619
20836,ABEV3,2015-03-31,2015-05-06,15717615,0,15717615
20837,ABEV3,2015-06-30,2015-07-30,15717615,0,15717615
20838,ABEV3,2015-09-30,2015-10-30,15717615,0,15717615
20839,ABEV3,2015-12-31,2016-02-25,15717615,0,15717615
20840,ABEV3,2016-03-31,2016-05-04,15717615,0,15717615
20841,ABEV3,2016-06-30,2016-07-29,15717615,0,15717615
20842,ABEV3,2016-09-30,2016-10-28,15717615,0,15717615
20843,ABEV3,2016-12-31,2018-07-05,15717615,0,15717615
20844,ABEV3,2017-03-31,2017-05-04,15717615,0,15717615
20845,ABEV3,2017-06-30,2017-07-27,15717615,0,15717615
20846,ABEV3,2017-09-30,2017-10-26,15717615,0,15717615
20847,ABEV3,2017-12-31,2018-07-05,15717615,0,15717615
20848,ABEV3,2018-03-31,2018-05-09,15722147,0,15722147
20849,ABEV3,2018-06-30,2018-07-26,15722147,0,15722147
20850,ABEV3,2018-09-30,2018-10-25,15722147,0,15722147
20851,ABEV3,2018-12-31,2019-02-28,15722147,0,15722147
20852,ABEV3,2019-03-31,2019-05-07,15726842,0,15726842
20853,ABEV3,2019-06-30,2019-07-25,15727523,0,15727523
20854,ABEV3,2019-09-30,2019-10-25,15733575,0,15733575
20855,ABEV3,2019-12-31,2020-02-27,15733575,0,15733575
20856,ABEV3,2020-03-31,2020-05-07,15735118,0,15735118
20857,ABEV3,2020-06-30,2020-07-30,15735118,0,15735118
20858,ABEV3,2020-09-30,2020-10-29,15735118,0,15735118
20859,ABEV3,2020-12-31,2021-02-25,15735118,0,15735118
20860,LOGG3,2012-12-31,2013-11-13,134362,0,134362
20861,LOGG3,2013-03-31,2013-11-13,134362,0,134362
20862,LOGG3,2013-06-30,2013-11-13,171453,0,171453
20863,LOGG3,2013-09-30,2013-11-14,171453,0,171453
20864,LOGG3,2013-12-31,2014-03-20,171453,0,171453
20865,LOGG3,2014-03-31,2014-08-14,171453,0,171453
20866,LOGG3,2014-06-30,2014-08-14,171453,0,171453
20867,LOGG3,2014-09-30,2014-11-11,171844,0,171844
20868,LOGG3,2014-12-31,2015-02-27,171844,0,171844
20869,LOGG3,2015-03-31,2015-05-12,171844,0,171844
20870,LOGG3,2015-06-30,2015-08-12,174557,0,174557
20871,LOGG3,2015-09-30,2015-11-11,174557,0,174557
20872,LOGG3,2015-12-31,2016-03-07,174557,0,174557
20873,LOGG3,2016-03-31,2016-05-10,174557,0,174557
20874,LOGG3,2016-06-30,2016-08-05,174732,0,174732
20875,LOGG3,2016-09-30,2016-11-08,174732,0,174732
20876,LOGG3,2016-12-31,2019-10-10,203402,0,203402
20877,LOGG3,2017-03-31,2017-05-11,50851,0,50851
20878,LOGG3,2017-06-30,2017-08-08,50851,0,50851
20879,LOGG3,2017-09-30,2017-11-06,60204,0,60204
20880,LOGG3,2017-12-31,2018-12-16,64977,0,64977
20881,LOGG3,2018-03-31,2018-05-04,69068,0,69068
20882,LOGG3,2018-06-30,2018-08-06,69068,0,69068
20883,LOGG3,2018-09-30,2018-10-31,69230,0,69230
20884,LOGG3,2018-12-31,2019-02-11,69230,0,69230
20885,LOGG3,2019-03-31,2019-04-25,73784,0,73784
20886,LOGG3,2019-06-30,2019-08-01,73784,0,73784
20887,LOGG3,2019-09-30,2019-10-30,73809,0,73809
20888,LOGG3,2019-12-31,2020-02-18,102159,0,102159
20889,LOGG3,2020-03-31,2020-04-29,102159,0,102159
20890,LOGG3,2020-06-30,2020-08-17,102159,0,102159
20891,LOGG3,2020-09-30,2020-10-29,102159,0,102159
20892,LOGG3,2020-12-31,2021-02-09,102159,0,102159
20893,QUSW3,2012-12-31,2013-12-05,400000,147945,547945
20894,QUSW3,2013-03-31,2013-12-05,400000,147945,547945
20895,QUSW3,2013-06-30,2013-12-05,400000,147945,547945
20896,QUSW3,2013-09-30,2013-12-05,400000,147945,547945
20897,QUSW3,2013-12-31,2014-03-28,400000,147945,547945
20898,QUSW3,2014-03-31,2014-05-14,400000,147945,547945
20899,QUSW3,2014-06-30,2014-08-14,400000,147945,547945
20900,QUSW3,2014-09-30,2014-11-14,400000,147945,547945
20901,QUSW3,2014-12-31,2015-03-27,400000,147945,547945
20902,QUSW3,2015-03-31,2015-05-14,400000,147945,547945
20903,QUSW3,2015-06-30,2015-08-17,547945,0,547945
20904,QUSW3,2015-09-30,2015-11-24,547945,0,547945
20905,QUSW3,2015-12-31,2016-04-27,400000,147945,547945
20906,QUSW3,2016-03-31,2016-05-13,663218,0,663218
20907,QUSW3,2016-06-30,2016-08-12,690180,0,690180
20908,QUSW3,2016-09-30,2016-11-11,690180,0,690180
20909,QUSW3,2016-12-31,2017-03-24,690180,0,690180
20910,QUSW3,2017-03-31,2017-11-16,830919,0,830919
20911,QUSW3,2017-06-30,2017-08-14,830919,0,830919
20912,QUSW3,2017-09-30,2017-11-14,830919,0,830919
20913,QUSW3,2017-12-31,2018-04-17,830919,0,830919
20914,QUSW3,2018-03-31,2018-05-15,830919,0,830919
20915,QUSW3,2018-06-30,2018-08-14,830919,0,830919
20916,QUSW3,2018-09-30,2018-11-14,830919,0,830919
20917,QUSW3,2018-12-31,2019-03-28,830919,0,830919
20918,QUSW3,2019-03-31,2019-05-15,830919,0,830919
20919,QUSW3,2019-06-30,2019-08-14,830919,0,830919
20920,QUSW3,2019-09-30,2019-11-14,830919,0,830919
20921,QUSW3,2019-12-31,2020-03-30,861605,0,861605
20922,QUSW3,2020-03-31,2020-05-20,861605,0,861605
20923,QUSW3,2020-06-30,2020-08-14,861605,0,861605
20924,QUSW3,2020-09-30,2020-11-18,861605,0,861605
20925,CVCB3,2012-12-31,2013-12-17,43527,0,43527
20926,CVCB3,2013-03-31,2013-12-17,43527,0,43527
20927,CVCB3,2013-06-30,2013-12-17,43527,0,43527
20928,CVCB3,2013-09-30,2013-12-17,43527,0,43527
20929,CVCB3,2013-12-31,2014-02-05,129729000,0,129729000
20930,CVCB3,2014-03-31,2014-05-06,129729000,0,129729000
20931,CVCB3,2014-06-30,2014-08-11,131465335,0,131465335
20932,CVCB3,2014-09-30,2014-10-20,131465335,0,131465335
20933,CVCB3,2014-12-31,2015-02-09,131465335,0,131465335
20934,CVCB3,2015-03-31,2015-05-05,131465335,0,131465335
20935,CVCB3,2015-06-30,2015-08-05,133302195,0,133302195
20936,CVCB3,2015-09-30,2015-11-11,134330243,0,134330243
20937,CVCB3,2015-12-31,2016-02-19,134330243,0,134330243
20938,CVCB3,2016-03-31,2016-05-05,132757443,0,132757443
20939,CVCB3,2016-06-30,2016-07-27,132830343,0,132830343
20940,CVCB3,2016-09-30,2016-11-03,134330243,0,134330243
20941,CVCB3,2016-12-31,2017-02-15,134330243,0,134330243
20942,CVCB3,2017-03-31,2017-05-10,134330243,0,134330243
20943,CVCB3,2017-06-30,2017-08-09,134330243,0,134330243
20944,CVCB3,2017-09-30,2017-11-08,135485103,0,135485103
20945,CVCB3,2017-12-31,2018-02-08,141700212,0,141700212
20946,CVCB3,2018-03-31,2018-05-10,146343772,0,146343772
20947,CVCB3,2018-06-30,2018-08-09,146472872,0,146472872
20948,CVCB3,2018-09-30,2018-11-09,146477872,0,146477872
20949,CVCB3,2018-12-31,2019-02-26,146511872,0,146511872
20950,CVCB3,2019-03-31,2019-05-09,148591079,0,148591079
20951,CVCB3,2019-06-30,2019-08-08,148609579,0,148609579
20952,CVCB3,2019-09-30,2019-11-08,149080579,0,149080579
20953,CVCB3,2019-12-31,2020-09-01,149181579,0,149181579
20954,CVCB3,2020-03-31,2020-09-30,149328579,0,149328579
20955,CVCB3,2020-06-30,2020-10-20,149328579,0,149328579
20956,CVCB3,2020-09-30,2020-11-13,172828579,0,172828579
20957,OMGE3,2013-12-31,2014-07-11,312610024,0,312610024
20958,OMGE3,2014-03-31,2014-07-11,312610,0,312610
20959,OMGE3,2014-06-30,2014-08-14,312610,0,312610
20960,OMGE3,2014-09-30,2014-11-14,312610,0,312610
20961,OMGE3,2014-12-31,2015-03-30,312610,0,312610
20962,OMGE3,2015-03-31,2015-05-15,312610,0,312610
20963,OMGE3,2015-06-30,2015-08-14,312610,0,312610
20964,OMGE3,2015-09-30,2015-11-13,312610,0,312610
20965,OMGE3,2015-12-31,2017-05-10,312610,0,312610
20966,OMGE3,2016-03-31,2016-05-17,312610,0,312610
20967,OMGE3,2016-06-30,2016-08-12,312610,0,312610
20968,OMGE3,2016-09-30,2016-11-09,312610,0,312610
20969,OMGE3,2016-12-31,2017-05-10,312610,0,312610
20970,OMGE3,2017-03-31,2017-05-10,312610,0,312610
20971,OMGE3,2017-06-30,2017-08-14,448622,0,448622
20972,OMGE3,2017-09-30,2017-11-14,79384,0,79384
20973,OMGE3,2017-12-31,2018-04-24,117800,0,117800
20974,OMGE3,2018-03-31,2018-05-15,117800,0,117800
20975,OMGE3,2018-06-30,2018-08-14,117800,0,117800
20976,OMGE3,2018-09-30,2018-11-05,117800,0,117800
20977,OMGE3,2018-12-31,2019-09-11,117800,0,117800
20978,OMGE3,2019-03-31,2019-05-06,124367,0,124367
20979,OMGE3,2019-06-30,2019-08-14,137047,0,137047
20980,OMGE3,2019-09-30,2019-11-05,164849,0,164849
20981,OMGE3,2019-12-31,2020-03-02,164849,0,164849
20982,OMGE3,2020-03-31,2020-05-15,169964,0,169964
20983,OMGE3,2020-06-30,2020-08-05,170133,0,170133
20984,OMGE3,2020-09-30,2020-11-05,195754,0,195754
20985,OMGE3,2020-12-31,2021-03-19,195912131,0,195912131
20986,RLOG3,2013-12-31,2014-09-12,939753176,0,939753176
20987,RLOG3,2014-03-31,2014-09-12,979753176,0,979753176
20988,RLOG3,2014-06-30,2014-09-12,939753176,0,939753176
20989,RLOG3,2014-09-30,2014-11-05,940753176,0,940753176
20990,RLOG3,2014-12-31,2015-03-18,405856814,0,405856814
20991,RLOG3,2015-03-31,2015-05-06,405856814,0,405856814
20992,RLOG3,2015-06-30,2015-08-13,405856814,0,405856814
20993,RLOG3,2015-09-30,2015-11-05,405856814,0,405856814
20994,RLOG3,2015-12-31,2016-02-25,405856814,0,405856814
20995,RLOG3,2016-03-31,2016-05-04,405856814,0,405856814
20996,RLOG3,2016-06-30,2016-08-10,365100567,0,365100567
20997,RLOG3,2016-09-30,2016-11-09,365429943,0,365429943
20998,RLOG3,2016-12-31,2017-02-21,366490593,0,366490593
20999,RLOG3,2017-03-31,2017-05-10,366490593,0,366490593
21000,RLOG3,2017-06-30,2017-08-09,368046576,0,368046576
21001,RLOG3,2017-09-30,2017-11-08,368046576,0,368046576
21002,RLOG3,2017-12-31,2018-03-26,463224241,0,463224241
21003,RLOG3,2018-03-31,2018-05-08,463224241,0,463224241
21004,RLOG3,2018-06-30,2018-08-13,463224241,0,463224241
21005,RLOG3,2018-09-30,2018-11-08,463224241,0,463224241
21006,RLOG3,2018-12-31,2019-02-13,463224241,0,463224241
21007,RLOG3,2019-03-31,2019-05-10,463224241,0,463224241
21008,RLOG3,2019-06-30,2019-08-13,463224241,0,463224241
21009,RLOG3,2019-09-30,2019-11-12,463224241,0,463224241
21010,RLOG3,2019-12-31,2020-02-17,463224241,0,463224241
21011,RLOG3,2020-03-31,2020-05-28,463224241,0,463224241
21012,RLOG3,2020-06-30,2020-08-14,463224241,0,463224241
21013,RLOG3,2020-09-30,2020-11-12,463224241,0,463224241
21014,DMMO3,2013-12-31,2014-09-19,8476908148,0,8476908148
21015,DMMO3,2014-03-31,2014-09-19,8493388831,0,8493388831
21016,DMMO3,2014-06-30,2014-09-19,8476908148,0,8476908148
21017,DMMO3,2014-09-30,2014-12-23,8606483363,0,8606483363
21018,DMMO3,2014-12-31,2015-03-23,120758380,0,120758380
21019,DMMO3,2015-03-31,2015-05-14,120758380,0,120758380
21020,DMMO3,2015-06-30,2015-08-13,120758380,0,120758380
21021,DMMO3,2015-09-30,2015-11-16,120758380,0,120758380
21022,DMMO3,2015-12-31,2016-03-28,120758380,0,120758380
21023,DMMO3,2016-03-31,2016-05-19,120758380,0,120758380
21024,DMMO3,2016-06-30,2016-08-12,133272201,0,133272201
21025,DMMO3,2016-09-30,2016-11-11,133272201,0,133272201
21026,DMMO3,2016-12-31,2017-03-17,133272201,0,133272201
21027,DMMO3,2017-03-31,2017-05-08,133272201,0,133272201
21028,DMMO3,2017-06-30,2017-08-14,133272201,0,133272201
21029,DMMO3,2017-09-30,2017-11-10,133272201,0,133272201
21030,DMMO3,2017-12-31,2018-03-27,2665444020,0,2665444020
21031,DMMO3,2018-03-31,2018-05-15,2665444020,0,2665444020
21032,DMMO3,2018-06-30,2018-08-14,2665444020,0,2665444020
21033,DMMO3,2018-09-30,2018-12-10,2665444020,0,2665444020
21034,DMMO3,2018-12-31,2019-03-28,2700398881,0,2700398881
21035,DMMO3,2019-03-31,2019-05-15,2700398881,0,2700398881
21036,DMMO3,2019-06-30,2019-08-14,270040228,0,270040228
21037,DMMO3,2019-09-30,2019-11-13,270040228,0,270040228
21038,DMMO3,2019-12-31,2020-03-30,270040228,0,270040228
21039,DMMO3,2020-03-31,2020-06-23,270040228,0,270040228
21040,DMMO3,2020-06-30,2020-08-10,270040228,0,270040228
21041,DMMO3,2020-09-30,2020-11-17,270040228,0,270040228
21042,OFSA3,2014-06-30,2014-10-21,188627485,0,188627485
21043,OFSA3,2014-09-30,2014-11-14,50000000,0,50000000
21044,OFSA3,2014-12-31,2015-03-25,53942307,0,53942307
21045,OFSA3,2015-03-31,2015-05-05,53942307,0,53942307
21046,OFSA3,2015-06-30,2015-08-11,53942307,0,53942307
21047,OFSA3,2015-09-30,2015-10-26,53942307,0,53942307
21048,OFSA3,2015-12-31,2016-03-22,53942307,0,53942307
21049,OFSA3,2016-03-31,2016-05-10,53942307,0,53942307
21050,OFSA3,2016-06-30,2016-08-09,53942307,0,53942307
21051,OFSA3,2016-09-30,2016-11-14,53949006,0,53949006
21052,OFSA3,2016-12-31,2017-03-21,53949006,0,53949006
21053,OFSA3,2017-03-31,2017-05-09,53949006,0,53949006
21054,OFSA3,2017-06-30,2017-08-08,53949006,0,53949006
21055,OFSA3,2017-09-30,2017-11-09,53949006,0,53949006
21056,OFSA3,2017-12-31,2018-03-06,53949006,0,53949006
21057,OFSA3,2018-03-31,2018-05-08,53949006,0,53949006
21058,OFSA3,2018-06-30,2018-08-07,53949006,0,53949006
21059,OFSA3,2018-09-30,2018-11-06,53949006,0,53949006
21060,OFSA3,2018-12-31,2019-02-26,53949006,0,53949006
21061,OFSA3,2019-03-31,2019-05-07,53949006,0,53949006
21062,OFSA3,2019-06-30,2019-08-07,53949006,0,53949006
21063,OFSA3,2019-09-30,2020-02-11,53949006,0,53949006
21064,OFSA3,2019-12-31,2020-02-11,53949006,0,53949006
21065,OFSA3,2020-03-31,2020-05-12,53949006,0,53949006
21066,OFSA3,2020-06-30,2020-08-06,53949006,0,53949006
21067,OFSA3,2020-09-30,2020-11-09,53949006,0,53949006
21068,OFSA3,2020-12-31,2021-03-04,53949006,0,53949006
21069,MEAL3,2011-12-31,2015-03-24,67636917,0,67636917
21070,MEAL3,2012-12-31,2015-03-24,68536917,0,68536917
21071,MEAL3,2013-12-31,2015-03-24,68536917,0,68536917
21072,MEAL3,2014-03-31,2015-03-24,68536917,0,68536917
21073,MEAL3,2014-06-30,2015-03-24,68536917,0,68536917
21074,MEAL3,2014-09-30,2015-03-24,68536917,0,68536917
21075,MEAL3,2014-12-31,2015-03-30,84482793,0,84482793
21076,MEAL3,2015-03-31,2015-05-18,84482793,0,84482793
21077,MEAL3,2015-06-30,2015-08-10,84482793,0,84482793
21078,MEAL3,2015-09-30,2015-11-11,84482793,0,84482793
21079,MEAL3,2015-12-31,2016-03-22,84482793,0,84482793
21080,MEAL3,2016-03-31,2016-05-11,166531600,0,166531600
21081,MEAL3,2016-06-30,2016-08-16,166531600,0,166531600
21082,MEAL3,2016-09-30,2016-11-10,166531600,0,166531600
21083,MEAL3,2016-12-31,2017-03-28,166531600,0,166531600
21084,MEAL3,2017-03-31,2017-05-10,166531600,0,166531600
21085,MEAL3,2017-06-30,2017-08-10,166531600,0,166531600
21086,MEAL3,2017-09-30,2017-10-26,166531600,0,166531600
21087,MEAL3,2017-12-31,2018-03-27,166531600,0,166531600
21088,MEAL3,2018-03-31,2018-05-11,166531600,0,166531600
21089,MEAL3,2018-06-30,2018-08-14,166531600,0,166531600
21090,MEAL3,2018-09-30,2018-11-08,166531600,0,166531600
21091,MEAL3,2018-12-31,2019-03-29,166531600,0,166531600
21092,MEAL3,2019-03-31,2019-05-14,166531600,0,166531600
21093,MEAL3,2019-06-30,2019-08-14,166531600,0,166531600
21094,MEAL3,2019-09-30,2019-11-12,166531600,0,166531600
21095,MEAL3,2019-12-31,2020-03-30,195919530,0,195919530
21096,MEAL3,2020-03-31,2020-06-01,195919530,0,195919530
21097,MEAL3,2020-06-30,2020-08-31,195919530,0,195919530
21098,MEAL3,2020-09-30,2020-11-16,286369530,0,286369530
21099,WIZS3,2014-12-31,2015-05-13,159907,0,159907
21100,WIZS3,2015-03-31,2015-05-13,159907,0,159907
21101,WIZS3,2015-06-30,2015-08-12,159907,0,159907
21102,WIZS3,2015-09-30,2015-11-04,159907,0,159907
21103,WIZS3,2015-12-31,2016-03-02,159907,0,159907
21104,WIZS3,2016-03-31,2016-05-11,159907,0,159907
21105,WIZS3,2016-06-30,2016-08-10,159907,0,159907
21106,WIZS3,2016-09-30,2016-11-10,159907,0,159907
21107,WIZS3,2016-12-31,2017-03-16,159907282,0,159907282
21108,WIZS3,2017-03-31,2017-05-11,159907,0,159907
21109,WIZS3,2017-06-30,2017-08-14,159907,0,159907
21110,WIZS3,2017-09-30,2017-11-08,159907,0,159907
21111,WIZS3,2017-12-31,2018-02-28,159907282,0,159907282
21112,WIZS3,2018-03-31,2018-05-09,159907282,0,159907282
21113,WIZS3,2018-06-30,2018-08-08,159907282,0,159907282
21114,WIZS3,2018-09-30,2018-11-07,159907282,0,159907282
21115,WIZS3,2018-12-31,2019-02-26,159907282,0,159907282
21116,WIZS3,2019-03-31,2019-05-08,159907282,0,159907282
21117,WIZS3,2019-06-30,2019-08-14,159907282,0,159907282
21118,WIZS3,2019-09-30,2019-11-06,159907282,0,159907282
21119,WIZS3,2019-12-31,2020-02-20,159907282,0,159907282
21120,WIZS3,2020-03-31,2020-05-07,159907182,0,159907182
21121,WIZS3,2020-06-30,2020-08-06,159907282,0,159907282
21122,WIZS3,2020-09-30,2020-11-26,159907282,0,159907282
21123,WIZS3,2020-12-31,2021-03-04,159907282,0,159907282
21124,MSRO3,2014-12-31,2015-05-28,1733988,0,1733988
21125,MSRO3,2015-03-31,2015-05-28,1733988,0,1733988
21126,MSRO3,2015-06-30,2015-08-10,1733988,0,1733988
21127,MSRO3,2015-09-30,2015-11-13,1733988,0,1733988
21128,MSRO3,2015-12-31,2016-03-30,1733988,0,1733988
21129,MSRO3,2016-03-31,2016-05-13,1733988,0,1733988
21130,MSRO3,2016-06-30,2016-08-15,1733988,0,1733988
21131,MSRO3,2016-09-30,2016-11-11,1733988,0,1733988
21132,MSRO3,2016-12-31,2017-03-28,1733988,0,1733988
21133,MSRO3,2017-03-31,2017-05-15,1733988,0,1733988
21134,MSRO3,2017-06-30,2017-08-14,1733988,0,1733988
21135,MSRO3,2017-09-30,2017-11-14,1733988,0,1733988
21136,MSRO3,2017-12-31,2018-03-26,1733988,0,1733988
21137,MSRO3,2018-03-31,2018-05-15,1733988,0,1733988
21138,MSRO3,2018-06-30,2018-08-17,1733988,0,1733988
21139,MSRO3,2018-09-30,2018-11-14,1733988,0,1733988
21140,MSRO3,2018-12-31,2019-03-28,1733988,0,1733988
21141,MSRO3,2019-03-31,2019-05-15,1733988,0,1733988
21142,MSRO3,2019-06-30,2019-08-14,1733988,0,1733988
21143,MSRO3,2019-09-30,2019-11-26,1733988,0,1733988
21144,MSRO3,2019-12-31,2020-03-23,1733988,0,1733988
21145,MSRO3,2020-03-31,2020-05-12,1733988,0,1733988
21146,MSRO3,2020-06-30,2020-08-24,1733988,0,1733988
21147,MSRO3,2020-09-30,2020-11-12,26009820,0,26009820
21148,BRQB3,2014-12-31,2016-01-13,99999900,29974447,129974347
21149,BRQB3,2015-03-31,2016-01-13,99999900,29974447,129974347
21150,BRQB3,2015-06-30,2016-01-13,129974347,0,129974347
21151,BRQB3,2015-09-30,2016-01-13,129996569,0,129996569
21152,BRQB3,2015-12-31,2016-04-01,129996569,0,129996569
21153,BRQB3,2016-03-31,2016-05-13,129996569,0,129996569
21154,BRQB3,2016-06-30,2016-08-12,129996569,0,129996569
21155,BRQB3,2016-09-30,2016-11-11,129996569,0,129996569
21156,BRQB3,2016-12-31,2017-03-10,129996569,0,129996569
21157,BRQB3,2017-03-31,2017-05-15,129970482,0,129970482
21158,BRQB3,2017-06-30,2017-08-14,129970482,0,129970482
21159,BRQB3,2017-09-30,2017-11-14,129957439,0,129957439
21160,BRQB3,2017-12-31,2018-02-21,129957439,0,129957439
21161,BRQB3,2018-03-31,2018-05-15,129957439,0,129957439
21162,BRQB3,2018-06-30,2018-08-14,129957439,0,129957439
21163,BRQB3,2018-09-30,2018-11-14,130724698,0,130724698
21164,BRQB3,2018-12-31,2019-02-14,130724698,0,130724698
21165,BRQB3,2019-03-31,2019-05-15,130724698,0,130724698
21166,BRQB3,2019-06-30,2020-05-18,130724698,0,130724698
21167,BRQB3,2019-09-30,2019-11-14,130724698,0,130724698
21168,BRQB3,2019-12-31,2020-02-14,130724698,0,130724698
21169,BRQB3,2020-03-31,2020-05-15,133186083,0,133186083
21170,BRQB3,2020-06-30,2020-08-14,133186083,0,133186083
21171,BRQB3,2020-09-30,2020-12-01,133186083,0,133186083
21172,BRQB3,2020-12-31,2021-02-17,132975127,0,132975127
21173,MOVI3,2014-12-31,2016-02-01,600241000,0,600241000
21174,MOVI3,2015-03-31,2016-02-01,624250000,0,624250000
21175,MOVI3,2015-06-30,2016-02-01,624250000,0,624250000
21176,MOVI3,2015-09-30,2016-02-01,624250000,0,624250000
21177,MOVI3,2015-12-31,2016-04-01,624250238,0,624250238
21178,MOVI3,2016-03-31,2016-05-13,624250238,0,624250238
21179,MOVI3,2016-06-30,2017-03-28,624250238,0,624250238
21180,MOVI3,2016-09-30,2017-01-11,715629238,0,715629238
21181,MOVI3,2016-12-31,2017-03-22,715629238,0,715629238
21182,MOVI3,2017-03-31,2017-04-28,213491586,0,213491586
21183,MOVI3,2017-06-30,2017-08-08,213491586,0,213491586
21184,MOVI3,2017-09-30,2017-11-08,213491586,0,213491586
21185,MOVI3,2017-12-31,2018-03-21,213491586,0,213491586
21186,MOVI3,2018-03-31,2018-05-28,213491586,0,213491586
21187,MOVI3,2018-06-30,2018-08-08,213491586,0,213491586
21188,MOVI3,2018-09-30,2019-01-16,212846643,0,212846643
21189,MOVI3,2018-12-31,2019-04-02,263421014,0,263421014
21190,MOVI3,2019-03-31,2019-04-30,263421014,0,263421014
21191,MOVI3,2019-06-30,2019-08-28,263421014,0,263421014
21192,MOVI3,2019-09-30,2019-11-18,298921014,0,298921014
21193,MOVI3,2019-12-31,2020-03-10,298921014,0,298921014
21194,MOVI3,2020-03-31,2020-05-25,298921014,0,298921014
21195,MOVI3,2020-06-30,2020-08-12,298921014,0,298921014
21196,MOVI3,2020-09-30,2020-11-10,298921014,0,298921014
21197,MOVI3,2020-12-31,2021-02-23,298921014,0,298921014
21198,CNSY3,2015-12-31,2016-07-21,19417644,0,19417644
21199,CNSY3,2016-03-31,2016-07-21,19417644,0,19417644
21200,CNSY3,2016-06-30,2016-08-12,19417644,0,19417644
21201,CNSY3,2016-09-30,2016-11-11,19417644,0,19417644
21202,CNSY3,2016-12-31,2017-04-18,19417644,0,19417644
21203,CNSY3,2017-03-31,2017-05-15,19417644,0,19417644
21204,CNSY3,2017-06-30,2017-08-14,19417644,0,19417644
21205,CNSY3,2017-09-30,2017-11-14,19417644,0,19417644
21206,CNSY3,2017-12-31,2018-03-19,19417644,0,19417644
21207,CNSY3,2018-03-31,2018-05-14,19417644,0,19417644
21208,CNSY3,2018-06-30,2018-08-14,19417644,0,19417644
21209,CNSY3,2018-09-30,2018-11-14,30969063,0,30969063
21210,CNSY3,2018-12-31,2019-03-22,30969063,0,30969063
21211,CNSY3,2019-03-31,2019-05-15,30969063,0,30969063
21212,CNSY3,2019-06-30,2019-08-14,30969063,0,30969063
21213,CNSY3,2019-09-30,2019-11-14,30969063,0,30969063
21214,CNSY3,2019-12-31,2020-03-27,30969063,0,30969063
21215,CNSY3,2020-03-31,2020-06-05,30969063,0,30969063
21216,CNSY3,2020-06-30,2020-08-28,30969063,0,30969063
21217,CNSY3,2020-09-30,2020-11-16,30969063,0,30969063
21218,CNSY3,2020-12-31,2021-03-26,30969063,0,30969063
21219,CTCA3,2016-03-31,2016-08-31,760001,0,760001
21220,CTCA3,2016-06-30,2016-08-26,760001,0,760001
21221,CTCA3,2016-09-30,2016-11-11,760001,0,760001
21222,CTCA3,2016-12-31,2017-02-14,801870,0,801870
21223,CTCA3,2017-03-31,2017-06-13,801870,0,801870
21224,CTCA3,2017-06-30,2017-08-14,801870,0,801870
21225,CTCA3,2017-09-30,2017-11-17,760001,0,760001
21226,CTCA3,2017-12-31,2018-02-09,760001,0,760001
21227,CTCA3,2018-03-31,2018-06-20,760001,0,760001
21228,CTCA3,2018-06-30,2018-08-14,760001,0,760001
21229,CTCA3,2018-09-30,2018-11-14,760001,0,760001
21230,CTCA3,2018-12-31,2019-02-12,801870,0,801870
21231,CTCA3,2019-03-31,2019-06-19,801870,0,801870
21232,CTCA3,2019-06-30,2019-08-14,801870,0,801870
21233,CTCA3,2019-09-30,2019-11-14,801870,0,801870
21234,CTCA3,2019-12-31,2020-02-27,801870,0,801870
21235,CTCA3,2020-03-31,2020-06-19,801870,0,801870
21236,CTCA3,2020-06-30,2020-08-14,801870,0,801870
21237,CTCA3,2020-09-30,2020-10-22,801870,0,801870
21238,CTCA3,2020-12-31,2021-01-28,801870,0,801870
21239,AALR3,2015-12-31,2016-12-04,49923660,49923660,99847320
21240,AALR3,2016-03-31,2016-12-04,49923660,49923660,99847320
21241,AALR3,2016-06-30,2016-12-04,49923660,49923660,99847320
21242,AALR3,2016-09-30,2016-12-04,49923660,50032820,99956480
21243,AALR3,2016-12-31,2017-03-22,114898767,0,114898767
21244,AALR3,2017-03-31,2017-05-10,114898767,0,114898767
21245,AALR3,2017-06-30,2017-08-10,118292816,0,118292816
21246,AALR3,2017-09-30,2017-11-08,118292816,0,118292816
21247,AALR3,2017-12-31,2018-03-28,118292816,0,118292816
21248,AALR3,2018-03-31,2018-05-10,118292816,0,118292816
21249,AALR3,2018-06-30,2018-08-13,118292816,0,118292816
21250,AALR3,2018-09-30,2018-11-13,118292816,0,118292816
21251,AALR3,2018-12-31,2019-03-19,118292816,0,118292816
21252,AALR3,2019-03-31,2019-05-13,118292816,0,118292816
21253,AALR3,2019-06-30,2019-08-13,118292816,0,118292816
21254,AALR3,2019-09-30,2019-11-12,118292816,0,118292816
21255,AALR3,2019-12-31,2020-03-17,118292816,0,118292816
21256,AALR3,2020-03-31,2020-05-19,118292816,0,118292816
21257,AALR3,2020-06-30,2020-08-20,118292816,0,118292816
21258,AALR3,2020-09-30,2020-11-12,118292816,0,118292816
21259,AALR3,2020-12-31,2021-03-17,118292816,0,118292816
21260,PARD3,2016-03-31,2017-02-14,3634,0,3634
21261,PARD3,2016-06-30,2017-02-14,3634,0,3634
21262,PARD3,2016-09-30,2017-02-14,3634,0,3634
21263,PARD3,2016-12-31,2017-03-27,3634,0,3634
21264,PARD3,2017-03-31,2017-05-04,130979,0,130979
21265,PARD3,2017-06-30,2017-08-14,130979,0,130979
21266,PARD3,2017-09-30,2017-11-13,130979,0,130979
21267,PARD3,2017-12-31,2018-03-22,130909,0,130909
21268,PARD3,2018-03-31,2018-05-07,130979,0,130979
21269,PARD3,2018-06-30,2018-08-07,130979,0,130979
21270,PARD3,2018-09-30,2018-11-08,130979,0,130979
21271,PARD3,2018-12-31,2019-03-15,130979,0,130979
21272,PARD3,2019-03-31,2019-05-07,130979,0,130979
21273,PARD3,2019-06-30,2019-08-12,130979,0,130979
21274,PARD3,2019-09-30,2019-11-05,130979,0,130979
21275,PARD3,2019-12-31,2020-03-31,130979,0,130979
21276,PARD3,2020-03-31,2020-05-18,130979,0,130979
21277,PARD3,2020-06-30,2020-08-13,130979,0,130979
21278,PARD3,2020-09-30,2020-11-05,130979,0,130979
21279,PARD3,2020-12-31,2021-03-24,130979,0,130979
21280,AZUL4,2016-12-31,2017-04-11,928965058,254571226,1183536284
21281,AZUL4,2017-03-31,2017-05-15,928965058,254571266,1183536324
21282,AZUL4,2017-06-30,2017-08-14,928965058,317571266,1246536324
21283,AZUL4,2017-09-30,2017-11-09,928965058,320086893,1249051951
21284,AZUL4,2017-12-31,2018-03-09,928965058,321650720,1250615778
21285,AZUL4,2018-03-31,2019-05-20,928965058,323965337,1252930395
21286,AZUL4,2018-06-30,2018-08-09,928965058,325992745,1254957803
21287,AZUL4,2018-09-30,2018-11-08,928965058,326063741,1255028799
21288,AZUL4,2018-12-31,2019-03-15,928965058,326631190,1255596248
21289,AZUL4,2019-03-31,2019-05-09,928965058,327175146,1256140204
21290,AZUL4,2019-06-30,2019-08-08,928965058,329115383,1258080441
21291,AZUL4,2019-09-30,2019-11-07,928965058,329359720,1258324778
21292,AZUL4,2019-12-31,2020-03-12,928965058,329568166,1258533224
21293,AZUL4,2020-03-31,2020-05-14,928965058,329703517,1258668575
21294,AZUL4,2020-06-30,2020-08-13,928965058,329703517,1258668575
21295,AZUL4,2020-09-30,2020-11-16,928965058,329904767,1258869825
21296,AZUL4,2020-12-31,2021-03-04,928965058,331644724,1260609782
21297,PACF3,2016-03-31,2017-07-11,4393387735,0,4393387735
21298,PACF3,2016-06-30,2017-07-11,5289275277,0,5289275277
21299,PACF3,2016-09-30,2017-07-11,5289275277,0,5289275277
21300,PACF3,2016-12-31,2017-07-11,5289603624,0,5289603624
21301,PACF3,2017-03-31,2017-07-11,5289603624,0,5289603624
21302,PACF3,2017-06-30,2017-08-14,5289603624,0,5289603624
21303,PACF3,2017-09-30,2017-11-10,5289603624,0,5289603624
21304,PACF3,2017-12-31,2018-02-14,5289603624,0,5289603624
21305,PACF3,2018-03-31,2018-06-29,5345720905,0,5345720905
21306,PACF3,2018-06-30,2018-08-14,5345720907,0,5345720907
21307,PACF3,2018-09-30,2018-11-13,5345720907,0,5345720907
21308,PACF3,2018-12-31,2019-02-18,5470720905,0,5470720905
21309,CRFB3,2016-12-31,2017-07-20,1775076589,0,1775076589
21310,CRFB3,2017-03-31,2017-07-20,1775076589,0,1775076589
21311,CRFB3,2017-06-30,2017-08-11,1775076589,0,1775076589
21312,CRFB3,2017-09-30,2017-11-09,1980958942,0,1980958942
21313,CRFB3,2017-12-31,2018-02-27,1980958942,0,1980958942
21314,CRFB3,2018-03-31,2018-05-15,1981709041,0,1981709041
21315,CRFB3,2018-06-30,2018-07-25,1981844854,0,1981844854
21316,CRFB3,2018-09-30,2018-11-07,1982672519,0,1982672519
21317,CRFB3,2018-12-31,2019-02-26,1983437967,0,1983437967
21318,CRFB3,2019-03-31,2019-05-09,1983527147,0,1983527147
21319,CRFB3,2019-06-30,2019-07-24,1983727443,0,1983727443
21320,CRFB3,2019-09-30,2019-11-06,1984106480,0,1984106480
21321,CRFB3,2019-12-31,2020-02-20,1984655599,0,1984655599
21322,CRFB3,2020-03-31,2020-05-11,1984942648,0,1984942648
21323,CRFB3,2020-06-30,2020-07-27,1985019050,0,1985019050
21324,CRFB3,2020-09-30,2020-11-10,1985199050,0,1985199050
21325,CRFB3,2020-12-31,2021-02-17,1985199050,0,1985199050
21326,IRBR3,2016-12-31,2017-07-31,310698900,1,310698901
21327,IRBR3,2017-03-31,2017-07-31,310698900,1,310698901
21328,IRBR3,2017-06-30,2017-08-04,310698900,1,310698901
21329,IRBR3,2017-09-30,2017-10-31,310698900,1,310698901
21330,IRBR3,2017-12-31,2018-02-08,310415400,0,310415400
21331,IRBR3,2018-03-31,2018-05-03,310698900,0,310698900
21332,IRBR3,2018-06-30,2018-08-02,310698900,0,310698900
21333,IRBR3,2018-09-30,2018-10-31,310415400,0,310415400
21334,IRBR3,2018-12-31,2019-03-08,312000000,1,312000001
21335,IRBR3,2019-03-31,2019-05-06,312000000,1,312000001
21336,IRBR3,2019-06-30,2019-08-05,312000000,1,312000001
21337,IRBR3,2019-09-30,2019-11-06,936000000,1,936000001
21338,IRBR3,2019-12-31,2021-02-18,936000000,1,936000001
21339,IRBR3,2020-03-31,2020-06-30,936000000,1,936000001
21340,IRBR3,2020-06-30,2020-08-28,936000000,1,936000001
21341,IRBR3,2020-09-30,2020-11-03,1267890331,1,1267890332
21342,IRBR3,2020-12-31,2021-02-18,1267890331,1,1267890332
21343,STTR3,2016-12-31,2017-09-19,297498383,0,297498383
21344,STTR3,2017-03-31,2017-09-19,297498383,0,297498383
21345,STTR3,2017-06-30,2017-09-19,297498383,0,297498383
21346,STTR3,2017-09-30,2017-11-10,297498383,0,297498383
21347,STTR3,2017-12-31,2018-03-27,297498383,0,297498383
21348,STTR3,2018-03-31,2018-05-14,297498383,0,297498383
21349,STTR3,2018-06-30,2018-08-13,297498383,0,297498383
21350,STTR3,2018-09-30,2018-11-13,297498383,0,297498383
21351,STTR3,2018-12-31,2019-03-25,297498383,0,297498383
21352,STTR3,2019-03-31,2019-05-14,297498383,0,297498383
21353,STTR3,2019-06-30,2019-08-13,297498383,0,297498383
21354,STTR3,2019-09-30,2019-11-13,297498383,0,297498383
21355,STTR3,2019-12-31,2020-03-23,297498383,0,297498383
21356,STTR3,2020-03-31,2020-06-25,297498383,0,297498383
21357,STTR3,2020-06-30,2020-08-13,297498383,0,297498383
21358,STTR3,2020-09-30,2020-11-12,297498383,0,297498383
21359,CAML3,2017-02-28,2017-09-28,123017292,0,123017292
21360,CAML3,2017-05-31,2017-09-28,123017292,0,123017292
21361,CAML3,2017-08-31,2017-10-13,369051876,0,369051876
21362,CAML3,2017-11-30,2018-01-11,410051876,0,410051876
21363,CAML3,2018-02-28,2018-05-28,410051876,0,410051876
21364,CAML3,2018-05-31,2018-07-13,410051876,0,410051876
21365,CAML3,2018-08-31,2018-10-09,410051876,0,410051876
21366,CAML3,2018-11-30,2019-01-10,410051876,0,410051876
21367,CAML3,2019-02-28,2019-05-09,410051876,0,410051876
21368,CAML3,2019-05-31,2019-07-11,410051876,0,410051876
21369,CAML3,2019-08-31,2019-10-10,410051876,0,410051876
21370,CAML3,2019-11-30,2020-01-09,370000000,0,370000000
21371,CAML3,2020-02-29,2020-05-14,370000000,0,370000000
21372,CAML3,2020-05-31,2020-07-07,370000000,0,370000000
21373,CAML3,2020-08-31,2020-10-09,370000000,0,370000000
21374,CAML3,2020-11-30,2021-01-07,370000000,0,370000000
21375,PRNR3,2016-12-31,2017-10-03,93077010,0,93077010
21376,PRNR3,2017-03-31,2017-10-03,93077010,0,93077010
21377,PRNR3,2017-06-30,2017-10-03,93077010,0,93077010
21378,PRNR3,2017-09-30,2017-11-22,93077010,0,93077010
21379,PRNR3,2017-12-31,2018-03-29,93708314,0,93708314
21380,PRNR3,2018-03-31,2018-05-30,93708314,0,93708314
21381,PRNR3,2018-06-30,2018-08-14,104873362,0,104873362
21382,PRNR3,2018-09-30,2018-11-14,104873362,0,104873362
21383,PRNR3,2018-12-31,2020-01-23,104873362,0,104873362
21384,PRNR3,2019-03-31,2019-05-15,104873362,0,104873362
21385,PRNR3,2019-06-30,2019-08-14,104873362,0,104873362
21386,PRNR3,2019-09-30,2020-01-23,104873362,0,104873362
21387,PRNR3,2019-12-31,2020-03-30,20653497,0,20653497
21388,PRNR3,2020-03-31,2020-06-29,38044801,0,38044801
21389,PRNR3,2020-06-30,2020-08-14,38044801,0,38044801
21390,PRNR3,2020-09-30,2020-11-13,38748616,0,38748616
21391,SMLS3,2016-12-31,2017-10-13,475477090,0,475477090
21392,SMLS3,2017-03-31,2017-10-13,475477090,0,475477090
21393,SMLS3,2017-06-30,2017-10-13,1,0,1
21394,SMLS3,2017-09-30,2017-11-06,123856953,0,123856953
21395,SMLS3,2017-12-31,2018-02-27,123856953,0,123856953
21396,SMLS3,2018-03-31,2018-05-07,124007953,0,124007953
21397,SMLS3,2018-06-30,2018-07-31,124007953,0,124007953
21398,SMLS3,2018-09-30,2018-10-31,124007953,0,124007953
21399,SMLS3,2018-12-31,2019-02-14,124007953,0,124007953
21400,SMLS3,2019-03-31,2019-04-26,124158953,0,124158953
21401,SMLS3,2019-06-30,2019-07-30,124158953,0,124158953
21402,SMLS3,2019-09-30,2019-10-29,124158953,0,124158953
21403,SMLS3,2019-12-31,2020-02-18,124158953,0,124158953
21404,SMLS3,2020-03-31,2020-04-28,124158953,0,124158953
21405,SMLS3,2020-06-30,2020-07-28,124158953,0,124158953
21406,SMLS3,2020-09-30,2020-10-27,124158953,0,124158953
21407,SMLS3,2020-12-31,2021-03-08,124158953,0,124158953
21408,SMFT3,2016-12-31,2018-05-30,11058,3552,14610
21409,SMFT3,2017-03-31,2017-10-23,11058,3552,14610
21410,SMFT3,2017-06-30,2017-10-23,11058,3552,14610
21411,SMFT3,2017-09-30,2018-01-19,11058,3552,14610
21412,SMFT3,2017-12-31,2018-05-30,11058,3552,14610
21413,SMFT3,2018-03-31,2018-05-16,11058,4311,15369
21414,SMFT3,2018-06-30,2018-08-16,11058,4054,15112
21415,SMFT3,2018-09-30,2018-11-15,11058,5144,16202
21416,SMFT3,2018-12-31,2019-03-30,11058,7314,18372
21417,SMFT3,2019-03-31,2019-05-20,11058,7314,18372
21418,SMFT3,2019-06-30,2019-09-25,11058,7146,18204
21419,SMFT3,2019-09-30,2019-11-15,11058,7146,18204
21420,SMFT3,2019-12-31,2020-04-03,14602,6464,21066
21421,SMFT3,2020-03-31,2020-05-29,14712,6464,21176
21422,SMFT3,2020-06-30,2020-08-28,14602,6464,21066
21423,SMFT3,2020-09-30,2020-11-14,14602,6464,21066
21424,INNT3,2016-12-31,2017-11-13,12371189,0,12371189
21425,INNT3,2017-03-31,2017-11-13,12371189,0,12371189
21426,INNT3,2017-06-30,2017-11-13,12371189,0,12371189
21427,INNT3,2017-09-30,2017-11-14,12371189,0,12371189
21428,INNT3,2017-12-31,2018-01-30,12371189,0,12371189
21429,INNT3,2018-03-31,2018-05-21,12371189,0,12371189
21430,INNT3,2018-06-30,2018-08-14,20060181,0,20060181
21431,INNT3,2018-09-30,2019-12-17,20060081,0,20060081
21432,INNT3,2018-12-31,2020-04-14,20260784,0,20260784
21433,INNT3,2019-03-31,2019-07-12,50651956,0,50651956
21434,INNT3,2019-06-30,2019-08-15,50651956,0,50651956
21435,INNT3,2019-09-30,2019-12-14,50651956,0,50651956
21436,INNT3,2019-12-31,2020-04-27,50651957,0,50651957
21437,INNT3,2020-03-31,2020-06-21,86885350,0,86885350
21438,INNT3,2020-06-30,2020-08-28,86885350,0,86885350
21439,INNT3,2020-09-30,2020-11-13,86885350,0,86885350
21440,BRDT3,2016-12-31,2017-12-14,1165000,0,1165000
21441,BRDT3,2017-03-31,2017-12-14,1165000,0,1165000
21442,BRDT3,2017-06-30,2017-12-14,1165000,0,1165000
21443,BRDT3,2017-09-30,2017-12-14,1165000,0,1165000
21444,BRDT3,2017-12-31,2018-03-16,1165000,0,1165000
21445,BRDT3,2018-03-31,2018-05-04,1165000,0,1165000
21446,BRDT3,2018-06-30,2018-08-01,1165000,0,1165000
21447,BRDT3,2018-09-30,2018-11-05,1165000,0,1165000
21448,BRDT3,2018-12-31,2019-02-26,1165000,0,1165000
21449,BRDT3,2019-03-31,2019-05-06,1165000,0,1165000
21450,BRDT3,2019-06-30,2019-07-31,1165000,0,1165000
21451,BRDT3,2019-09-30,2019-11-12,1165000,0,1165000
21452,BRDT3,2019-12-31,2020-03-12,1165000,0,1165000
21453,BRDT3,2020-03-31,2020-06-10,1165000,0,1165000
21454,BRDT3,2020-06-30,2020-08-11,1165000,0,1165000
21455,BRDT3,2020-09-30,2020-11-10,1165000,0,1165000
21456,BRDT3,2020-12-31,2021-03-09,1165000,0,1165000
21457,BKBR3,2016-12-31,2017-12-18,114706400,20674200,135380600
21458,BKBR3,2017-03-31,2017-12-18,114706400,20674200,135380600
21459,BKBR3,2017-06-30,2017-12-18,120713800,20674200,141388000
21460,BKBR3,2017-09-30,2017-12-18,120713800,36179800,156893600
21461,BKBR3,2017-12-31,2018-03-13,222278169,0,222278169
21462,BKBR3,2018-03-31,2018-05-10,222278169,0,222278169
21463,BKBR3,2018-06-30,2018-08-08,222278169,0,222278169
21464,BKBR3,2018-09-30,2018-11-08,222525821,0,222525821
21465,BKBR3,2018-12-31,2019-03-06,222525821,0,222525821
21466,BKBR3,2019-03-31,2019-05-13,227074970,0,227074970
21467,BKBR3,2019-06-30,2019-08-08,227381070,0,227381070
21468,BKBR3,2019-09-30,2019-11-07,228105447,0,228105447
21469,BKBR3,2019-12-31,2020-02-19,228105447,0,228105447
21470,BKBR3,2020-03-31,2020-05-28,228105447,0,228105447
21471,BKBR3,2020-06-30,2020-08-06,228105447,0,228105447
21472,BKBR3,2020-09-30,2020-11-05,228105447,0,228105447
21473,BKBR3,2020-12-31,2021-02-25,275355447,0,275355447
21474,FLEX3,2016-12-31,2018-03-05,3141,0,3141
21475,FLEX3,2017-03-31,2018-03-05,3141,0,3141
21476,FLEX3,2017-06-30,2018-03-05,3141,0,3141
21477,FLEX3,2017-09-30,2018-03-05,3248,0,3248
21478,FLEX3,2017-12-31,2018-03-29,3248,0,3248
21479,FLEX3,2018-03-31,2018-05-15,3248,0,3248
21480,FLEX3,2018-06-30,2018-08-15,3248,0,3248
21481,FLEX3,2018-09-30,2018-11-13,3248,0,3248
21482,FLEX3,2018-12-31,2019-03-29,3248,0,3248
21483,FLEX3,2019-03-31,2019-05-15,3248,0,3248
21484,FLEX3,2019-06-30,2019-08-21,3248,0,3248
21485,FLEX3,2019-09-30,2019-11-21,3248,0,3248
21486,FLEX3,2019-12-31,2020-03-31,3248,0,3248
21487,FLEX3,2020-03-31,2020-06-19,3248,0,3248
21488,FLEX3,2020-06-30,2020-08-18,3248,0,3248
21489,FLEX3,2020-09-30,2020-11-13,3248,0,3248
21490,GNDI3,2017-12-31,2018-04-23,467591549,0,467591549
21491,GNDI3,2018-03-31,2018-05-14,467591549,0,467591549
21492,GNDI3,2018-06-30,2018-08-09,488281204,0,488281204
21493,GNDI3,2018-09-30,2018-11-08,488281204,0,488281204
21494,GNDI3,2018-12-31,2019-02-25,528783790,0,528783790
21495,GNDI3,2019-03-31,2019-05-10,528783790,0,528783790
21496,GNDI3,2019-06-30,2019-08-07,528783790,0,528783790
21497,GNDI3,2019-09-30,2019-11-06,528475691,0,528475691
21498,GNDI3,2019-12-31,2020-02-20,603385083,0,603385083
21499,GNDI3,2020-03-31,2020-05-06,603385083,0,603385083
21500,GNDI3,2020-06-30,2020-08-06,603385083,0,603385083
21501,GNDI3,2020-09-30,2020-11-16,609479408,0,609479408
21502,GNDI3,2020-12-31,2021-03-16,609479408,0,609479408
21503,HAPV3,2017-12-31,2018-04-24,560000000,0,560000000
21504,HAPV3,2018-03-31,2018-05-16,560000000,0,560000000
21505,HAPV3,2018-06-30,2018-08-15,671958573,0,671958573
21506,HAPV3,2018-09-30,2018-11-14,671958573,0,671958573
21507,HAPV3,2018-12-31,2019-03-14,671958573,0,671958573
21508,HAPV3,2019-03-31,2019-05-08,671958573,0,671958573
21509,HAPV3,2019-06-30,2019-08-13,671958573,0,671958573
21510,HAPV3,2019-09-30,2019-11-13,734652573,0,734652573
21511,HAPV3,2019-12-31,2020-03-26,742985906,0,742985906
21512,HAPV3,2020-03-31,2020-05-20,742985906,0,742985906
21513,HAPV3,2020-06-30,2020-08-13,742985906,0,742985906
21514,HAPV3,2020-09-30,2020-11-12,742985906,0,742985906
21515,HAPV3,2020-12-31,2021-03-23,3714929530,0,3714929530
21516,BIDI11,2017-12-31,2018-05-01,6030415,5867641,11898056
21517,BIDI11,2018-03-31,2018-05-15,46402418,24985918,71388336
21518,BIDI11,2018-06-30,2018-07-31,50341992,49784638,100126630
21519,BIDI11,2018-09-30,2018-10-31,50767085,50643959,101411044
21520,BIDI11,2018-12-31,2019-03-11,50767085,50643959,101411044
21521,BIDI11,2019-03-31,2019-05-08,50767085,50643959,101411044
21522,BIDI11,2019-06-30,2019-08-12,50767085,50767082,101534167
21523,BIDI11,2019-09-30,2019-11-06,364451252,338353750,702805002
21524,BIDI11,2019-12-31,2020-02-12,365244096,339939438,705183534
21525,BIDI11,2020-03-31,2020-05-19,365833928,341119102,706953030
21526,BIDI11,2020-06-30,2020-08-13,365833928,341119102,706953030
21527,BIDI11,2020-09-30,2020-11-12,382116929,378322416,760439345
21528,BIDI11,2020-12-31,2021-02-25,383452029,380992616,764444645
21529,BIDI3,2017-12-31,2018-05-01,6030415,5867641,11898056
21530,BIDI3,2018-03-31,2018-05-15,46402418,24985918,71388336
21531,BIDI3,2018-06-30,2018-07-31,50341992,49784638,100126630
21532,BIDI3,2018-09-30,2018-10-31,50767085,50643959,101411044
21533,BIDI3,2018-12-31,2019-03-11,50767085,50643959,101411044
21534,BIDI3,2019-03-31,2019-05-08,50767085,50643959,101411044
21535,BIDI3,2019-06-30,2019-08-12,50767085,50767082,101534167
21536,BIDI3,2019-09-30,2019-11-06,364451252,338353750,702805002
21537,BIDI3,2019-12-31,2020-02-12,365244096,339939438,705183534
21538,BIDI3,2020-03-31,2020-05-19,365833928,341119102,706953030
21539,BIDI3,2020-06-30,2020-08-13,365833928,341119102,706953030
21540,BIDI3,2020-09-30,2020-11-12,382116929,378322416,760439345
21541,BIDI3,2020-12-31,2021-02-25,383452029,380992616,764444645
21542,BIDI4,2017-12-31,2018-05-01,6030415,5867641,11898056
21543,BIDI4,2018-03-31,2018-05-15,46402418,24985918,71388336
21544,BIDI4,2018-06-30,2018-07-31,50341992,49784638,100126630
21545,BIDI4,2018-09-30,2018-10-31,50767085,50643959,101411044
21546,BIDI4,2018-12-31,2019-03-11,50767085,50643959,101411044
21547,BIDI4,2019-03-31,2019-05-08,50767085,50643959,101411044
21548,BIDI4,2019-06-30,2019-08-12,50767085,50767082,101534167
21549,BIDI4,2019-09-30,2019-11-06,364451252,338353750,702805002
21550,BIDI4,2019-12-31,2020-02-12,365244096,339939438,705183534
21551,BIDI4,2020-03-31,2020-05-19,365833928,341119102,706953030
21552,BIDI4,2020-06-30,2020-08-13,365833928,341119102,706953030
21553,BIDI4,2020-09-30,2020-11-12,382116929,378322416,760439345
21554,BIDI4,2020-12-31,2021-02-25,383452029,380992616,764444645
21555,PTCA11,2018-09-30,2018-11-19,3355031,373242,3728273
21556,PTCA11,2018-12-31,2019-04-17,3355031,373242,3728273
21557,PTCA11,2019-03-31,2019-05-15,3355031,373242,3728273
21558,PTCA11,2019-06-30,2019-08-15,3355031,373242,3728273
21559,PTCA11,2019-09-30,2019-11-14,3355031,373242,3728273
21560,PTCA11,2019-12-31,2020-03-31,3355031,373242,3728273
21561,PTCA11,2020-03-31,2020-07-13,3355031,373242,3728273
21562,PTCA11,2020-06-30,2020-09-01,3355031,373242,3728273
21563,PTCA11,2020-09-30,2020-11-16,3355031,373242,3728273
21564,PTCA3,2018-09-30,2018-11-19,3355031,373242,3728273
21565,PTCA3,2018-12-31,2019-04-17,3355031,373242,3728273
21566,PTCA3,2019-03-31,2019-05-15,3355031,373242,3728273
21567,PTCA3,2019-06-30,2019-08-15,3355031,373242,3728273
21568,PTCA3,2019-09-30,2019-11-14,3355031,373242,3728273
21569,PTCA3,2019-12-31,2020-03-31,3355031,373242,3728273
21570,PTCA3,2020-03-31,2020-07-13,3355031,373242,3728273
21571,PTCA3,2020-06-30,2020-09-01,3355031,373242,3728273
21572,PTCA3,2020-09-30,2020-11-16,3355031,373242,3728273
21573,BMGB11,2018-12-31,2019-10-02,400007354,100000000,500007354
21574,BMGB11,2019-03-31,2019-10-02,400007354,100000000,500007354
21575,BMGB11,2019-06-30,2019-10-02,400007354,100000000,500007354
21576,BMGB11,2019-09-30,2019-11-19,400007354,100000000,500007354
21577,BMGB11,2019-12-31,2020-02-13,400007354,203448277,603455631
21578,BMGB11,2020-03-31,2020-05-28,400007354,191467177,591474531
21579,BMGB11,2020-06-30,2020-09-11,400007354,191467177,591474531
21580,BMGB11,2020-09-30,2020-11-16,400007354,191467177,591474531
21581,BMGB4,2018-12-31,2019-10-02,400007354,100000000,500007354
21582,BMGB4,2019-03-31,2019-10-02,400007354,100000000,500007354
21583,BMGB4,2019-06-30,2019-10-02,400007354,100000000,500007354
21584,BMGB4,2019-09-30,2019-11-19,400007354,100000000,500007354
21585,BMGB4,2019-12-31,2020-02-13,400007354,203448277,603455631
21586,BMGB4,2020-03-31,2020-05-28,400007354,191467177,591474531
21587,BMGB4,2020-06-30,2020-09-11,400007354,191467177,591474531
21588,BMGB4,2020-09-30,2020-11-16,400007354,191467177,591474531
21589,BBML3,2018-12-31,2019-03-29,36232057,0,36232057
21590,BBML3,2019-03-31,2019-05-15,36232,0,36232
21591,BBML3,2019-06-30,2019-08-14,37582066,0,37582066
21592,BBML3,2019-09-30,2019-11-14,37582066,0,37582066
21593,BBML3,2019-12-31,2020-02-12,40760818,0,40760818
21594,BBML3,2020-03-31,2020-06-26,40761,0,40761
21595,BBML3,2020-06-30,2020-08-05,40760818,0,40760818
21596,BBML3,2020-09-30,2020-11-16,40760818,0,40760818
21597,BBML3,2020-12-31,2021-03-15,40760818,0,40760818
21598,CNTO3,2019-03-31,2019-05-14,153035846,0,153035846
21599,CNTO3,2019-06-30,2019-08-23,210140608,0,210140608
21600,CNTO3,2019-09-30,2019-11-13,210140608,0,210140608
21601,CNTO3,2019-12-31,2020-03-27,210140608,0,210140608
21602,CNTO3,2020-03-31,2020-06-29,241015279,0,241015279
21603,CNTO3,2020-06-30,2020-08-13,241784625,0,241784625
21604,CNTO3,2020-09-30,2020-11-12,241808625,0,241808625
21605,VAMO3,2019-03-31,2019-05-08,287453495,0,287453495
21606,VAMO3,2019-06-30,2019-08-14,95817831,0,95817831
21607,VAMO3,2019-09-30,2019-11-08,95817831,0,95817831
21608,VAMO3,2019-12-31,2020-01-31,95817831,0,95817831
21609,VAMO3,2020-03-31,2020-05-14,191635662,0,191635662
21610,VAMO3,2020-06-30,2020-08-13,191635662,0,191635662
21611,VAMO3,2020-09-30,2020-10-31,191635662,0,191635662
21612,VAMO3,2020-12-31,2021-02-25,191635662,0,191635662
21613,LTLA3B,2019-09-30,2019-11-14,196713,0,196713
21614,LTLA3B,2019-12-31,2020-04-27,196713,0,196713
21615,LTLA3B,2020-03-31,2020-05-15,196713,0,196713
21616,LTLA3B,2020-06-30,2020-08-14,196713,0,196713
21617,LTLA3B,2020-09-30,2020-11-13,196713,0,196713
21618,NTCO3,2019-09-30,2019-11-13,100,0,100
21619,NTCO3,2019-12-31,2020-03-05,865659,0,865659
21620,NTCO3,2020-03-31,2020-11-12,1188271,0,1188271
21621,NTCO3,2020-06-30,2020-10-01,1251240,0,1251240
21622,NTCO3,2020-09-30,2020-11-12,1253618,0,1253618
21623,NTCO3,2020-12-31,2021-03-04,1375158,0,1375158
21624,VIVA3,2019-09-30,2019-11-13,217303107,0,217303107
21625,VIVA3,2019-12-31,2020-03-23,236197769,0,236197769
21626,VIVA3,2020-03-31,2020-05-14,236197769,0,236197769
21627,VIVA3,2020-06-30,2020-08-26,236197769,0,236197769
21628,VIVA3,2020-09-30,2020-11-12,236197769,0,236197769
21629,VIVA3,2020-12-31,2021-03-17,236197769,0,236197769
21630,RDOR3,2018-12-31,2020-11-15,919824834,0,919824834
21631,RDOR3,2019-03-31,2020-11-15,919824834,0,919824834
21632,RDOR3,2019-06-30,2020-11-15,919824834,0,919824834
21633,RDOR3,2019-09-30,2020-11-15,919824834,0,919824834
21634,RDOR3,2019-12-31,2020-11-16,1839649668,0,1839649668
21635,RDOR3,2020-03-31,2020-11-15,919824834,0,919824834
21636,RDOR3,2020-06-30,2020-11-15,919824834,0,919824834
21637,RDOR3,2020-09-30,2020-11-16,1839649668,0,1839649668
21638,RDOR3,2020-12-31,2021-02-24,1985327155,0,1985327155
21639,CEAB3,2019-03-31,2020-08-20,1035720,0,1035720
21640,CEAB3,2019-09-30,2019-11-12,1035720,0,1035720
21641,CEAB3,2019-12-31,2020-03-23,308245068,0,308245068
21642,CEAB3,2020-03-31,2020-05-27,308245068,0,308245068
21643,CEAB3,2020-06-30,2020-08-19,308245068,0,308245068
21644,CEAB3,2020-09-30,2020-11-12,308245068,0,308245068
21645,CEAB3,2020-12-31,2021-03-18,308245068,0,308245068
21646,LMED3,2019-09-30,2019-11-14,2576438,0,2576438
21647,LMED3,2019-12-31,2020-03-18,2576438,0,2576438
21648,LMED3,2020-03-31,2020-05-20,2576438,0,2576438
21649,LMED3,2020-06-30,2020-08-31,2576438,0,2576438
21650,LMED3,2020-09-30,2020-11-12,2576438,0,2576438
21651,LMED3,2020-12-31,2021-03-18,2576438,0,2576438
21652,MTRE3,2019-12-31,2020-03-31,56100,0,56100
21653,MTRE3,2020-03-31,2020-08-11,105774820,0,105774820
21654,MTRE3,2020-06-30,2020-08-28,105774820,0,105774820
21655,MTRE3,2020-09-30,2020-11-10,105774820,0,105774820
21656,MTRE3,2020-12-31,2021-03-15,105774820,0,105774820
21657,LWSA3,2019-12-31,2020-03-25,91596653,0,91596653
21658,LWSA3,2020-03-31,2020-05-13,125172486,0,125172486
21659,LWSA3,2020-06-30,2020-08-12,125172486,0,125172486
21660,LWSA3,2020-09-30,2020-11-11,125890296,0,125890296
21661,LWSA3,2020-12-31,2021-03-24,125890296,0,125890296
21662,TIMS3,2020-03-31,2020-05-05,42296789606,0,42296789606
21663,TIMS3,2020-06-30,2020-07-29,42296789606,0,42296789606
21664,TIMS3,2020-09-30,2020-11-03,2420804398,0,2420804398
21665,TIMS3,2020-12-31,2021-02-09,2420804398,0,2420804398
21666,ALPK3,2020-03-31,2020-07-09,161335,0,161335
21667,ALPK3,2020-06-30,2020-08-13,193771,0,193771
21668,ALPK3,2020-09-30,2020-11-10,193771,0,193771
21669,ALPK3,2020-12-31,2021-03-09,193771,0,193771
21670,AMBP3,2020-03-31,2020-06-19,69202254,0,69202254
21671,AMBP3,2020-06-30,2020-08-10,69202254,0,69202254
21672,AMBP3,2020-09-30,2020-11-11,112935588,0,112935588
21673,AMBP3,2020-12-31,2021-03-17,112935588,0,112935588
21674,SIMH3,2020-06-30,2020-09-21,107491070,0,107491070
21675,SIMH3,2020-09-30,2020-11-13,206032081,0,206032081
21676,SIMH3,2020-12-31,2021-03-10,205817879,0,205817879
21677,SOMA3,2020-06-30,2020-08-28,336777496,0,336777496
21678,SOMA3,2020-09-30,2020-11-12,473141132,0,473141132
21679,SOMA3,2020-12-31,2021-03-25,473141132,0,473141132
21680,LJQQ3,2020-06-30,2020-08-12,148109,0,148109
21681,LJQQ3,2020-09-30,2020-11-11,187290,0,187290
21682,LJQQ3,2020-12-31,2021-03-03,187290,0,187290
21683,DMVF3,2019-12-31,2020-09-18,675473,0,675473
21684,DMVF3,2020-06-30,2020-08-20,676666,0,676666
21685,DMVF3,2020-09-30,2020-11-04,50602,0,50602
21686,DMVF3,2020-12-31,2021-03-18,50602,0,50602
21687,LAVV3,2020-09-30,2020-11-12,214628652,0,214628652
21688,LAVV3,2020-12-31,2021-03-18,214628652,0,214628652
21689,PLPL3,2020-09-30,2020-11-12,204256,0,204256
21690,PLPL3,2020-12-31,2021-03-25,204256,0,204256
21691,PETZ3,2020-09-30,2020-10-26,372856,0,372856
21692,PETZ3,2020-12-31,2021-03-08,372855796,0,372855796
21693,CURY3,2020-09-30,2020-12-10,291875088,0,291875088
21694,CURY3,2020-12-31,2021-03-22,291875088,0,291875088
21695,MELK3,2020-09-30,2020-11-12,207969341,0,207969341
21696,MELK3,2020-12-31,2021-03-18,207969341,0,207969341
21697,BOAS3,2020-09-30,2020-11-13,456938333,0,456938333
21698,BOAS3,2020-12-31,2021-03-22,520797860,0,520797860
21699,SEQL3,2020-09-30,2020-11-10,98848161,0,98848161
21700,SEQL3,2020-12-31,2021-02-25,127150021,0,127150021
21701,GMAT3,2020-09-30,2020-11-12,1863829195,0,1863829195
21702,GMAT3,2020-12-31,2021-03-24,2209346079,0,2209346079
21703,TFCO4,2020-09-30,2020-11-12,877251375,52274864,929526239
21704,TFCO4,2020-12-31,2021-03-22,877251375,68980161,946231536
21705,CASH3,2020-09-30,2020-11-16,92965249,0,92965249
21706,ENJU3,2020-09-30,2020-11-25,149533,0,149533
21707,AVLL3,2020-09-30,2020-11-12,11482979,0,11482979
21708,AERI3,2020-09-30,2020-11-12,615828842,0,615828842
21709,AERI3,2020-12-31,2021-02-22,766213456,0,766213456
21710,RRRP3,2020-09-30,2020-11-16,1189074,0,1189074
21711,RRRP3,2020-12-31,2021-03-17,109504342,0,109504342
21712,ASAI3,2019-12-31,2021-02-02,257731,0,257731
21713,ASAI3,2020-09-30,2021-02-02,268352,0,268352
21714,ASAI3,2020-12-31,2021-03-01,268352,0,268352
21715,INTB3,2020-12-31,2021-03-22,28161111,0,28161111
21716,MOSI3,2020-12-31,2021-03-25,91646,0,91646
21717,POWE3,2020-12-31,2021-03-25,23601013,0,23601013
21718,JALL3,2020-12-31,2021-02-12,228099500,0,228099500
21719,CMIN3,2020-12-31,2021-02-22,181001902,0,181001902
21720,PPLA11,2011-12-31,2012-05-02,149223,0,149223
21721,PPLA11,2012-03-31,2012-05-10,149223,0,149223
21722,PPLA11,2012-06-30,2012-08-10,446222799,0,446222799
21723,PPLA11,2012-09-30,2012-11-06,446222799,0,446222799
21724,PPLA11,2012-12-31,2013-02-21,254190,268430,522620
21725,PPLA11,2013-03-31,2013-05-07,254190,301154,555344
21726,PPLA11,2013-06-30,2013-08-15,254190202,397022793,651212995
21727,PPLA11,2013-09-30,2013-11-05,254190202,438805173,692995375
21728,PPLA11,2013-12-31,2014-02-18,438805,254190,692995
21729,PPLA11,2014-03-31,2014-05-07,254190,438805,692995
21730,PPLA11,2014-06-30,2014-08-05,254190,440873,695063
21731,PPLA11,2014-09-30,2014-11-04,254190,440873,695063
21732,PPLA11,2014-12-31,2015-02-26,254190203,453429518,707619721
21733,PPLA11,2015-03-31,2015-05-07,254190203,453429518,707619721
21734,PPLA11,2015-06-30,2015-08-05,254190203,453429518,707619721
21735,PPLA11,2015-09-30,2015-11-05,287824613,520698338,808522951
21736,PPLA11,2015-12-31,2016-02-21,761373679,0,761373679
21737,PPLA11,2016-03-31,2016-05-10,672998665,0,672998665
21738,PPLA11,2016-06-30,2016-08-09,699111879,0,699111879
21739,PPLA11,2016-09-30,2016-11-08,814318698,0,814318698
21740,PPLA11,2016-12-31,2017-02-14,808443106,0,808443106
21741,PPLA11,2017-03-31,2017-05-12,782255566,0,782255566
21742,PPLA11,2017-06-30,2017-08-14,778595566,0,778595566
21743,PPLA11,2017-09-30,2017-11-14,84440019,0,84440019
21744,PPLA11,2017-12-31,2018-03-07,84440019,0,84440019
21745,PPLA11,2018-03-31,2018-05-15,84440019,0,84440019
21746,PPLA11,2018-06-30,2018-08-14,84440019,0,84440019
21747,PPLA11,2018-09-30,2018-11-13,84440020,0,84440020
21748,PPLA11,2018-12-31,2019-03-29,84440020,0,84440020
21749,PPLA11,2019-03-31,2019-05-15,84440020,0,84440020
21750,PPLA11,2019-06-30,2019-08-14,84440020,0,84440020
21751,PPLA11,2019-09-30,2019-11-14,84440020,0,84440020
21752,PPLA11,2019-12-31,2020-03-27,84440020,0,84440020
21753,PPLA11,2020-03-31,2020-06-03,2814666,0,2814666
21754,PPLA11,2020-06-30,2020-08-27,2814666,0,2814666
21755,PPLA11,2020-09-30,2020-11-23,938223,1876444,2814667
21756,PPLA11,2020-12-31,2021-03-23,938223,1876444,2814667
