codigo_cvm,ticker_id,codigo_negociacao,data_referencia,ordinarias,preferenciais,totais
94,8,$PATI3,2010-12-31,8534,322,8856
94,8,$PATI3,2011-03-31,8534,322,8856
94,8,$PATI3,2011-06-30,8850,334,9184
94,8,$PATI3,2011-09-30,9135,345,9480
94,8,$PATI3,2011-12-31,9135,345,9480
94,8,$PATI3,2012-03-31,9135,345,9480
94,8,$PATI3,2012-06-30,9241,349,9590
94,8,$PATI3,2012-09-30,9423,355,9778
94,8,$PATI3,2012-12-31,9423,355,9778
94,8,$PATI3,2013-03-31,9423,355,9778
94,8,$PATI3,2013-06-30,9462,335,9797
94,8,$PATI3,2013-09-30,10785,679,11464
94,8,$PATI3,2013-12-31,11841,746,12587
94,8,$PATI3,2014-03-31,11841,746,12587
94,8,$PATI3,2014-06-30,13307,622,13929
94,8,$PATI3,2014-09-30,13307,622,13929
94,8,$PATI3,2014-12-31,15614,699,16313
94,8,$PATI3,2015-03-31,15614,699,16313
94,8,$PATI3,2015-06-30,15614,699,16313
94,8,$PATI3,2015-09-30,15614,699,16313
94,8,$PATI3,2015-12-31,15803,707,16510
94,8,$PATI3,2016-03-31,15803,707,16510
94,8,$PATI3,2016-06-30,15803,707,16510
94,8,$PATI3,2016-09-30,16572,742,17314
94,8,$PATI3,2016-12-31,16703,748,17451
94,8,$PATI3,2017-03-31,16703,748,17451
94,8,$PATI3,2017-06-30,16703,748,17451
94,8,$PATI3,2017-09-30,16703,748,17451
94,8,$PATI3,2017-12-31,16880,756,17636
94,8,$PATI3,2018-03-31,16880,756,17636
94,8,$PATI3,2018-06-30,16880,756,17636
94,8,$PATI3,2018-09-30,16880,756,17636
94,8,$PATI3,2018-12-31,17075,764,17839
94,8,$PATI3,2019-03-31,17075,764,17839
94,8,$PATI3,2019-06-30,17075,764,17839
94,8,$PATI3,2019-09-30,17075,764,17839
94,8,$PATI3,2019-12-31,17487,783,18270
94,8,$PATI3,2020-03-31,17487,783,18270
94,8,$PATI3,2020-06-30,17487,783,18270
94,8,$PATI3,2020-09-30,17487,783,18270
94,9,$PATI4,2010-12-31,8534,322,8856
94,9,$PATI4,2011-03-31,8534,322,8856
94,9,$PATI4,2011-06-30,8850,334,9184
94,9,$PATI4,2011-09-30,9135,345,9480
94,9,$PATI4,2011-12-31,9135,345,9480
94,9,$PATI4,2012-03-31,9135,345,9480
94,9,$PATI4,2012-06-30,9241,349,9590
94,9,$PATI4,2012-09-30,9423,355,9778
94,9,$PATI4,2012-12-31,9423,355,9778
94,9,$PATI4,2013-03-31,9423,355,9778
94,9,$PATI4,2013-06-30,9462,335,9797
94,9,$PATI4,2013-09-30,10785,679,11464
94,9,$PATI4,2013-12-31,11841,746,12587
94,9,$PATI4,2014-03-31,11841,746,12587
94,9,$PATI4,2014-06-30,13307,622,13929
94,9,$PATI4,2014-09-30,13307,622,13929
94,9,$PATI4,2014-12-31,15614,699,16313
94,9,$PATI4,2015-03-31,15614,699,16313
94,9,$PATI4,2015-06-30,15614,699,16313
94,9,$PATI4,2015-09-30,15614,699,16313
94,9,$PATI4,2015-12-31,15803,707,16510
94,9,$PATI4,2016-03-31,15803,707,16510
94,9,$PATI4,2016-06-30,15803,707,16510
94,9,$PATI4,2016-09-30,16572,742,17314
94,9,$PATI4,2016-12-31,16703,748,17451
94,9,$PATI4,2017-03-31,16703,748,17451
94,9,$PATI4,2017-06-30,16703,748,17451
94,9,$PATI4,2017-09-30,16703,748,17451
94,9,$PATI4,2017-12-31,16880,756,17636
94,9,$PATI4,2018-03-31,16880,756,17636
94,9,$PATI4,2018-06-30,16880,756,17636
94,9,$PATI4,2018-09-30,16880,756,17636
94,9,$PATI4,2018-12-31,17075,764,17839
94,9,$PATI4,2019-03-31,17075,764,17839
94,9,$PATI4,2019-06-30,17075,764,17839
94,9,$PATI4,2019-09-30,17075,764,17839
94,9,$PATI4,2019-12-31,17487,783,18270
94,9,$PATI4,2020-03-31,17487,783,18270
94,9,$PATI4,2020-06-30,17487,783,18270
94,9,$PATI4,2020-09-30,17487,783,18270
701,13,$BAHI3,2010-12-31,5451213,0,5451213
701,13,$BAHI3,2011-03-31,5451213,0,5451213
701,13,$BAHI3,2011-06-30,5996334,0,5996334
701,13,$BAHI3,2011-09-30,5996334,0,5996334
701,13,$BAHI3,2011-12-31,5996334,0,5996334
701,13,$BAHI3,2012-03-31,5996334,0,5996334
701,13,$BAHI3,2012-06-30,5996334,0,5996334
701,13,$BAHI3,2012-09-30,5996334,0,5996334
701,13,$BAHI3,2012-12-31,5996334,0,5996334
701,13,$BAHI3,2013-03-31,5996334,0,5996334
701,13,$BAHI3,2013-06-30,5996334,0,5996334
701,13,$BAHI3,2013-09-30,5996334,0,5996334
701,13,$BAHI3,2013-12-31,5996334,0,5996334
701,13,$BAHI3,2014-03-31,5996334,0,5996334
701,13,$BAHI3,2014-06-30,5996334,0,5996334
701,13,$BAHI3,2014-09-30,6038183,0,6038183
701,13,$BAHI3,2014-12-31,6038183,0,6038183
701,13,$BAHI3,2015-03-31,6038183,0,6038183
701,13,$BAHI3,2015-06-30,6038183,0,6038183
701,13,$BAHI3,2015-09-30,6038183,0,6038183
701,13,$BAHI3,2015-12-31,6038183,0,6038183
701,13,$BAHI3,2016-03-31,6038183,0,6038183
701,13,$BAHI3,2016-06-30,6038183,0,6038183
701,13,$BAHI3,2016-09-30,603818,0,603818
701,13,$BAHI3,2016-12-31,603818,0,603818
701,13,$BAHI3,2017-03-31,603818,0,603818
701,13,$BAHI3,2017-06-30,603818,0,603818
701,13,$BAHI3,2017-09-30,1171970,0,1171970
701,13,$BAHI3,2017-12-31,1171970,0,1171970
701,13,$BAHI3,2018-03-31,1171970,0,1171970
701,13,$BAHI3,2018-06-30,1171970,0,1171970
701,13,$BAHI3,2018-09-30,1171970,0,1171970
701,13,$BAHI3,2018-12-31,1171970,0,1171970
701,13,$BAHI3,2019-03-31,1171970,0,1171970
701,13,$BAHI3,2019-06-30,1171970,0,1171970
701,13,$BAHI3,2019-09-30,1171970,0,1171970
701,13,$BAHI3,2019-12-31,2219359,0,2219359
701,13,$BAHI3,2020-03-31,2219359,0,2219359
701,13,$BAHI3,2020-06-30,2219359,0,2219359
701,13,$BAHI3,2020-09-30,2219359,0,2219359
906,24,$BBDC3,2010-12-31,1881225,1881225,3762450
906,24,$BBDC3,2011-03-31,1912397,1912397,3824794
906,24,$BBDC3,2011-06-30,1912397,1912397,3824794
906,24,$BBDC3,2011-09-30,1912397,1912397,3824794
906,24,$BBDC3,2011-12-31,1912397,1912397,3824794
906,24,$BBDC3,2011-12-31,1912397,1912397,3824794
906,24,$BBDC3,2012-03-31,1912397,1912397,3824794
906,24,$BBDC3,2012-06-30,1912397,1912397,3824794
906,24,$BBDC3,2012-09-30,1912397,1912397,3824794
906,24,$BBDC3,2012-12-31,1912397,1912397,3824794
906,24,$BBDC3,2012-12-31,1912397,1912397,3824794
906,24,$BBDC3,2013-03-31,2103637,2103637,4207274
906,24,$BBDC3,2013-06-30,2103637,2103637,4207274
906,24,$BBDC3,2013-09-30,2103637,2103637,4207274
906,24,$BBDC3,2013-12-31,2103637,2103637,4207274
906,24,$BBDC3,2013-12-31,2103637,2103637,4207274
906,24,$BBDC3,2014-03-31,2103637,2103637,4207274
906,24,$BBDC3,2014-06-30,2103637,2103637,4207274
906,24,$BBDC3,2014-09-30,2103637,2103637,4207274
906,24,$BBDC3,2014-12-31,2103637,2103637,4207274
906,24,$BBDC3,2014-12-31,2103637,2103637,4207274
906,24,$BBDC3,2015-03-31,2524365,2524364,5048729
906,24,$BBDC3,2015-06-30,2524365,2524364,5048729
906,24,$BBDC3,2015-09-30,2524365,2524364,5048729
906,24,$BBDC3,2015-12-31,2524365,2524364,5048729
906,24,$BBDC3,2015-12-31,2524365,2524364,5048729
906,24,$BBDC3,2016-03-31,2524365,2524364,5048729
906,24,$BBDC3,2016-06-30,2776801,2776801,5553602
906,24,$BBDC3,2016-09-30,2776801,2776801,5553602
906,24,$BBDC3,2016-12-31,2776801,2776800,5553601
906,24,$BBDC3,2016-12-31,2776801,2776800,5553601
906,24,$BBDC3,2017-03-31,3054481,3054481,6108962
906,24,$BBDC3,2017-06-30,3054481,3054481,6108962
906,24,$BBDC3,2017-09-30,3054481,3054481,6108962
906,24,$BBDC3,2017-12-31,3054481,3054481,6108962
906,24,$BBDC3,2017-12-31,3054481,3054481,6108962
906,24,$BBDC3,2018-03-31,3359929,3359929,6719858
906,24,$BBDC3,2018-03-31,3359929,3359929,6719858
906,24,$BBDC3,2018-06-30,3359929,3359929,6719858
906,24,$BBDC3,2018-06-30,3359929,3359929,6719858
906,24,$BBDC3,2018-09-30,3359929,3359929,6719858
906,24,$BBDC3,2018-12-31,3359929,3359929,6719858
906,24,$BBDC3,2019-03-31,4031915,4031915,8063830
906,24,$BBDC3,2019-06-30,4031915,4031915,8063830
906,24,$BBDC3,2019-09-30,4031915,4031915,8063830
906,24,$BBDC3,2019-12-31,4031915,4031915,8063830
906,24,$BBDC3,2019-12-31,4031915,4031915,8063830
906,24,$BBDC3,2020-03-31,4435107,4435106,8870213
906,24,$BBDC3,2020-06-30,4435107,4435106,8870213
906,24,$BBDC3,2020-09-30,4435107,4435106,8870213
906,25,$BBDC4,2010-12-31,1881225,1881225,3762450
906,25,$BBDC4,2011-03-31,1912397,1912397,3824794
906,25,$BBDC4,2011-06-30,1912397,1912397,3824794
906,25,$BBDC4,2011-09-30,1912397,1912397,3824794
906,25,$BBDC4,2011-12-31,1912397,1912397,3824794
906,25,$BBDC4,2011-12-31,1912397,1912397,3824794
906,25,$BBDC4,2012-03-31,1912397,1912397,3824794
906,25,$BBDC4,2012-06-30,1912397,1912397,3824794
906,25,$BBDC4,2012-09-30,1912397,1912397,3824794
906,25,$BBDC4,2012-12-31,1912397,1912397,3824794
906,25,$BBDC4,2012-12-31,1912397,1912397,3824794
906,25,$BBDC4,2013-03-31,2103637,2103637,4207274
906,25,$BBDC4,2013-06-30,2103637,2103637,4207274
906,25,$BBDC4,2013-09-30,2103637,2103637,4207274
906,25,$BBDC4,2013-12-31,2103637,2103637,4207274
906,25,$BBDC4,2013-12-31,2103637,2103637,4207274
906,25,$BBDC4,2014-03-31,2103637,2103637,4207274
906,25,$BBDC4,2014-06-30,2103637,2103637,4207274
906,25,$BBDC4,2014-09-30,2103637,2103637,4207274
906,25,$BBDC4,2014-12-31,2103637,2103637,4207274
906,25,$BBDC4,2014-12-31,2103637,2103637,4207274
906,25,$BBDC4,2015-03-31,2524365,2524364,5048729
906,25,$BBDC4,2015-06-30,2524365,2524364,5048729
906,25,$BBDC4,2015-09-30,2524365,2524364,5048729
906,25,$BBDC4,2015-12-31,2524365,2524364,5048729
906,25,$BBDC4,2015-12-31,2524365,2524364,5048729
906,25,$BBDC4,2016-03-31,2524365,2524364,5048729
906,25,$BBDC4,2016-06-30,2776801,2776801,5553602
906,25,$BBDC4,2016-09-30,2776801,2776801,5553602
906,25,$BBDC4,2016-12-31,2776801,2776800,5553601
906,25,$BBDC4,2016-12-31,2776801,2776800,5553601
906,25,$BBDC4,2017-03-31,3054481,3054481,6108962
906,25,$BBDC4,2017-06-30,3054481,3054481,6108962
906,25,$BBDC4,2017-09-30,3054481,3054481,6108962
906,25,$BBDC4,2017-12-31,3054481,3054481,6108962
906,25,$BBDC4,2017-12-31,3054481,3054481,6108962
906,25,$BBDC4,2018-03-31,3359929,3359929,6719858
906,25,$BBDC4,2018-03-31,3359929,3359929,6719858
906,25,$BBDC4,2018-06-30,3359929,3359929,6719858
906,25,$BBDC4,2018-06-30,3359929,3359929,6719858
906,25,$BBDC4,2018-09-30,3359929,3359929,6719858
906,25,$BBDC4,2018-12-31,3359929,3359929,6719858
906,25,$BBDC4,2019-03-31,4031915,4031915,8063830
906,25,$BBDC4,2019-06-30,4031915,4031915,8063830
906,25,$BBDC4,2019-09-30,4031915,4031915,8063830
906,25,$BBDC4,2019-12-31,4031915,4031915,8063830
906,25,$BBDC4,2019-12-31,4031915,4031915,8063830
906,25,$BBDC4,2020-03-31,4435107,4435106,8870213
906,25,$BBDC4,2020-06-30,4435107,4435106,8870213
906,25,$BBDC4,2020-09-30,4435107,4435106,8870213
922,3,$BAZA3,2010-12-31,2964596,0,2964596
922,3,$BAZA3,2011-03-31,2964596,0,2964596
922,3,$BAZA3,2011-06-30,2964596,0,2964596
922,3,$BAZA3,2011-09-30,2964596,0,2964596
922,3,$BAZA3,2011-12-31,2964596,0,2964596
922,3,$BAZA3,2012-03-31,2964596,0,2964596
922,3,$BAZA3,2012-06-30,2964596,0,2964596
922,3,$BAZA3,2012-09-30,2964596,0,2964596
922,3,$BAZA3,2012-12-31,2964596,0,2964596
922,3,$BAZA3,2013-03-31,2964596,0,2964596
922,3,$BAZA3,2013-06-30,2964596,0,2964596
922,3,$BAZA3,2013-09-30,2964596,0,2964596
922,3,$BAZA3,2013-12-31,2964596762,0,2964596762
922,3,$BAZA3,2014-03-31,2964596762,0,2964596762
922,3,$BAZA3,2014-06-30,2964596762,0,2964596762
922,3,$BAZA3,2014-09-30,2964596762,0,2964596762
922,3,$BAZA3,2014-12-31,2964596762,0,2964596762
922,3,$BAZA3,2015-03-31,2964596762,0,2964596762
922,3,$BAZA3,2015-06-30,2964596762,0,2964596762
922,3,$BAZA3,2015-09-30,2964596762,0,2964596762
922,3,$BAZA3,2015-12-31,2964596762,0,2964596762
922,3,$BAZA3,2016-03-31,2964596762,0,2964596762
922,3,$BAZA3,2016-06-30,2964596762,0,2964596762
922,3,$BAZA3,2016-09-30,29645967,0,29645967
922,3,$BAZA3,2016-12-31,29645967,0,29645967
922,3,$BAZA3,2017-03-31,29645967,0,29645967
922,3,$BAZA3,2017-06-30,29645967,0,29645967
922,3,$BAZA3,2017-09-30,29645967,0,29645967
922,3,$BAZA3,2017-12-31,29645967,0,29645967
922,3,$BAZA3,2018-03-31,29645967,0,29645967
922,3,$BAZA3,2018-06-30,29645967,0,29645967
922,3,$BAZA3,2018-09-30,29645967,0,29645967
922,3,$BAZA3,2018-12-31,29645967,0,29645967
922,3,$BAZA3,2019-03-31,29645967,0,29645967
922,3,$BAZA3,2019-06-30,29645967,0,29645967
922,3,$BAZA3,2019-09-30,29645967,0,29645967
922,3,$BAZA3,2019-12-31,29645967,0,29645967
922,3,$BAZA3,2020-03-31,29645967,0,29645967
922,3,$BAZA3,2020-06-30,29645967,0,29645967
922,3,$BAZA3,2020-09-30,29645967,0,29645967
1023,33,$BBAS3,2010-12-31,2860729247,0,2860729247
1023,33,$BBAS3,2011-03-31,2860729247,0,2860729247
1023,33,$BBAS3,2011-06-30,2860729247,0,2860729247
1023,33,$BBAS3,2011-09-30,2860729247,0,2860729247
1023,33,$BBAS3,2011-12-31,2865416988,0,2865416988
1023,33,$BBAS3,2012-03-31,2865416973,0,2865416973
1023,33,$BBAS3,2012-06-30,2865416973,0,2865416973
1023,33,$BBAS3,2012-09-30,2858171973,0,2858171973
1023,33,$BBAS3,2012-12-31,2865417020,0,2865417020
1023,33,$BBAS3,2013-03-31,2865417020,0,2865417020
1023,33,$BBAS3,2013-06-30,2865417020,0,2865417020
1023,33,$BBAS3,2013-09-30,2865417020,0,2865417020
1023,33,$BBAS3,2013-12-31,2865417020,0,2865417020
1023,33,$BBAS3,2014-03-31,2865417020,0,2865417020
1023,33,$BBAS3,2014-06-30,2865417020,0,2865417020
1023,33,$BBAS3,2014-09-30,2865417020,0,2865417020
1023,33,$BBAS3,2014-12-31,2865417020,0,2865417020
1023,33,$BBAS3,2015-03-31,2865417020,0,2865417020
1023,33,$BBAS3,2015-06-30,2865417020,0,2865417020
1023,33,$BBAS3,2015-09-30,2865417020,0,2865417020
1023,33,$BBAS3,2015-12-31,2865417020,0,2865417020
1023,33,$BBAS3,2016-03-31,2865417020,0,2865417020
1023,33,$BBAS3,2016-06-30,2865417020,0,2865417020
1023,33,$BBAS3,2016-09-30,2865417020,0,2865417020
1023,33,$BBAS3,2016-12-31,2865417020,0,2865417020
1023,33,$BBAS3,2017-03-31,2865417020,0,2865417020
1023,33,$BBAS3,2017-06-30,2865417020,0,2865417020
1023,33,$BBAS3,2017-09-30,2865417020,0,2865417020
1023,33,$BBAS3,2017-12-31,2865417020,0,2865417020
1023,33,$BBAS3,2018-03-31,2865417020,0,2865417020
1023,33,$BBAS3,2018-06-30,2865417020,0,2865417020
1023,33,$BBAS3,2018-09-30,2865417020,0,2865417020
1023,33,$BBAS3,2018-12-31,2865417020,0,2865417020
1023,33,$BBAS3,2019-03-31,2865417020,0,2865417020
1023,33,$BBAS3,2019-06-30,2865417020,0,2865417020
1023,33,$BBAS3,2019-09-30,2865417020,0,2865417020
1023,33,$BBAS3,2019-12-31,2865417020,0,2865417020
1023,33,$BBAS3,2020-03-31,2865417020,0,2865417020
1023,33,$BBAS3,2020-06-30,2865417020,0,2865417020
1023,33,$BBAS3,2020-09-30,2865417020,0,2865417020
1120,14,$BGIP3,2010-12-31,5270721,5270721,10541442
1120,14,$BGIP3,2011-03-31,5270721,5270721,10541442
1120,14,$BGIP3,2011-06-30,5270721,5270721,10541442
1120,14,$BGIP3,2011-09-30,5271221,5271221,10542442
1120,14,$BGIP3,2011-12-31,5270721,5270721,10541442
1120,14,$BGIP3,2012-03-31,5271221,5271221,10542442
1120,14,$BGIP3,2012-06-30,5271221,5271221,10542442
1120,14,$BGIP3,2012-09-30,5271221,5271221,10542442
1120,14,$BGIP3,2012-12-31,5270721,5270721,10541442
1120,14,$BGIP3,2013-03-31,5270721,5270721,10541442
1120,14,$BGIP3,2013-06-30,5271,5271,10542
1120,14,$BGIP3,2013-09-30,5271,5271,10542
1120,14,$BGIP3,2013-12-31,5271,5271,10542
1120,14,$BGIP3,2014-03-31,5271,5271,10542
1120,14,$BGIP3,2014-06-30,5271,5271,10542
1120,14,$BGIP3,2014-09-30,7642545,7642545,15285090
1120,14,$BGIP3,2014-12-31,7642545,7642545,15285090
1120,14,$BGIP3,2015-03-31,7642545,7642545,15285090
1120,14,$BGIP3,2015-06-30,7642545,7642545,15285090
1120,14,$BGIP3,2015-09-30,7642545,7642545,15285090
1120,14,$BGIP3,2015-12-31,7642545,7642545,15285090
1120,14,$BGIP3,2016-03-31,7642545,7642545,15285090
1120,14,$BGIP3,2016-06-30,7642545,7642545,15285090
1120,14,$BGIP3,2016-09-30,7642545,7642545,15285090
1120,14,$BGIP3,2016-12-31,7642545,7642545,15285090
1120,14,$BGIP3,2017-03-31,7642545,7642545,15285090
1120,14,$BGIP3,2017-06-30,7642545,7642545,15285090
1120,14,$BGIP3,2017-09-30,7642545,7642545,15285090
1120,14,$BGIP3,2017-12-31,7642545,7642545,15285090
1120,14,$BGIP3,2018-03-31,7642545,7642545,15285090
1120,14,$BGIP3,2018-06-30,7642545,7642545,15285090
1120,14,$BGIP3,2018-09-30,7642545,7642545,15285090
1120,14,$BGIP3,2018-12-31,7642545,7642545,15285090
1120,14,$BGIP3,2019-03-31,7642545,7642545,15285090
1120,14,$BGIP3,2019-06-30,7642545,7642545,15285090
1120,14,$BGIP3,2019-09-30,7642545,7642545,15285090
1120,14,$BGIP3,2019-12-31,7642545,7642545,15285090
1120,14,$BGIP3,2020-03-31,7642545,7642545,15285090
1120,14,$BGIP3,2020-06-30,7642545,7642545,15285090
1120,14,$BGIP3,2020-09-30,7642545,7642545,15285090
1120,15,$BGIP4,2010-12-31,5270721,5270721,10541442
1120,15,$BGIP4,2011-03-31,5270721,5270721,10541442
1120,15,$BGIP4,2011-06-30,5270721,5270721,10541442
1120,15,$BGIP4,2011-09-30,5271221,5271221,10542442
1120,15,$BGIP4,2011-12-31,5270721,5270721,10541442
1120,15,$BGIP4,2012-03-31,5271221,5271221,10542442
1120,15,$BGIP4,2012-06-30,5271221,5271221,10542442
1120,15,$BGIP4,2012-09-30,5271221,5271221,10542442
1120,15,$BGIP4,2012-12-31,5270721,5270721,10541442
1120,15,$BGIP4,2013-03-31,5270721,5270721,10541442
1120,15,$BGIP4,2013-06-30,5271,5271,10542
1120,15,$BGIP4,2013-09-30,5271,5271,10542
1120,15,$BGIP4,2013-12-31,5271,5271,10542
1120,15,$BGIP4,2014-03-31,5271,5271,10542
1120,15,$BGIP4,2014-06-30,5271,5271,10542
1120,15,$BGIP4,2014-09-30,7642545,7642545,15285090
1120,15,$BGIP4,2014-12-31,7642545,7642545,15285090
1120,15,$BGIP4,2015-03-31,7642545,7642545,15285090
1120,15,$BGIP4,2015-06-30,7642545,7642545,15285090
1120,15,$BGIP4,2015-09-30,7642545,7642545,15285090
1120,15,$BGIP4,2015-12-31,7642545,7642545,15285090
1120,15,$BGIP4,2016-03-31,7642545,7642545,15285090
1120,15,$BGIP4,2016-06-30,7642545,7642545,15285090
1120,15,$BGIP4,2016-09-30,7642545,7642545,15285090
1120,15,$BGIP4,2016-12-31,7642545,7642545,15285090
1120,15,$BGIP4,2017-03-31,7642545,7642545,15285090
1120,15,$BGIP4,2017-06-30,7642545,7642545,15285090
1120,15,$BGIP4,2017-09-30,7642545,7642545,15285090
1120,15,$BGIP4,2017-12-31,7642545,7642545,15285090
1120,15,$BGIP4,2018-03-31,7642545,7642545,15285090
1120,15,$BGIP4,2018-06-30,7642545,7642545,15285090
1120,15,$BGIP4,2018-09-30,7642545,7642545,15285090
1120,15,$BGIP4,2018-12-31,7642545,7642545,15285090
1120,15,$BGIP4,2019-03-31,7642545,7642545,15285090
1120,15,$BGIP4,2019-06-30,7642545,7642545,15285090
1120,15,$BGIP4,2019-09-30,7642545,7642545,15285090
1120,15,$BGIP4,2019-12-31,7642545,7642545,15285090
1120,15,$BGIP4,2020-03-31,7642545,7642545,15285090
1120,15,$BGIP4,2020-06-30,7642545,7642545,15285090
1120,15,$BGIP4,2020-09-30,7642545,7642545,15285090
1155,22,$BEES3,2010-12-31,109305,42183,151488
1155,22,$BEES3,2011-03-31,109305,42183,151488
1155,22,$BEES3,2011-06-30,109305,42183,151488
1155,22,$BEES3,2011-09-30,109305,42183,151488
1155,22,$BEES3,2011-12-31,109305,42183,151488
1155,22,$BEES3,2012-03-31,109305,42183,151488
1155,22,$BEES3,2012-06-30,109332,42183,151515
1155,22,$BEES3,2012-09-30,1093320,421832,1515152
1155,22,$BEES3,2012-12-31,1093320,421832,1515152
1155,22,$BEES3,2013-03-31,1093320,421832,1515152
1155,22,$BEES3,2013-06-30,1093320,421832,1515152
1155,22,$BEES3,2013-09-30,1093320,421832,1515152
1155,22,$BEES3,2013-12-31,1157732,421832,1579564
1155,22,$BEES3,2014-03-31,1157732,421832,1579564
1155,22,$BEES3,2014-06-30,1157732,421832,1579564
1155,22,$BEES3,2014-09-30,1157732,421832,1579564
1155,22,$BEES3,2014-12-31,1157732,421832,1579564
1155,22,$BEES3,2015-03-31,231547,84366,315913
1155,22,$BEES3,2015-06-30,231546,84366,315912
1155,22,$BEES3,2015-09-30,231546,84366,315912
1155,22,$BEES3,2015-12-31,231546,84366,315912
1155,22,$BEES3,2016-03-31,231546,84366,315912
1155,22,$BEES3,2016-06-30,231546,84366,315912
1155,22,$BEES3,2016-09-30,231546,84366,315912
1155,22,$BEES3,2016-12-31,231546,84366,315912
1155,22,$BEES3,2017-03-31,231546,84366,315912
1155,22,$BEES3,2017-06-30,231356,84556,315912
1155,22,$BEES3,2017-09-30,231356,84556,315912
1155,22,$BEES3,2017-12-31,231356,84556,315912
1155,22,$BEES3,2018-03-31,231356,84556,315912
1155,22,$BEES3,2018-06-30,231356,84556,315912
1155,22,$BEES3,2018-09-30,231355,84557,315912
1155,22,$BEES3,2018-12-31,231355,84557,315912
1155,22,$BEES3,2019-03-31,231355,84557,315912
1155,22,$BEES3,2019-06-30,231355,84557,315912
1155,22,$BEES3,2019-09-30,231355,84557,315912
1155,22,$BEES3,2019-12-31,231355,84557,315912
1155,22,$BEES3,2020-03-31,231329,84583,315912
1155,22,$BEES3,2020-06-30,231329,84583,315912
1155,22,$BEES3,2020-09-30,231329,84583,315912
1155,23,$BEES4,2010-12-31,109305,42183,151488
1155,23,$BEES4,2011-03-31,109305,42183,151488
1155,23,$BEES4,2011-06-30,109305,42183,151488
1155,23,$BEES4,2011-09-30,109305,42183,151488
1155,23,$BEES4,2011-12-31,109305,42183,151488
1155,23,$BEES4,2012-03-31,109305,42183,151488
1155,23,$BEES4,2012-06-30,109332,42183,151515
1155,23,$BEES4,2012-09-30,1093320,421832,1515152
1155,23,$BEES4,2012-12-31,1093320,421832,1515152
1155,23,$BEES4,2013-03-31,1093320,421832,1515152
1155,23,$BEES4,2013-06-30,1093320,421832,1515152
1155,23,$BEES4,2013-09-30,1093320,421832,1515152
1155,23,$BEES4,2013-12-31,1157732,421832,1579564
1155,23,$BEES4,2014-03-31,1157732,421832,1579564
1155,23,$BEES4,2014-06-30,1157732,421832,1579564
1155,23,$BEES4,2014-09-30,1157732,421832,1579564
1155,23,$BEES4,2014-12-31,1157732,421832,1579564
1155,23,$BEES4,2015-03-31,231547,84366,315913
1155,23,$BEES4,2015-06-30,231546,84366,315912
1155,23,$BEES4,2015-09-30,231546,84366,315912
1155,23,$BEES4,2015-12-31,231546,84366,315912
1155,23,$BEES4,2016-03-31,231546,84366,315912
1155,23,$BEES4,2016-06-30,231546,84366,315912
1155,23,$BEES4,2016-09-30,231546,84366,315912
1155,23,$BEES4,2016-12-31,231546,84366,315912
1155,23,$BEES4,2017-03-31,231546,84366,315912
1155,23,$BEES4,2017-06-30,231356,84556,315912
1155,23,$BEES4,2017-09-30,231356,84556,315912
1155,23,$BEES4,2017-12-31,231356,84556,315912
1155,23,$BEES4,2018-03-31,231356,84556,315912
1155,23,$BEES4,2018-06-30,231356,84556,315912
1155,23,$BEES4,2018-09-30,231355,84557,315912
1155,23,$BEES4,2018-12-31,231355,84557,315912
1155,23,$BEES4,2019-03-31,231355,84557,315912
1155,23,$BEES4,2019-06-30,231355,84557,315912
1155,23,$BEES4,2019-09-30,231355,84557,315912
1155,23,$BEES4,2019-12-31,231355,84557,315912
1155,23,$BEES4,2020-03-31,231329,84583,315912
1155,23,$BEES4,2020-06-30,231329,84583,315912
1155,23,$BEES4,2020-09-30,231329,84583,315912
1171,225,$BPAR3,2010-12-31,9521649,0,9521649
1171,225,$BPAR3,2011-03-31,9521649,0,9521649
1171,225,$BPAR3,2011-06-30,9521649,0,9521649
1171,225,$BPAR3,2011-09-30,9521649,0,9521649
1171,225,$BPAR3,2011-12-31,9521649,0,9521649
1171,225,$BPAR3,2012-03-31,9521649,0,9521649
1171,225,$BPAR3,2012-06-30,9521649,0,9521649
1171,225,$BPAR3,2012-09-30,9521649,0,9521649
1171,225,$BPAR3,2012-12-31,9521649,0,9521649
1171,225,$BPAR3,2013-03-31,9521649,0,9521649
1171,225,$BPAR3,2013-06-30,9521649,0,9521649
1171,225,$BPAR3,2013-09-30,9521649,0,9521649
1171,225,$BPAR3,2013-12-31,9521649,0,9521649
1171,225,$BPAR3,2014-03-31,9521649,0,9521649
1171,225,$BPAR3,2014-06-30,9521649,0,9521649
1171,225,$BPAR3,2014-09-30,9521649,0,9521649
1171,225,$BPAR3,2014-12-31,9521649,0,9521649
1171,225,$BPAR3,2015-03-31,9521649,0,9521649
1171,225,$BPAR3,2015-06-30,9521649,0,9521649
1171,225,$BPAR3,2015-09-30,9521649,0,9521649
1171,225,$BPAR3,2015-12-31,9521649,0,9521649
1171,225,$BPAR3,2016-03-31,9521649,0,9521649
1171,225,$BPAR3,2016-06-30,9521649,0,9521649
1171,225,$BPAR3,2016-09-30,9521649,0,9521649
1171,225,$BPAR3,2016-12-31,9521649,0,9521649
1171,225,$BPAR3,2017-03-31,9521649,0,9521649
1171,225,$BPAR3,2017-06-30,9521649,0,9521649
1171,225,$BPAR3,2017-09-30,9521649,0,9521649
1171,225,$BPAR3,2017-12-31,9521649,0,9521649
1171,225,$BPAR3,2018-03-31,9521649,0,9521649
1171,225,$BPAR3,2018-06-30,9521649,0,9521649
1171,225,$BPAR3,2018-09-30,9521649,0,9521649
1171,225,$BPAR3,2018-12-31,9521649,0,9521649
1171,225,$BPAR3,2019-03-31,9521649,0,9521649
1171,225,$BPAR3,2019-06-30,9521649,0,9521649
1171,225,$BPAR3,2019-09-30,9521649,0,9521649
1171,225,$BPAR3,2019-12-31,9521649,0,9521649
1171,225,$BPAR3,2020-03-31,9521649,0,9521649
1171,225,$BPAR3,2020-06-30,9521649,0,9521649
1171,225,$BPAR3,2020-09-30,9521649,0,9521649
1210,26,$BRSR3,2010-12-31,205043,203931,408974
1210,26,$BRSR3,2011-03-31,205043,203931,408974
1210,26,$BRSR3,2011-06-30,205043,203931,408974
1210,26,$BRSR3,2011-09-30,205043,203931,408974
1210,26,$BRSR3,2011-12-31,205043,203931,408974
1210,26,$BRSR3,2012-03-31,205043,203931,408974
1210,26,$BRSR3,2012-06-30,205043,203931,408974
1210,26,$BRSR3,2012-09-30,205043,203931,408974
1210,26,$BRSR3,2012-12-31,205043,203931,408974
1210,26,$BRSR3,2013-03-31,205043,203931,408974
1210,26,$BRSR3,2013-06-30,205043,203931,408974
1210,26,$BRSR3,2013-09-30,205043,203931,408974
1210,26,$BRSR3,2013-12-31,205043,203931,408974
1210,26,$BRSR3,2014-03-31,205043,203931,408974
1210,26,$BRSR3,2014-06-30,205043,203931,408974
1210,26,$BRSR3,2014-09-30,205043,203931,408974
1210,26,$BRSR3,2014-12-31,205043,203931,408974
1210,26,$BRSR3,2015-03-31,205043,203931,408974
1210,26,$BRSR3,2015-06-30,205043,203931,408974
1210,26,$BRSR3,2015-09-30,205044,203930,408974
1210,26,$BRSR3,2015-12-31,205051,203923,408974
1210,26,$BRSR3,2016-03-31,205052,203922,408974
1210,26,$BRSR3,2016-06-30,205054,203920,408974
1210,26,$BRSR3,2016-09-30,205044,203930,408974
1210,26,$BRSR3,2016-12-31,205054,203920,408974
1210,26,$BRSR3,2017-03-31,205057,203917,408974
1210,26,$BRSR3,2017-06-30,205057,203917,408974
1210,26,$BRSR3,2017-09-30,205057,203917,408974
1210,26,$BRSR3,2017-12-31,205058,203916,408974
1210,26,$BRSR3,2018-03-31,205059,203915,408974
1210,26,$BRSR3,2018-06-30,205060,203914,408974
1210,26,$BRSR3,2018-09-30,205060,203914,408974
1210,26,$BRSR3,2018-12-31,205062,203912,408974
1210,26,$BRSR3,2019-03-31,205062,203912,408974
1210,26,$BRSR3,2019-06-30,205062,203912,408974
1210,26,$BRSR3,2019-09-30,205062,203912,408974
1210,26,$BRSR3,2019-12-31,205065,203909,408974
1210,26,$BRSR3,2020-03-31,205065,203909,408974
1210,26,$BRSR3,2020-06-30,205065,203909,408974
1210,26,$BRSR3,2020-09-30,205065,203909,408974
1210,27,$BRSR6,2010-12-31,205043,203931,408974
1210,27,$BRSR6,2011-03-31,205043,203931,408974
1210,27,$BRSR6,2011-06-30,205043,203931,408974
1210,27,$BRSR6,2011-09-30,205043,203931,408974
1210,27,$BRSR6,2011-12-31,205043,203931,408974
1210,27,$BRSR6,2012-03-31,205043,203931,408974
1210,27,$BRSR6,2012-06-30,205043,203931,408974
1210,27,$BRSR6,2012-09-30,205043,203931,408974
1210,27,$BRSR6,2012-12-31,205043,203931,408974
1210,27,$BRSR6,2013-03-31,205043,203931,408974
1210,27,$BRSR6,2013-06-30,205043,203931,408974
1210,27,$BRSR6,2013-09-30,205043,203931,408974
1210,27,$BRSR6,2013-12-31,205043,203931,408974
1210,27,$BRSR6,2014-03-31,205043,203931,408974
1210,27,$BRSR6,2014-06-30,205043,203931,408974
1210,27,$BRSR6,2014-09-30,205043,203931,408974
1210,27,$BRSR6,2014-12-31,205043,203931,408974
1210,27,$BRSR6,2015-03-31,205043,203931,408974
1210,27,$BRSR6,2015-06-30,205043,203931,408974
1210,27,$BRSR6,2015-09-30,205044,203930,408974
1210,27,$BRSR6,2015-12-31,205051,203923,408974
1210,27,$BRSR6,2016-03-31,205052,203922,408974
1210,27,$BRSR6,2016-06-30,205054,203920,408974
1210,27,$BRSR6,2016-09-30,205044,203930,408974
1210,27,$BRSR6,2016-12-31,205054,203920,408974
1210,27,$BRSR6,2017-03-31,205057,203917,408974
1210,27,$BRSR6,2017-06-30,205057,203917,408974
1210,27,$BRSR6,2017-09-30,205057,203917,408974
1210,27,$BRSR6,2017-12-31,205058,203916,408974
1210,27,$BRSR6,2018-03-31,205059,203915,408974
1210,27,$BRSR6,2018-06-30,205060,203914,408974
1210,27,$BRSR6,2018-09-30,205060,203914,408974
1210,27,$BRSR6,2018-12-31,205062,203912,408974
1210,27,$BRSR6,2019-03-31,205062,203912,408974
1210,27,$BRSR6,2019-06-30,205062,203912,408974
1210,27,$BRSR6,2019-09-30,205062,203912,408974
1210,27,$BRSR6,2019-12-31,205065,203909,408974
1210,27,$BRSR6,2020-03-31,205065,203909,408974
1210,27,$BRSR6,2020-06-30,205065,203909,408974
1210,27,$BRSR6,2020-09-30,205065,203909,408974
1210,28,$BRSR5,2010-12-31,205043,203931,408974
1210,28,$BRSR5,2011-03-31,205043,203931,408974
1210,28,$BRSR5,2011-06-30,205043,203931,408974
1210,28,$BRSR5,2011-09-30,205043,203931,408974
1210,28,$BRSR5,2011-12-31,205043,203931,408974
1210,28,$BRSR5,2012-03-31,205043,203931,408974
1210,28,$BRSR5,2012-06-30,205043,203931,408974
1210,28,$BRSR5,2012-09-30,205043,203931,408974
1210,28,$BRSR5,2012-12-31,205043,203931,408974
1210,28,$BRSR5,2013-03-31,205043,203931,408974
1210,28,$BRSR5,2013-06-30,205043,203931,408974
1210,28,$BRSR5,2013-09-30,205043,203931,408974
1210,28,$BRSR5,2013-12-31,205043,203931,408974
1210,28,$BRSR5,2014-03-31,205043,203931,408974
1210,28,$BRSR5,2014-06-30,205043,203931,408974
1210,28,$BRSR5,2014-09-30,205043,203931,408974
1210,28,$BRSR5,2014-12-31,205043,203931,408974
1210,28,$BRSR5,2015-03-31,205043,203931,408974
1210,28,$BRSR5,2015-06-30,205043,203931,408974
1210,28,$BRSR5,2015-09-30,205044,203930,408974
1210,28,$BRSR5,2015-12-31,205051,203923,408974
1210,28,$BRSR5,2016-03-31,205052,203922,408974
1210,28,$BRSR5,2016-06-30,205054,203920,408974
1210,28,$BRSR5,2016-09-30,205044,203930,408974
1210,28,$BRSR5,2016-12-31,205054,203920,408974
1210,28,$BRSR5,2017-03-31,205057,203917,408974
1210,28,$BRSR5,2017-06-30,205057,203917,408974
1210,28,$BRSR5,2017-09-30,205057,203917,408974
1210,28,$BRSR5,2017-12-31,205058,203916,408974
1210,28,$BRSR5,2018-03-31,205059,203915,408974
1210,28,$BRSR5,2018-06-30,205060,203914,408974
1210,28,$BRSR5,2018-09-30,205060,203914,408974
1210,28,$BRSR5,2018-12-31,205062,203912,408974
1210,28,$BRSR5,2019-03-31,205062,203912,408974
1210,28,$BRSR5,2019-06-30,205062,203912,408974
1210,28,$BRSR5,2019-09-30,205062,203912,408974
1210,28,$BRSR5,2019-12-31,205065,203909,408974
1210,28,$BRSR5,2020-03-31,205065,203909,408974
1210,28,$BRSR5,2020-06-30,205065,203909,408974
1210,28,$BRSR5,2020-09-30,205065,203909,408974
1228,12,$BNBR3,2010-12-31,48485,38517,87002
1228,12,$BNBR3,2011-03-31,48485,38517,87002
1228,12,$BNBR3,2011-06-30,48485,38517,87002
1228,12,$BNBR3,2011-09-30,48485,38517,87002
1228,12,$BNBR3,2011-12-31,48485,38517,87002
1228,12,$BNBR3,2012-03-31,48485,38517,87002
1228,12,$BNBR3,2012-06-30,48485,38517,87002
1228,12,$BNBR3,2012-09-30,48485,38517,87002
1228,12,$BNBR3,2012-12-31,48485,38517,87002
1228,12,$BNBR3,2013-03-31,48485,38517,87002
1228,12,$BNBR3,2013-06-30,48485,38517,87002
1228,12,$BNBR3,2013-09-30,48485,38517,87002
1228,12,$BNBR3,2013-12-31,48485,38517,87002
1228,12,$BNBR3,2014-03-31,86371,0,86371
1228,12,$BNBR3,2014-06-30,86371,0,86371
1228,12,$BNBR3,2014-09-30,86371,0,86371
1228,12,$BNBR3,2014-12-31,86371464,0,86371464
1228,12,$BNBR3,2015-03-31,86371,0,86371
1228,12,$BNBR3,2015-06-30,86371,0,86371
1228,12,$BNBR3,2015-09-30,86371,0,86371
1228,12,$BNBR3,2015-12-31,86371,0,86371
1228,12,$BNBR3,2016-03-31,86371,0,86371
1228,12,$BNBR3,2016-06-30,86371,0,86371
1228,12,$BNBR3,2016-09-30,86371,0,86371
1228,12,$BNBR3,2016-12-31,86371,0,86371
1228,12,$BNBR3,2017-03-31,86371,0,86371
1228,12,$BNBR3,2017-06-30,86371,0,86371
1228,12,$BNBR3,2017-09-30,86371,0,86371
1228,12,$BNBR3,2017-12-31,86371,0,86371
1228,12,$BNBR3,2018-03-31,86371,0,86371
1228,12,$BNBR3,2018-06-30,86371,0,86371
1228,12,$BNBR3,2018-09-30,86371,0,86371
1228,12,$BNBR3,2018-12-31,86371,0,86371
1228,12,$BNBR3,2019-03-31,86371,0,86371
1228,12,$BNBR3,2019-06-30,86371,0,86371
1228,12,$BNBR3,2019-09-30,86371,0,86371
1228,12,$BNBR3,2019-12-31,86371,0,86371
1228,12,$BNBR3,2020-03-31,86371,0,86371
1228,12,$BNBR3,2020-06-30,86371,0,86371
1228,12,$BNBR3,2020-09-30,86371,0,86371
1309,1,$BMIN3,2010-12-31,111506,71014,182520
1309,1,$BMIN3,2011-03-31,111506,71014,182520
1309,1,$BMIN3,2011-06-30,111506,71014,182520
1309,1,$BMIN3,2011-09-30,111506,71014,182520
1309,1,$BMIN3,2011-12-31,111506,71014,182520
1309,1,$BMIN3,2012-03-31,111506,71014,182520
1309,1,$BMIN3,2012-06-30,111506,71014,182520
1309,1,$BMIN3,2012-09-30,111506,71014,182520
1309,1,$BMIN3,2012-12-31,111506,71014,182520
1309,1,$BMIN3,2013-03-31,111506,71014,182520
1309,1,$BMIN3,2013-06-30,111506,71014,182520
1309,1,$BMIN3,2013-09-30,111506,71014,182520
1309,1,$BMIN3,2013-12-31,111506,71014,182520
1309,1,$BMIN3,2014-03-31,111506,71014,182520
1309,1,$BMIN3,2014-06-30,111506,71014,182520
1309,1,$BMIN3,2014-09-30,111506,71014,182520
1309,1,$BMIN3,2014-12-31,111506,71014,182520
1309,1,$BMIN3,2015-03-31,111506,71014,182520
1309,1,$BMIN3,2015-06-30,111506,71014,182520
1309,1,$BMIN3,2015-09-30,111506,71014,182520
1309,1,$BMIN3,2015-12-31,111506,71014,182520
1309,1,$BMIN3,2016-03-31,464127,295588,759715
1309,1,$BMIN3,2016-06-30,464127,295588,759715
1309,1,$BMIN3,2016-09-30,464127,295588,759715
1309,1,$BMIN3,2016-12-31,111506,71014,182520
1309,1,$BMIN3,2017-03-31,111506,71014,182520
1309,1,$BMIN3,2017-06-30,111506,71014,182520
1309,1,$BMIN3,2017-09-30,1115,710,1825
1309,1,$BMIN3,2017-12-31,1115,710,1825
1309,1,$BMIN3,2018-03-31,1115,710,1825
1309,1,$BMIN3,2018-06-30,4115,710,4825
1309,1,$BMIN3,2018-09-30,4115,710,4825
1309,1,$BMIN3,2018-12-31,4115,710,4825
1309,1,$BMIN3,2019-03-31,4115,710,4825
1309,1,$BMIN3,2019-06-30,4115,710,4825
1309,1,$BMIN3,2019-09-30,4115,710,4825
1309,1,$BMIN3,2019-12-31,4115,710,4825
1309,1,$BMIN3,2020-03-31,4115,710,4825
1309,1,$BMIN3,2020-06-30,4115,710,4825
1309,1,$BMIN3,2020-09-30,4115,710,4825
1309,2,$BMIN4,2010-12-31,111506,71014,182520
1309,2,$BMIN4,2011-03-31,111506,71014,182520
1309,2,$BMIN4,2011-06-30,111506,71014,182520
1309,2,$BMIN4,2011-09-30,111506,71014,182520
1309,2,$BMIN4,2011-12-31,111506,71014,182520
1309,2,$BMIN4,2012-03-31,111506,71014,182520
1309,2,$BMIN4,2012-06-30,111506,71014,182520
1309,2,$BMIN4,2012-09-30,111506,71014,182520
1309,2,$BMIN4,2012-12-31,111506,71014,182520
1309,2,$BMIN4,2013-03-31,111506,71014,182520
1309,2,$BMIN4,2013-06-30,111506,71014,182520
1309,2,$BMIN4,2013-09-30,111506,71014,182520
1309,2,$BMIN4,2013-12-31,111506,71014,182520
1309,2,$BMIN4,2014-03-31,111506,71014,182520
1309,2,$BMIN4,2014-06-30,111506,71014,182520
1309,2,$BMIN4,2014-09-30,111506,71014,182520
1309,2,$BMIN4,2014-12-31,111506,71014,182520
1309,2,$BMIN4,2015-03-31,111506,71014,182520
1309,2,$BMIN4,2015-06-30,111506,71014,182520
1309,2,$BMIN4,2015-09-30,111506,71014,182520
1309,2,$BMIN4,2015-12-31,111506,71014,182520
1309,2,$BMIN4,2016-03-31,464127,295588,759715
1309,2,$BMIN4,2016-06-30,464127,295588,759715
1309,2,$BMIN4,2016-09-30,464127,295588,759715
1309,2,$BMIN4,2016-12-31,111506,71014,182520
1309,2,$BMIN4,2017-03-31,111506,71014,182520
1309,2,$BMIN4,2017-06-30,111506,71014,182520
1309,2,$BMIN4,2017-09-30,1115,710,1825
1309,2,$BMIN4,2017-12-31,1115,710,1825
1309,2,$BMIN4,2018-03-31,1115,710,1825
1309,2,$BMIN4,2018-06-30,4115,710,4825
1309,2,$BMIN4,2018-09-30,4115,710,4825
1309,2,$BMIN4,2018-12-31,4115,710,4825
1309,2,$BMIN4,2019-03-31,4115,710,4825
1309,2,$BMIN4,2019-06-30,4115,710,4825
1309,2,$BMIN4,2019-09-30,4115,710,4825
1309,2,$BMIN4,2019-12-31,4115,710,4825
1309,2,$BMIN4,2020-03-31,4115,710,4825
1309,2,$BMIN4,2020-06-30,4115,710,4825
1309,2,$BMIN4,2020-09-30,4115,710,4825
1325,20,$BMEB3,2010-12-31,26262,9138,35400
1325,20,$BMEB3,2011-03-31,26262,9138,35400
1325,20,$BMEB3,2011-06-30,26262,9138,35400
1325,20,$BMEB3,2011-09-30,26262,9138,35400
1325,20,$BMEB3,2011-12-31,26262,9138,35400
1325,20,$BMEB3,2012-03-31,26262,9138,35400
1325,20,$BMEB3,2012-06-30,26262,9138,35400
1325,20,$BMEB3,2012-09-30,26262,16238,42500
1325,20,$BMEB3,2012-12-31,26262,16238,42500
1325,20,$BMEB3,2013-03-31,26262,16238,42500
1325,20,$BMEB3,2013-06-30,26262,16238,42500
1325,20,$BMEB3,2013-09-30,26262,16238,42500
1325,20,$BMEB3,2013-12-31,26262,19838,46100
1325,20,$BMEB3,2014-03-31,26262,19838,46100
1325,20,$BMEB3,2014-06-30,26262,19838,46100
1325,20,$BMEB3,2014-09-30,26262,19838,46100
1325,20,$BMEB3,2014-12-31,26262,19838,46100
1325,20,$BMEB3,2015-03-31,26262,19838,46100
1325,20,$BMEB3,2015-06-30,26262,19838,46100
1325,20,$BMEB3,2015-09-30,26262,19838,46100
1325,20,$BMEB3,2015-12-31,26262,19838,46100
1325,20,$BMEB3,2016-03-31,26262,19838,46100
1325,20,$BMEB3,2016-06-30,26262,19838,46100
1325,20,$BMEB3,2016-09-30,26262,19838,46100
1325,20,$BMEB3,2016-12-31,26262,19838,46100
1325,20,$BMEB3,2017-03-31,26262,19838,46100
1325,20,$BMEB3,2017-06-30,26262,19838,46100
1325,20,$BMEB3,2017-09-30,26262,19838,46100
1325,20,$BMEB3,2017-12-31,26262,19838,46100
1325,20,$BMEB3,2018-03-31,26262,19838,46100
1325,20,$BMEB3,2018-06-30,26262,19838,46100
1325,20,$BMEB3,2018-09-30,32578,19838,52416
1325,20,$BMEB3,2018-12-31,32578,19838,52416
1325,20,$BMEB3,2019-03-31,32578,19838,52416
1325,20,$BMEB3,2019-06-30,32578,19838,52416
1325,20,$BMEB3,2019-09-30,32578,19838,52416
1325,20,$BMEB3,2019-12-31,32578,19838,52416
1325,20,$BMEB3,2020-03-31,32578,19838,52416
1325,20,$BMEB3,2020-06-30,32578,19838,52416
1325,20,$BMEB3,2020-09-30,32578,19838,52416
1325,21,$BMEB4,2010-12-31,26262,9138,35400
1325,21,$BMEB4,2011-03-31,26262,9138,35400
1325,21,$BMEB4,2011-06-30,26262,9138,35400
1325,21,$BMEB4,2011-09-30,26262,9138,35400
1325,21,$BMEB4,2011-12-31,26262,9138,35400
1325,21,$BMEB4,2012-03-31,26262,9138,35400
1325,21,$BMEB4,2012-06-30,26262,9138,35400
1325,21,$BMEB4,2012-09-30,26262,16238,42500
1325,21,$BMEB4,2012-12-31,26262,16238,42500
1325,21,$BMEB4,2013-03-31,26262,16238,42500
1325,21,$BMEB4,2013-06-30,26262,16238,42500
1325,21,$BMEB4,2013-09-30,26262,16238,42500
1325,21,$BMEB4,2013-12-31,26262,19838,46100
1325,21,$BMEB4,2014-03-31,26262,19838,46100
1325,21,$BMEB4,2014-06-30,26262,19838,46100
1325,21,$BMEB4,2014-09-30,26262,19838,46100
1325,21,$BMEB4,2014-12-31,26262,19838,46100
1325,21,$BMEB4,2015-03-31,26262,19838,46100
1325,21,$BMEB4,2015-06-30,26262,19838,46100
1325,21,$BMEB4,2015-09-30,26262,19838,46100
1325,21,$BMEB4,2015-12-31,26262,19838,46100
1325,21,$BMEB4,2016-03-31,26262,19838,46100
1325,21,$BMEB4,2016-06-30,26262,19838,46100
1325,21,$BMEB4,2016-09-30,26262,19838,46100
1325,21,$BMEB4,2016-12-31,26262,19838,46100
1325,21,$BMEB4,2017-03-31,26262,19838,46100
1325,21,$BMEB4,2017-06-30,26262,19838,46100
1325,21,$BMEB4,2017-09-30,26262,19838,46100
1325,21,$BMEB4,2017-12-31,26262,19838,46100
1325,21,$BMEB4,2018-03-31,26262,19838,46100
1325,21,$BMEB4,2018-06-30,26262,19838,46100
1325,21,$BMEB4,2018-09-30,32578,19838,52416
1325,21,$BMEB4,2018-12-31,32578,19838,52416
1325,21,$BMEB4,2019-03-31,32578,19838,52416
1325,21,$BMEB4,2019-06-30,32578,19838,52416
1325,21,$BMEB4,2019-09-30,32578,19838,52416
1325,21,$BMEB4,2019-12-31,32578,19838,52416
1325,21,$BMEB4,2020-03-31,32578,19838,52416
1325,21,$BMEB4,2020-06-30,32578,19838,52416
1325,21,$BMEB4,2020-09-30,32578,19838,52416
1384,5,$CNPR3,2010-12-31,53949,36275,90224
1384,5,$CNPR3,2011-03-31,53949,36275,90224
1384,5,$CNPR3,2011-06-30,53949,36275,90224
1384,5,$CNPR3,2011-09-30,53949,36275,90224
1384,5,$CNPR3,2011-12-31,53949,36275,90224
1384,5,$CNPR3,2012-03-31,53949,36275,90224
1384,5,$CNPR3,2012-06-30,53949,36275,90224
1384,5,$CNPR3,2012-09-30,53949,36275,90224
1384,5,$CNPR3,2012-12-31,53949,36275,90224
1384,5,$CNPR3,2013-03-31,53949,36275,90224
1384,5,$CNPR3,2013-06-30,53949,36275,90224
1384,5,$CNPR3,2013-09-30,53949,36275,90224
1384,5,$CNPR3,2013-12-31,53949,36275,90224
1384,5,$CNPR3,2014-03-31,53949,36275,90224
1384,5,$CNPR3,2014-06-30,53949,36275,90224
1384,5,$CNPR3,2014-09-30,53949,36275,90224
1384,5,$CNPR3,2014-12-31,53949,36275,90224
1384,5,$CNPR3,2015-03-31,53949,36275,90224
1384,5,$CNPR3,2015-06-30,53949,36275,90224
1384,5,$CNPR3,2015-09-30,53949,36275,90224
1384,5,$CNPR3,2015-12-31,53812,35118,88930
1384,5,$CNPR3,2016-03-31,53812,35118,88930
1384,5,$CNPR3,2016-06-30,53812,35118,88930
1384,5,$CNPR3,2016-09-30,53812129,35118455,88930584
1384,5,$CNPR3,2016-12-31,53812129,35118455,88930584
1384,5,$CNPR3,2017-03-31,53812129,35118455,88930584
1384,5,$CNPR3,2017-06-30,53812129,35118455,88930584
1384,5,$CNPR3,2017-09-30,53812129,35118455,88930584
1384,5,$CNPR3,2017-12-31,53812129,35118455,88930584
1384,5,$CNPR3,2018-03-31,53535329,35118455,88653784
1384,5,$CNPR3,2018-06-30,53482129,35118455,88600584
1384,5,$CNPR3,2018-09-30,53482129,35118455,88600584
1384,5,$CNPR3,2018-12-31,53482129,35118455,88600584
1384,5,$CNPR3,2019-03-31,53482129,35118445,88600574
1384,5,$CNPR3,2019-06-30,53482129,35118455,88600584
1384,5,$CNPR3,2019-09-30,53482129,35118455,88600584
1384,5,$CNPR3,2019-12-31,53482129,35118455,88600584
1384,5,$CNPR3,2020-03-31,53482129,35118455,88600584
1384,5,$CNPR3,2020-06-30,53482129,35118455,88600584
1384,5,$CNPR3,2020-09-30,53482129,35118455,88600584
1384,6,$BRIV3,2010-12-31,53949,36275,90224
1384,6,$BRIV3,2011-03-31,53949,36275,90224
1384,6,$BRIV3,2011-06-30,53949,36275,90224
1384,6,$BRIV3,2011-09-30,53949,36275,90224
1384,6,$BRIV3,2011-12-31,53949,36275,90224
1384,6,$BRIV3,2012-03-31,53949,36275,90224
1384,6,$BRIV3,2012-06-30,53949,36275,90224
1384,6,$BRIV3,2012-09-30,53949,36275,90224
1384,6,$BRIV3,2012-12-31,53949,36275,90224
1384,6,$BRIV3,2013-03-31,53949,36275,90224
1384,6,$BRIV3,2013-06-30,53949,36275,90224
1384,6,$BRIV3,2013-09-30,53949,36275,90224
1384,6,$BRIV3,2013-12-31,53949,36275,90224
1384,6,$BRIV3,2014-03-31,53949,36275,90224
1384,6,$BRIV3,2014-06-30,53949,36275,90224
1384,6,$BRIV3,2014-09-30,53949,36275,90224
1384,6,$BRIV3,2014-12-31,53949,36275,90224
1384,6,$BRIV3,2015-03-31,53949,36275,90224
1384,6,$BRIV3,2015-06-30,53949,36275,90224
1384,6,$BRIV3,2015-09-30,53949,36275,90224
1384,6,$BRIV3,2015-12-31,53812,35118,88930
1384,6,$BRIV3,2016-03-31,53812,35118,88930
1384,6,$BRIV3,2016-06-30,53812,35118,88930
1384,6,$BRIV3,2016-09-30,53812129,35118455,88930584
1384,6,$BRIV3,2016-12-31,53812129,35118455,88930584
1384,6,$BRIV3,2017-03-31,53812129,35118455,88930584
1384,6,$BRIV3,2017-06-30,53812129,35118455,88930584
1384,6,$BRIV3,2017-09-30,53812129,35118455,88930584
1384,6,$BRIV3,2017-12-31,53812129,35118455,88930584
1384,6,$BRIV3,2018-03-31,53535329,35118455,88653784
1384,6,$BRIV3,2018-06-30,53482129,35118455,88600584
1384,6,$BRIV3,2018-09-30,53482129,35118455,88600584
1384,6,$BRIV3,2018-12-31,53482129,35118455,88600584
1384,6,$BRIV3,2019-03-31,53482129,35118445,88600574
1384,6,$BRIV3,2019-06-30,53482129,35118455,88600584
1384,6,$BRIV3,2019-09-30,53482129,35118455,88600584
1384,6,$BRIV3,2019-12-31,53482129,35118455,88600584
1384,6,$BRIV3,2020-03-31,53482129,35118455,88600584
1384,6,$BRIV3,2020-06-30,53482129,35118455,88600584
1384,6,$BRIV3,2020-09-30,53482129,35118455,88600584
1384,7,$BRIV4,2010-12-31,53949,36275,90224
1384,7,$BRIV4,2011-03-31,53949,36275,90224
1384,7,$BRIV4,2011-06-30,53949,36275,90224
1384,7,$BRIV4,2011-09-30,53949,36275,90224
1384,7,$BRIV4,2011-12-31,53949,36275,90224
1384,7,$BRIV4,2012-03-31,53949,36275,90224
1384,7,$BRIV4,2012-06-30,53949,36275,90224
1384,7,$BRIV4,2012-09-30,53949,36275,90224
1384,7,$BRIV4,2012-12-31,53949,36275,90224
1384,7,$BRIV4,2013-03-31,53949,36275,90224
1384,7,$BRIV4,2013-06-30,53949,36275,90224
1384,7,$BRIV4,2013-09-30,53949,36275,90224
1384,7,$BRIV4,2013-12-31,53949,36275,90224
1384,7,$BRIV4,2014-03-31,53949,36275,90224
1384,7,$BRIV4,2014-06-30,53949,36275,90224
1384,7,$BRIV4,2014-09-30,53949,36275,90224
1384,7,$BRIV4,2014-12-31,53949,36275,90224
1384,7,$BRIV4,2015-03-31,53949,36275,90224
1384,7,$BRIV4,2015-06-30,53949,36275,90224
1384,7,$BRIV4,2015-09-30,53949,36275,90224
1384,7,$BRIV4,2015-12-31,53812,35118,88930
1384,7,$BRIV4,2016-03-31,53812,35118,88930
1384,7,$BRIV4,2016-06-30,53812,35118,88930
1384,7,$BRIV4,2016-09-30,53812129,35118455,88930584
1384,7,$BRIV4,2016-12-31,53812129,35118455,88930584
1384,7,$BRIV4,2017-03-31,53812129,35118455,88930584
1384,7,$BRIV4,2017-06-30,53812129,35118455,88930584
1384,7,$BRIV4,2017-09-30,53812129,35118455,88930584
1384,7,$BRIV4,2017-12-31,53812129,35118455,88930584
1384,7,$BRIV4,2018-03-31,53535329,35118455,88653784
1384,7,$BRIV4,2018-06-30,53482129,35118455,88600584
1384,7,$BRIV4,2018-09-30,53482129,35118455,88600584
1384,7,$BRIV4,2018-12-31,53482129,35118455,88600584
1384,7,$BRIV4,2019-03-31,53482129,35118445,88600574
1384,7,$BRIV4,2019-06-30,53482129,35118455,88600584
1384,7,$BRIV4,2019-09-30,53482129,35118455,88600584
1384,7,$BRIV4,2019-12-31,53482129,35118455,88600584
1384,7,$BRIV4,2020-03-31,53482129,35118455,88600584
1384,7,$BRIV4,2020-06-30,53482129,35118455,88600584
1384,7,$BRIV4,2020-09-30,53482129,35118455,88600584
1520,18,$BDLL3,2010-12-31,607192,992808,1600000
1520,18,$BDLL3,2011-03-31,607192,992808,1600000
1520,18,$BDLL3,2011-06-30,607192,992808,1600000
1520,18,$BDLL3,2011-09-30,607192,992808,1600000
1520,18,$BDLL3,2011-12-31,607192,992808,1600000
1520,18,$BDLL3,2012-03-31,607192,992808,1600000
1520,18,$BDLL3,2012-06-30,607192,992808,1600000
1520,18,$BDLL3,2012-09-30,607192,992808,1600000
1520,18,$BDLL3,2012-12-31,607192,992808,1600000
1520,18,$BDLL3,2013-03-31,607192,992808,1600000
1520,18,$BDLL3,2013-06-30,607192,992808,1600000
1520,18,$BDLL3,2013-09-30,607192,992808,1600000
1520,18,$BDLL3,2013-12-31,607192,992808,1600000
1520,18,$BDLL3,2014-03-31,607192,992808,1600000
1520,18,$BDLL3,2014-06-30,607192,992808,1600000
1520,18,$BDLL3,2014-09-30,607192,992808,1600000
1520,18,$BDLL3,2014-12-31,607192,992808,1600000
1520,18,$BDLL3,2015-03-31,607192,992808,1600000
1520,18,$BDLL3,2015-06-30,607192,992808,1600000
1520,18,$BDLL3,2015-09-30,607192,992808,1600000
1520,18,$BDLL3,2015-12-31,607192,992808,1600000
1520,18,$BDLL3,2016-03-31,607192,992808,1600000
1520,18,$BDLL3,2016-06-30,607192,992808,1600000
1520,18,$BDLL3,2016-09-30,607192,992808,1600000
1520,18,$BDLL3,2016-12-31,607192,992808,1600000
1520,18,$BDLL3,2017-03-31,607192,992808,1600000
1520,18,$BDLL3,2017-06-30,607192,992808,1600000
1520,18,$BDLL3,2017-09-30,607192,992808,1600000
1520,18,$BDLL3,2017-12-31,607192,992808,1600000
1520,18,$BDLL3,2018-03-31,607192,992808,1600000
1520,18,$BDLL3,2018-06-30,607192,992808,1600000
1520,18,$BDLL3,2018-09-30,607192,992808,1600000
1520,18,$BDLL3,2018-12-31,607192,992808,1600000
1520,18,$BDLL3,2019-03-31,607192,992808,1600000
1520,18,$BDLL3,2019-06-30,607192,992808,1600000
1520,18,$BDLL3,2019-09-30,607192,992808,1600000
1520,18,$BDLL3,2019-12-31,607192,992808,1600000
1520,18,$BDLL3,2020-03-31,607192,992808,1600000
1520,18,$BDLL3,2020-06-30,607192,992808,1600000
1520,18,$BDLL3,2020-09-30,607192,992808,1600000
1520,19,$BDLL4,2010-12-31,607192,992808,1600000
1520,19,$BDLL4,2011-03-31,607192,992808,1600000
1520,19,$BDLL4,2011-06-30,607192,992808,1600000
1520,19,$BDLL4,2011-09-30,607192,992808,1600000
1520,19,$BDLL4,2011-12-31,607192,992808,1600000
1520,19,$BDLL4,2012-03-31,607192,992808,1600000
1520,19,$BDLL4,2012-06-30,607192,992808,1600000
1520,19,$BDLL4,2012-09-30,607192,992808,1600000
1520,19,$BDLL4,2012-12-31,607192,992808,1600000
1520,19,$BDLL4,2013-03-31,607192,992808,1600000
1520,19,$BDLL4,2013-06-30,607192,992808,1600000
1520,19,$BDLL4,2013-09-30,607192,992808,1600000
1520,19,$BDLL4,2013-12-31,607192,992808,1600000
1520,19,$BDLL4,2014-03-31,607192,992808,1600000
1520,19,$BDLL4,2014-06-30,607192,992808,1600000
1520,19,$BDLL4,2014-09-30,607192,992808,1600000
1520,19,$BDLL4,2014-12-31,607192,992808,1600000
1520,19,$BDLL4,2015-03-31,607192,992808,1600000
1520,19,$BDLL4,2015-06-30,607192,992808,1600000
1520,19,$BDLL4,2015-09-30,607192,992808,1600000
1520,19,$BDLL4,2015-12-31,607192,992808,1600000
1520,19,$BDLL4,2016-03-31,607192,992808,1600000
1520,19,$BDLL4,2016-06-30,607192,992808,1600000
1520,19,$BDLL4,2016-09-30,607192,992808,1600000
1520,19,$BDLL4,2016-12-31,607192,992808,1600000
1520,19,$BDLL4,2017-03-31,607192,992808,1600000
1520,19,$BDLL4,2017-06-30,607192,992808,1600000
1520,19,$BDLL4,2017-09-30,607192,992808,1600000
1520,19,$BDLL4,2017-12-31,607192,992808,1600000
1520,19,$BDLL4,2018-03-31,607192,992808,1600000
1520,19,$BDLL4,2018-06-30,607192,992808,1600000
1520,19,$BDLL4,2018-09-30,607192,992808,1600000
1520,19,$BDLL4,2018-12-31,607192,992808,1600000
1520,19,$BDLL4,2019-03-31,607192,992808,1600000
1520,19,$BDLL4,2019-06-30,607192,992808,1600000
1520,19,$BDLL4,2019-09-30,607192,992808,1600000
1520,19,$BDLL4,2019-12-31,607192,992808,1600000
1520,19,$BDLL4,2020-03-31,607192,992808,1600000
1520,19,$BDLL4,2020-06-30,607192,992808,1600000
1520,19,$BDLL4,2020-09-30,607192,992808,1600000
1562,10,$BALM3,2010-12-31,490000,490000,980000
1562,10,$BALM3,2011-03-31,490000,490000,980000
1562,10,$BALM3,2011-06-30,490000,490000,980000
1562,10,$BALM3,2011-09-30,490000,490000,980000
1562,10,$BALM3,2011-12-31,490000,490000,980000
1562,10,$BALM3,2012-03-31,490000,490000,980000
1562,10,$BALM3,2012-06-30,490000,490000,980000
1562,10,$BALM3,2012-09-30,490000,490000,980000
1562,10,$BALM3,2012-12-31,490000,490000,980000
1562,10,$BALM3,2013-03-31,490000,490000,980000
1562,10,$BALM3,2013-06-30,490000,490000,980000
1562,10,$BALM3,2013-09-30,490000,490000,980000
1562,10,$BALM3,2013-12-31,490000,490000,980000
1562,10,$BALM3,2014-03-31,490000,490000,980000
1562,10,$BALM3,2014-06-30,4900000,4900000,9800000
1562,10,$BALM3,2014-09-30,4900000,4900000,9800000
1562,10,$BALM3,2014-12-31,4900000,4900000,9800000
1562,10,$BALM3,2015-03-31,4900000,4900000,9800000
1562,10,$BALM3,2015-06-30,4900000,4900000,9800000
1562,10,$BALM3,2015-09-30,4900000,4900000,9800000
1562,10,$BALM3,2015-12-31,4900000,4900000,9800000
1562,10,$BALM3,2016-03-31,4900000,4900000,9800000
1562,10,$BALM3,2016-06-30,4900000,4900000,9800000
1562,10,$BALM3,2016-09-30,4900000,4900000,9800000
1562,10,$BALM3,2016-12-31,4900000,4900000,9800000
1562,10,$BALM3,2017-03-31,4900000,4900000,9800000
1562,10,$BALM3,2017-06-30,4900000,4900000,9800000
1562,10,$BALM3,2017-09-30,4900000,4900000,9800000
1562,10,$BALM3,2017-12-31,4900000,4900000,9800000
1562,10,$BALM3,2018-03-31,4900000,4900000,9800000
1562,10,$BALM3,2018-06-30,4900000,4900000,9800000
1562,10,$BALM3,2018-09-30,4900000,4900000,9800000
1562,10,$BALM3,2018-12-31,4900000,4900000,9800000
1562,10,$BALM3,2019-03-31,4888100,4896900,9785000
1562,10,$BALM3,2019-06-30,4888100,4896900,9785000
1562,10,$BALM3,2019-09-30,4900000,4900000,9800000
1562,10,$BALM3,2019-12-31,4900000,4900000,9800000
1562,10,$BALM3,2020-03-31,4900000,4900000,9800000
1562,10,$BALM3,2020-06-30,4900000,4900000,9800000
1562,10,$BALM3,2020-09-30,4900000,4900000,9800000
1562,11,$BALM4,2010-12-31,490000,490000,980000
1562,11,$BALM4,2011-03-31,490000,490000,980000
1562,11,$BALM4,2011-06-30,490000,490000,980000
1562,11,$BALM4,2011-09-30,490000,490000,980000
1562,11,$BALM4,2011-12-31,490000,490000,980000
1562,11,$BALM4,2012-03-31,490000,490000,980000
1562,11,$BALM4,2012-06-30,490000,490000,980000
1562,11,$BALM4,2012-09-30,490000,490000,980000
1562,11,$BALM4,2012-12-31,490000,490000,980000
1562,11,$BALM4,2013-03-31,490000,490000,980000
1562,11,$BALM4,2013-06-30,490000,490000,980000
1562,11,$BALM4,2013-09-30,490000,490000,980000
1562,11,$BALM4,2013-12-31,490000,490000,980000
1562,11,$BALM4,2014-03-31,490000,490000,980000
1562,11,$BALM4,2014-06-30,4900000,4900000,9800000
1562,11,$BALM4,2014-09-30,4900000,4900000,9800000
1562,11,$BALM4,2014-12-31,4900000,4900000,9800000
1562,11,$BALM4,2015-03-31,4900000,4900000,9800000
1562,11,$BALM4,2015-06-30,4900000,4900000,9800000
1562,11,$BALM4,2015-09-30,4900000,4900000,9800000
1562,11,$BALM4,2015-12-31,4900000,4900000,9800000
1562,11,$BALM4,2016-03-31,4900000,4900000,9800000
1562,11,$BALM4,2016-06-30,4900000,4900000,9800000
1562,11,$BALM4,2016-09-30,4900000,4900000,9800000
1562,11,$BALM4,2016-12-31,4900000,4900000,9800000
1562,11,$BALM4,2017-03-31,4900000,4900000,9800000
1562,11,$BALM4,2017-06-30,4900000,4900000,9800000
1562,11,$BALM4,2017-09-30,4900000,4900000,9800000
1562,11,$BALM4,2017-12-31,4900000,4900000,9800000
1562,11,$BALM4,2018-03-31,4900000,4900000,9800000
1562,11,$BALM4,2018-06-30,4900000,4900000,9800000
1562,11,$BALM4,2018-09-30,4900000,4900000,9800000
1562,11,$BALM4,2018-12-31,4900000,4900000,9800000
1562,11,$BALM4,2019-03-31,4888100,4896900,9785000
1562,11,$BALM4,2019-06-30,4888100,4896900,9785000
1562,11,$BALM4,2019-09-30,4900000,4900000,9800000
1562,11,$BALM4,2019-12-31,4900000,4900000,9800000
1562,11,$BALM4,2020-03-31,4900000,4900000,9800000
1562,11,$BALM4,2020-06-30,4900000,4900000,9800000
1562,11,$BALM4,2020-09-30,4900000,4900000,9800000
1570,16,$BAUH3,2010-12-31,2847,2375,5222
1570,16,$BAUH3,2011-03-31,2846929,2375293,5222222
1570,16,$BAUH3,2011-06-30,2846929,2375293,5222222
1570,16,$BAUH3,2011-09-30,2846929,2375293,5222222
1570,16,$BAUH3,2011-12-31,2847,2375,5222
1570,16,$BAUH3,2012-03-31,2847,2375,5222
1570,16,$BAUH3,2012-06-30,2847,2375,5222
1570,16,$BAUH3,2012-09-30,2847,2375,5222
1570,16,$BAUH3,2012-12-31,2847,2375,5222
1570,16,$BAUH3,2013-03-31,2847,2375,5222
1570,16,$BAUH3,2013-06-30,2847,2375,5222
1570,16,$BAUH3,2013-09-30,2847,2375,5222
1570,16,$BAUH3,2013-12-31,2847,2375,5222
1570,16,$BAUH3,2014-03-31,2847,2375,5222
1570,16,$BAUH3,2014-06-30,2847,2375,5222
1570,16,$BAUH3,2014-09-30,2847,2375,5222
1570,16,$BAUH3,2014-12-31,2847,2375,5222
1570,16,$BAUH3,2015-03-31,2847,2375,5222
1570,16,$BAUH3,2015-06-30,2847,2375,5222
1570,16,$BAUH3,2015-09-30,2847,2375,5222
1570,16,$BAUH3,2015-12-31,2847,2375,5222
1570,16,$BAUH3,2016-03-31,2847,2375,5222
1570,16,$BAUH3,2016-06-30,2847,2375,5222
1570,16,$BAUH3,2016-09-30,2847,2375,5222
1570,16,$BAUH3,2016-12-31,2847,2375,5222
1570,16,$BAUH3,2017-03-31,2847,2375,5222
1570,16,$BAUH3,2017-06-30,2847,2375,5222
1570,16,$BAUH3,2017-09-30,2847,2375,5222
1570,16,$BAUH3,2017-12-31,2847,2375,5222
1570,16,$BAUH3,2018-03-31,2847,2375,5222
1570,16,$BAUH3,2018-06-30,2847,2375,5222
1570,16,$BAUH3,2018-09-30,2847,2375,5222
1570,16,$BAUH3,2018-12-31,2847,2375,5222
1570,16,$BAUH3,2019-03-31,2847,2375,5222
1570,16,$BAUH3,2019-06-30,2847,2375,5222
1570,16,$BAUH3,2019-09-30,2847,2375,5222
1570,16,$BAUH3,2019-12-31,2847,2375,5222
1570,16,$BAUH3,2020-03-31,2847,2375,5222
1570,16,$BAUH3,2020-06-30,2847,2375,5222
1570,16,$BAUH3,2020-09-30,2847,2375,5222
1570,17,$BAUH4,2010-12-31,2847,2375,5222
1570,17,$BAUH4,2011-03-31,2846929,2375293,5222222
1570,17,$BAUH4,2011-06-30,2846929,2375293,5222222
1570,17,$BAUH4,2011-09-30,2846929,2375293,5222222
1570,17,$BAUH4,2011-12-31,2847,2375,5222
1570,17,$BAUH4,2012-03-31,2847,2375,5222
1570,17,$BAUH4,2012-06-30,2847,2375,5222
1570,17,$BAUH4,2012-09-30,2847,2375,5222
1570,17,$BAUH4,2012-12-31,2847,2375,5222
1570,17,$BAUH4,2013-03-31,2847,2375,5222
1570,17,$BAUH4,2013-06-30,2847,2375,5222
1570,17,$BAUH4,2013-09-30,2847,2375,5222
1570,17,$BAUH4,2013-12-31,2847,2375,5222
1570,17,$BAUH4,2014-03-31,2847,2375,5222
1570,17,$BAUH4,2014-06-30,2847,2375,5222
1570,17,$BAUH4,2014-09-30,2847,2375,5222
1570,17,$BAUH4,2014-12-31,2847,2375,5222
1570,17,$BAUH4,2015-03-31,2847,2375,5222
1570,17,$BAUH4,2015-06-30,2847,2375,5222
1570,17,$BAUH4,2015-09-30,2847,2375,5222
1570,17,$BAUH4,2015-12-31,2847,2375,5222
1570,17,$BAUH4,2016-03-31,2847,2375,5222
1570,17,$BAUH4,2016-06-30,2847,2375,5222
1570,17,$BAUH4,2016-09-30,2847,2375,5222
1570,17,$BAUH4,2016-12-31,2847,2375,5222
1570,17,$BAUH4,2017-03-31,2847,2375,5222
1570,17,$BAUH4,2017-06-30,2847,2375,5222
1570,17,$BAUH4,2017-09-30,2847,2375,5222
1570,17,$BAUH4,2017-12-31,2847,2375,5222
1570,17,$BAUH4,2018-03-31,2847,2375,5222
1570,17,$BAUH4,2018-06-30,2847,2375,5222
1570,17,$BAUH4,2018-09-30,2847,2375,5222
1570,17,$BAUH4,2018-12-31,2847,2375,5222
1570,17,$BAUH4,2019-03-31,2847,2375,5222
1570,17,$BAUH4,2019-06-30,2847,2375,5222
1570,17,$BAUH4,2019-09-30,2847,2375,5222
1570,17,$BAUH4,2019-12-31,2847,2375,5222
1570,17,$BAUH4,2020-03-31,2847,2375,5222
1570,17,$BAUH4,2020-06-30,2847,2375,5222
1570,17,$BAUH4,2020-09-30,2847,2375,5222
1694,29,$BMFK3,2010-12-31,454750,0,454750
1694,29,$BMFK3,2011-03-31,454750,0,454750
1694,29,$BMFK3,2011-06-30,454750,0,454750
1694,29,$BMFK3,2011-09-30,454750,0,454750
1694,29,$BMFK3,2011-12-31,454750,0,454750
1694,29,$BMFK3,2012-03-31,454750,0,454750
1694,29,$BMFK3,2012-06-30,454750,0,454750
1694,29,$BMFK3,2012-09-30,454750,0,454750
1694,29,$BMFK3,2012-12-31,454750,0,454750
1694,29,$BMFK3,2013-03-31,454750,0,454750
1694,29,$BMFK3,2013-06-30,454750,0,454750
1694,29,$BMFK3,2013-09-30,454750,0,454750
1694,29,$BMFK3,2013-12-31,454750,0,454750
1694,29,$BMFK3,2014-03-31,454750,0,454750
1694,29,$BMFK3,2014-06-30,454750,0,454750
1694,29,$BMFK3,2014-09-30,454750,0,454750
1694,29,$BMFK3,2014-12-31,454750,0,454750
1694,29,$BMFK3,2015-03-31,454750,0,454750
1694,29,$BMFK3,2015-06-30,454750,0,454750
1694,29,$BMFK3,2015-09-30,454750,0,454750
1694,29,$BMFK3,2015-12-31,454750,0,454750
1694,29,$BMFK3,2016-03-31,454750,0,454750
1694,29,$BMFK3,2016-06-30,454750,0,454750
1694,29,$BMFK3,2016-09-30,454750,0,454750
1694,29,$BMFK3,2016-12-31,454750,0,454750
1694,29,$BMFK3,2017-03-31,454750,0,454750
1694,29,$BMFK3,2017-06-30,454750,0,454750
1694,29,$BMFK3,2017-09-30,454750,0,454750
1694,29,$BMFK3,2017-12-31,454750,0,454750
1694,29,$BMFK3,2018-03-31,454750,0,454750
1694,29,$BMFK3,2018-06-30,454750,0,454750
1694,29,$BMFK3,2018-09-30,454750,0,454750
1694,29,$BMFK3,2018-12-31,454750,0,454750
1694,29,$BMFK3,2019-03-31,454750,0,454750
1694,29,$BMFK3,2019-06-30,454750,0,454750
1694,29,$BMFK3,2019-09-30,454750,0,454750
1694,29,$BMFK3,2019-12-31,454750,0,454750
1694,29,$BMFK3,2020-03-31,454750,0,454750
1694,29,$BMFK3,2020-06-30,454750,0,454750
1694,29,$BMFK3,2020-09-30,454750,0,454750
1694,30,$BMKS3,2010-12-31,454750,0,454750
1694,30,$BMKS3,2011-03-31,454750,0,454750
1694,30,$BMKS3,2011-06-30,454750,0,454750
1694,30,$BMKS3,2011-09-30,454750,0,454750
1694,30,$BMKS3,2011-12-31,454750,0,454750
1694,30,$BMKS3,2012-03-31,454750,0,454750
1694,30,$BMKS3,2012-06-30,454750,0,454750
1694,30,$BMKS3,2012-09-30,454750,0,454750
1694,30,$BMKS3,2012-12-31,454750,0,454750
1694,30,$BMKS3,2013-03-31,454750,0,454750
1694,30,$BMKS3,2013-06-30,454750,0,454750
1694,30,$BMKS3,2013-09-30,454750,0,454750
1694,30,$BMKS3,2013-12-31,454750,0,454750
1694,30,$BMKS3,2014-03-31,454750,0,454750
1694,30,$BMKS3,2014-06-30,454750,0,454750
1694,30,$BMKS3,2014-09-30,454750,0,454750
1694,30,$BMKS3,2014-12-31,454750,0,454750
1694,30,$BMKS3,2015-03-31,454750,0,454750
1694,30,$BMKS3,2015-06-30,454750,0,454750
1694,30,$BMKS3,2015-09-30,454750,0,454750
1694,30,$BMKS3,2015-12-31,454750,0,454750
1694,30,$BMKS3,2016-03-31,454750,0,454750
1694,30,$BMKS3,2016-06-30,454750,0,454750
1694,30,$BMKS3,2016-09-30,454750,0,454750
1694,30,$BMKS3,2016-12-31,454750,0,454750
1694,30,$BMKS3,2017-03-31,454750,0,454750
1694,30,$BMKS3,2017-06-30,454750,0,454750
1694,30,$BMKS3,2017-09-30,454750,0,454750
1694,30,$BMKS3,2017-12-31,454750,0,454750
1694,30,$BMKS3,2018-03-31,454750,0,454750
1694,30,$BMKS3,2018-06-30,454750,0,454750
1694,30,$BMKS3,2018-09-30,454750,0,454750
1694,30,$BMKS3,2018-12-31,454750,0,454750
1694,30,$BMKS3,2019-03-31,454750,0,454750
1694,30,$BMKS3,2019-06-30,454750,0,454750
1694,30,$BMKS3,2019-09-30,454750,0,454750
1694,30,$BMKS3,2019-12-31,454750,0,454750
1694,30,$BMKS3,2020-03-31,454750,0,454750
1694,30,$BMKS3,2020-06-30,454750,0,454750
1694,30,$BMKS3,2020-09-30,454750,0,454750
2100,427,$CAMB4,2010-12-31,12421,24539,36960
2100,427,$CAMB4,2011-03-31,12421,24539,36960
2100,427,$CAMB4,2011-06-30,12421,24539,36960
2100,427,$CAMB4,2011-09-30,12421,24539,36960
2100,427,$CAMB4,2011-12-31,12421,24539,36960
2100,427,$CAMB4,2012-03-31,12421,24539,36960
2100,427,$CAMB4,2012-06-30,12421,24539,36960
2100,427,$CAMB4,2012-09-30,12421,24539,36960
2100,427,$CAMB4,2012-12-31,12421,24539,36960
2100,427,$CAMB4,2013-03-31,12421,24539,36960
2100,427,$CAMB4,2013-06-30,12421,24539,36960
2100,427,$CAMB4,2013-09-30,12421,24539,36960
2100,427,$CAMB4,2013-12-31,13087,25465,38552
2100,427,$CAMB4,2014-03-31,13087,25465,38552
2100,427,$CAMB4,2014-06-30,13087,25465,38552
2100,427,$CAMB4,2014-09-30,13087,25465,38552
2100,427,$CAMB4,2014-12-31,13087,25465,38552
2100,427,$CAMB4,2015-03-31,13087,25465,38552
2100,427,$CAMB4,2015-06-30,13087,25465,38552
2100,427,$CAMB4,2015-09-30,13087,25465,38552
2100,427,$CAMB4,2015-12-31,13087,25465,38552
2100,427,$CAMB4,2016-03-31,13087,25465,38552
2100,427,$CAMB4,2016-06-30,1309,2546,3855
2100,427,$CAMB4,2016-09-30,1309,2546,3855
2100,427,$CAMB4,2016-12-31,1309,2546,3855
2100,427,$CAMB4,2017-03-31,1309,2546,3855
2100,427,$CAMB4,2017-06-30,1309,2546,3855
2100,427,$CAMB4,2017-09-30,1309,2546,3855
2100,427,$CAMB4,2017-12-31,1309,2546,3855
2100,427,$CAMB4,2018-03-31,1309,2546,3855
2100,427,$CAMB4,2018-06-30,1309,2546,3855
2100,427,$CAMB4,2018-09-30,1309,2546,3855
2100,427,$CAMB4,2018-12-31,1309,2546,3855
2100,427,$CAMB4,2019-03-31,1309,2546,3855
2100,427,$CAMB4,2019-06-30,1429,2769,4198
2100,427,$CAMB4,2019-09-30,14292,27688,41980
2100,427,$CAMB4,2019-12-31,41980080,0,41980080
2100,427,$CAMB4,2020-03-31,41980080,0,41980080
2100,427,$CAMB4,2020-06-30,41980080,0,41980080
2100,427,$CAMB4,2020-09-30,42100080,0,42100080
2100,430,$CAMB3,2010-12-31,12421,24539,36960
2100,430,$CAMB3,2011-03-31,12421,24539,36960
2100,430,$CAMB3,2011-06-30,12421,24539,36960
2100,430,$CAMB3,2011-09-30,12421,24539,36960
2100,430,$CAMB3,2011-12-31,12421,24539,36960
2100,430,$CAMB3,2012-03-31,12421,24539,36960
2100,430,$CAMB3,2012-06-30,12421,24539,36960
2100,430,$CAMB3,2012-09-30,12421,24539,36960
2100,430,$CAMB3,2012-12-31,12421,24539,36960
2100,430,$CAMB3,2013-03-31,12421,24539,36960
2100,430,$CAMB3,2013-06-30,12421,24539,36960
2100,430,$CAMB3,2013-09-30,12421,24539,36960
2100,430,$CAMB3,2013-12-31,13087,25465,38552
2100,430,$CAMB3,2014-03-31,13087,25465,38552
2100,430,$CAMB3,2014-06-30,13087,25465,38552
2100,430,$CAMB3,2014-09-30,13087,25465,38552
2100,430,$CAMB3,2014-12-31,13087,25465,38552
2100,430,$CAMB3,2015-03-31,13087,25465,38552
2100,430,$CAMB3,2015-06-30,13087,25465,38552
2100,430,$CAMB3,2015-09-30,13087,25465,38552
2100,430,$CAMB3,2015-12-31,13087,25465,38552
2100,430,$CAMB3,2016-03-31,13087,25465,38552
2100,430,$CAMB3,2016-06-30,1309,2546,3855
2100,430,$CAMB3,2016-09-30,1309,2546,3855
2100,430,$CAMB3,2016-12-31,1309,2546,3855
2100,430,$CAMB3,2017-03-31,1309,2546,3855
2100,430,$CAMB3,2017-06-30,1309,2546,3855
2100,430,$CAMB3,2017-09-30,1309,2546,3855
2100,430,$CAMB3,2017-12-31,1309,2546,3855
2100,430,$CAMB3,2018-03-31,1309,2546,3855
2100,430,$CAMB3,2018-06-30,1309,2546,3855
2100,430,$CAMB3,2018-09-30,1309,2546,3855
2100,430,$CAMB3,2018-12-31,1309,2546,3855
2100,430,$CAMB3,2019-03-31,1309,2546,3855
2100,430,$CAMB3,2019-06-30,1429,2769,4198
2100,430,$CAMB3,2019-09-30,14292,27688,41980
2100,430,$CAMB3,2019-12-31,41980080,0,41980080
2100,430,$CAMB3,2020-03-31,41980080,0,41980080
2100,430,$CAMB3,2020-06-30,41980080,0,41980080
2100,430,$CAMB3,2020-09-30,42100080,0,42100080
2429,31,$RANI3,2010-12-31,7464,640,8104
2429,31,$RANI3,2011-03-31,7464,640,8104
2429,31,$RANI3,2011-06-30,7464,640,8104
2429,31,$RANI3,2011-09-30,7464,640,8104
2429,31,$RANI3,2011-12-31,7464,640,8104
2429,31,$RANI3,2012-03-31,7464,640,8104
2429,31,$RANI3,2012-06-30,149280,12810,162090
2429,31,$RANI3,2012-09-30,149280,12810,162090
2429,31,$RANI3,2012-12-31,149280,12810,162090
2429,31,$RANI3,2013-03-31,149280,12810,162090
2429,31,$RANI3,2013-06-30,149280,12810,162090
2429,31,$RANI3,2013-09-30,149280,12810,162090
2429,31,$RANI3,2013-12-31,153910,12810,166720
2429,31,$RANI3,2014-03-31,153910,12810,166720
2429,31,$RANI3,2014-06-30,153910,12810,166720
2429,31,$RANI3,2014-09-30,153910,12810,166720
2429,31,$RANI3,2014-12-31,153910,12810,166720
2429,31,$RANI3,2015-03-31,153910,12810,166720
2429,31,$RANI3,2015-06-30,153910,12810,166720
2429,31,$RANI3,2015-09-30,153910,12810,166720
2429,31,$RANI3,2015-12-31,153910,12810,166720
2429,31,$RANI3,2016-03-31,153910,12810,166720
2429,31,$RANI3,2016-06-30,153910,12810,166720
2429,31,$RANI3,2016-09-30,153910,12810,166720
2429,31,$RANI3,2016-12-31,153910,12810,166720
2429,31,$RANI3,2017-03-31,153910,12810,166720
2429,31,$RANI3,2017-06-30,153910,12810,166720
2429,31,$RANI3,2017-09-30,153910,12810,166720
2429,31,$RANI3,2017-12-31,153910,12810,166720
2429,31,$RANI3,2018-03-31,153910,12810,166720
2429,31,$RANI3,2018-06-30,153910,12810,166720
2429,31,$RANI3,2018-09-30,153910,12810,166720
2429,31,$RANI3,2018-12-31,153910,12810,166720
2429,31,$RANI3,2019-03-31,153910,12810,166720
2429,31,$RANI3,2019-06-30,153910,12810,166720
2429,31,$RANI3,2019-09-30,153910,12810,166720
2429,31,$RANI3,2019-12-31,153910,12810,166720
2429,31,$RANI3,2020-03-31,153910,12810,166720
2429,31,$RANI3,2020-06-30,153910,12810,166720
2429,31,$RANI3,2020-09-30,243910,12810,256720
2429,32,$RANI4,2010-12-31,7464,640,8104
2429,32,$RANI4,2011-03-31,7464,640,8104
2429,32,$RANI4,2011-06-30,7464,640,8104
2429,32,$RANI4,2011-09-30,7464,640,8104
2429,32,$RANI4,2011-12-31,7464,640,8104
2429,32,$RANI4,2012-03-31,7464,640,8104
2429,32,$RANI4,2012-06-30,149280,12810,162090
2429,32,$RANI4,2012-09-30,149280,12810,162090
2429,32,$RANI4,2012-12-31,149280,12810,162090
2429,32,$RANI4,2013-03-31,149280,12810,162090
2429,32,$RANI4,2013-06-30,149280,12810,162090
2429,32,$RANI4,2013-09-30,149280,12810,162090
2429,32,$RANI4,2013-12-31,153910,12810,166720
2429,32,$RANI4,2014-03-31,153910,12810,166720
2429,32,$RANI4,2014-06-30,153910,12810,166720
2429,32,$RANI4,2014-09-30,153910,12810,166720
2429,32,$RANI4,2014-12-31,153910,12810,166720
2429,32,$RANI4,2015-03-31,153910,12810,166720
2429,32,$RANI4,2015-06-30,153910,12810,166720
2429,32,$RANI4,2015-09-30,153910,12810,166720
2429,32,$RANI4,2015-12-31,153910,12810,166720
2429,32,$RANI4,2016-03-31,153910,12810,166720
2429,32,$RANI4,2016-06-30,153910,12810,166720
2429,32,$RANI4,2016-09-30,153910,12810,166720
2429,32,$RANI4,2016-12-31,153910,12810,166720
2429,32,$RANI4,2017-03-31,153910,12810,166720
2429,32,$RANI4,2017-06-30,153910,12810,166720
2429,32,$RANI4,2017-09-30,153910,12810,166720
2429,32,$RANI4,2017-12-31,153910,12810,166720
2429,32,$RANI4,2018-03-31,153910,12810,166720
2429,32,$RANI4,2018-06-30,153910,12810,166720
2429,32,$RANI4,2018-09-30,153910,12810,166720
2429,32,$RANI4,2018-12-31,153910,12810,166720
2429,32,$RANI4,2019-03-31,153910,12810,166720
2429,32,$RANI4,2019-06-30,153910,12810,166720
2429,32,$RANI4,2019-09-30,153910,12810,166720
2429,32,$RANI4,2019-12-31,153910,12810,166720
2429,32,$RANI4,2020-03-31,153910,12810,166720
2429,32,$RANI4,2020-06-30,153910,12810,166720
2429,32,$RANI4,2020-09-30,243910,12810,256720
2437,58,$ELET3,2010-12-31,905023527,227333563,1132357090
2437,58,$ELET3,2011-03-31,1087050297,265583803,1352634100
2437,58,$ELET3,2011-06-30,1087050297,265583803,1352634100
2437,58,$ELET3,2011-09-30,1087050297,265583803,1352634100
2437,58,$ELET3,2011-12-31,1087050297,265583803,1352634100
2437,58,$ELET3,2012-03-31,1087050297,265583803,1352634100
2437,58,$ELET3,2012-06-30,1087050297,265583803,1352634100
2437,58,$ELET3,2012-09-30,1087050297,265583803,1352634100
2437,58,$ELET3,2012-12-31,1087050297,265583803,1352634100
2437,58,$ELET3,2013-03-31,1087050297,265583803,1352634100
2437,58,$ELET3,2013-06-30,1087050297,265583803,1352634100
2437,58,$ELET3,2013-09-30,1087050297,265583803,1352634100
2437,58,$ELET3,2013-12-31,1087050297,265583803,1352634100
2437,58,$ELET3,2014-03-31,1087050297,265583803,1352634100
2437,58,$ELET3,2014-06-30,1087050297,265583803,1352634100
2437,58,$ELET3,2014-09-30,1087050297,265583803,1352634100
2437,58,$ELET3,2014-12-31,1087050297,265583803,1352634100
2437,58,$ELET3,2015-03-31,1087050297,265583803,1352634100
2437,58,$ELET3,2015-06-30,1087050297,265583803,1352634100
2437,58,$ELET3,2015-09-30,1087050297,265583803,1352634100
2437,58,$ELET3,2015-12-31,1087050297,265583803,1352634100
2437,58,$ELET3,2016-03-31,1087050297,265583803,1352634100
2437,58,$ELET3,2016-06-30,1087050297,265583803,1352634100
2437,58,$ELET3,2016-09-30,1087050297,265583803,1352634100
2437,58,$ELET3,2016-12-31,1087050297,265583803,1352634100
2437,58,$ELET3,2017-03-31,1087050297,265583803,1352634100
2437,58,$ELET3,2017-06-30,1087050297,265583803,1352634100
2437,58,$ELET3,2017-09-30,1087050297,265583803,1352634100
2437,58,$ELET3,2017-12-31,1087050297,265583803,1352634100
2437,58,$ELET3,2018-03-31,1087050297,265583803,1352634100
2437,58,$ELET3,2018-06-30,1087050297,265583803,1352634100
2437,58,$ELET3,2018-09-30,1087050297,265583803,1352634100
2437,58,$ELET3,2018-12-31,1087050297,265583803,1352634100
2437,58,$ELET3,2019-03-31,1087050297,265583803,1352634100
2437,58,$ELET3,2019-06-30,1087050297,265583803,1352634100
2437,58,$ELET3,2019-09-30,1087050297,265583803,1352634100
2437,58,$ELET3,2019-12-31,1087050297,265583803,1352634100
2437,58,$ELET3,2020-03-31,1288842596,280088314,1568930910
2437,58,$ELET3,2020-06-30,1288842596,280088314,1568930910
2437,58,$ELET3,2020-09-30,1288842596,280088314,1568930910
2437,59,$ELET6,2010-12-31,905023527,227333563,1132357090
2437,59,$ELET6,2011-03-31,1087050297,265583803,1352634100
2437,59,$ELET6,2011-06-30,1087050297,265583803,1352634100
2437,59,$ELET6,2011-09-30,1087050297,265583803,1352634100
2437,59,$ELET6,2011-12-31,1087050297,265583803,1352634100
2437,59,$ELET6,2012-03-31,1087050297,265583803,1352634100
2437,59,$ELET6,2012-06-30,1087050297,265583803,1352634100
2437,59,$ELET6,2012-09-30,1087050297,265583803,1352634100
2437,59,$ELET6,2012-12-31,1087050297,265583803,1352634100
2437,59,$ELET6,2013-03-31,1087050297,265583803,1352634100
2437,59,$ELET6,2013-06-30,1087050297,265583803,1352634100
2437,59,$ELET6,2013-09-30,1087050297,265583803,1352634100
2437,59,$ELET6,2013-12-31,1087050297,265583803,1352634100
2437,59,$ELET6,2014-03-31,1087050297,265583803,1352634100
2437,59,$ELET6,2014-06-30,1087050297,265583803,1352634100
2437,59,$ELET6,2014-09-30,1087050297,265583803,1352634100
2437,59,$ELET6,2014-12-31,1087050297,265583803,1352634100
2437,59,$ELET6,2015-03-31,1087050297,265583803,1352634100
2437,59,$ELET6,2015-06-30,1087050297,265583803,1352634100
2437,59,$ELET6,2015-09-30,1087050297,265583803,1352634100
2437,59,$ELET6,2015-12-31,1087050297,265583803,1352634100
2437,59,$ELET6,2016-03-31,1087050297,265583803,1352634100
2437,59,$ELET6,2016-06-30,1087050297,265583803,1352634100
2437,59,$ELET6,2016-09-30,1087050297,265583803,1352634100
2437,59,$ELET6,2016-12-31,1087050297,265583803,1352634100
2437,59,$ELET6,2017-03-31,1087050297,265583803,1352634100
2437,59,$ELET6,2017-06-30,1087050297,265583803,1352634100
2437,59,$ELET6,2017-09-30,1087050297,265583803,1352634100
2437,59,$ELET6,2017-12-31,1087050297,265583803,1352634100
2437,59,$ELET6,2018-03-31,1087050297,265583803,1352634100
2437,59,$ELET6,2018-06-30,1087050297,265583803,1352634100
2437,59,$ELET6,2018-09-30,1087050297,265583803,1352634100
2437,59,$ELET6,2018-12-31,1087050297,265583803,1352634100
2437,59,$ELET6,2019-03-31,1087050297,265583803,1352634100
2437,59,$ELET6,2019-06-30,1087050297,265583803,1352634100
2437,59,$ELET6,2019-09-30,1087050297,265583803,1352634100
2437,59,$ELET6,2019-12-31,1087050297,265583803,1352634100
2437,59,$ELET6,2020-03-31,1288842596,280088314,1568930910
2437,59,$ELET6,2020-06-30,1288842596,280088314,1568930910
2437,59,$ELET6,2020-09-30,1288842596,280088314,1568930910
2437,60,$ELET5,2010-12-31,905023527,227333563,1132357090
2437,60,$ELET5,2011-03-31,1087050297,265583803,1352634100
2437,60,$ELET5,2011-06-30,1087050297,265583803,1352634100
2437,60,$ELET5,2011-09-30,1087050297,265583803,1352634100
2437,60,$ELET5,2011-12-31,1087050297,265583803,1352634100
2437,60,$ELET5,2012-03-31,1087050297,265583803,1352634100
2437,60,$ELET5,2012-06-30,1087050297,265583803,1352634100
2437,60,$ELET5,2012-09-30,1087050297,265583803,1352634100
2437,60,$ELET5,2012-12-31,1087050297,265583803,1352634100
2437,60,$ELET5,2013-03-31,1087050297,265583803,1352634100
2437,60,$ELET5,2013-06-30,1087050297,265583803,1352634100
2437,60,$ELET5,2013-09-30,1087050297,265583803,1352634100
2437,60,$ELET5,2013-12-31,1087050297,265583803,1352634100
2437,60,$ELET5,2014-03-31,1087050297,265583803,1352634100
2437,60,$ELET5,2014-06-30,1087050297,265583803,1352634100
2437,60,$ELET5,2014-09-30,1087050297,265583803,1352634100
2437,60,$ELET5,2014-12-31,1087050297,265583803,1352634100
2437,60,$ELET5,2015-03-31,1087050297,265583803,1352634100
2437,60,$ELET5,2015-06-30,1087050297,265583803,1352634100
2437,60,$ELET5,2015-09-30,1087050297,265583803,1352634100
2437,60,$ELET5,2015-12-31,1087050297,265583803,1352634100
2437,60,$ELET5,2016-03-31,1087050297,265583803,1352634100
2437,60,$ELET5,2016-06-30,1087050297,265583803,1352634100
2437,60,$ELET5,2016-09-30,1087050297,265583803,1352634100
2437,60,$ELET5,2016-12-31,1087050297,265583803,1352634100
2437,60,$ELET5,2017-03-31,1087050297,265583803,1352634100
2437,60,$ELET5,2017-06-30,1087050297,265583803,1352634100
2437,60,$ELET5,2017-09-30,1087050297,265583803,1352634100
2437,60,$ELET5,2017-12-31,1087050297,265583803,1352634100
2437,60,$ELET5,2018-03-31,1087050297,265583803,1352634100
2437,60,$ELET5,2018-06-30,1087050297,265583803,1352634100
2437,60,$ELET5,2018-09-30,1087050297,265583803,1352634100
2437,60,$ELET5,2018-12-31,1087050297,265583803,1352634100
2437,60,$ELET5,2019-03-31,1087050297,265583803,1352634100
2437,60,$ELET5,2019-06-30,1087050297,265583803,1352634100
2437,60,$ELET5,2019-09-30,1087050297,265583803,1352634100
2437,60,$ELET5,2019-12-31,1087050297,265583803,1352634100
2437,60,$ELET5,2020-03-31,1288842596,280088314,1568930910
2437,60,$ELET5,2020-06-30,1288842596,280088314,1568930910
2437,60,$ELET5,2020-09-30,1288842596,280088314,1568930910
2453,47,$CMIG3,2010-12-31,298270,384145,682415
2453,47,$CMIG3,2011-03-31,298270,384145,682415
2453,47,$CMIG3,2011-06-30,298269668,384144914,682414582
2453,47,$CMIG3,2011-09-30,298269668,384144914,682414582
2453,47,$CMIG3,2011-12-31,298270,384145,682415
2453,47,$CMIG3,2012-03-31,298270,384145,682415
2453,47,$CMIG3,2012-06-30,372837,480181,853018
2453,47,$CMIG3,2012-09-30,372837,480181,853018
2453,47,$CMIG3,2012-12-31,372837,479818,852655
2453,47,$CMIG3,2013-03-31,372837,480181,853018
2453,47,$CMIG3,2013-06-30,420765,541907,962672
2453,47,$CMIG3,2013-09-30,420765,541907,962672
2453,47,$CMIG3,2013-12-31,420765,838077,1258842
2453,47,$CMIG3,2014-03-31,420765,838077,1258842
2453,47,$CMIG3,2014-06-30,420765,838077,1258842
2453,47,$CMIG3,2014-09-30,420765,838077,1258842
2453,47,$CMIG3,2014-12-31,420765,838077,1258842
2453,47,$CMIG3,2015-03-31,420765,838077,1258842
2453,47,$CMIG3,2015-06-30,420765,838077,1258842
2453,47,$CMIG3,2015-09-30,420765,838077,1258842
2453,47,$CMIG3,2015-12-31,420765,838077,1258842
2453,47,$CMIG3,2016-03-31,420765,838077,1258842
2453,47,$CMIG3,2016-06-30,420765,838077,1258842
2453,47,$CMIG3,2016-09-30,420765,838077,1258842
2453,47,$CMIG3,2016-12-31,420765,838077,1258842
2453,47,$CMIG3,2017-03-31,420765,838077,1258842
2453,47,$CMIG3,2017-06-30,420765,838077,1258842
2453,47,$CMIG3,2017-09-30,420765,838077,1258842
2453,47,$CMIG3,2017-12-31,420765,838077,1258842
2453,47,$CMIG3,2018-03-31,420765,838077,1258842
2453,47,$CMIG3,2018-06-30,487614,971138,1458752
2453,47,$CMIG3,2018-09-30,487614,971138,1458752
2453,47,$CMIG3,2018-12-31,487614,971138,1458752
2453,47,$CMIG3,2019-03-31,487614,971138,1458752
2453,47,$CMIG3,2019-06-30,487614,971138,1458752
2453,47,$CMIG3,2019-09-30,487614,971138,1458752
2453,47,$CMIG3,2019-12-31,487614,971138,1458752
2453,47,$CMIG3,2020-03-31,487614,971138,1458752
2453,47,$CMIG3,2020-06-30,487614,971138,1458752
2453,47,$CMIG3,2020-09-30,507670,1011082,1518752
2453,48,$CMIG4,2010-12-31,298270,384145,682415
2453,48,$CMIG4,2011-03-31,298270,384145,682415
2453,48,$CMIG4,2011-06-30,298269668,384144914,682414582
2453,48,$CMIG4,2011-09-30,298269668,384144914,682414582
2453,48,$CMIG4,2011-12-31,298270,384145,682415
2453,48,$CMIG4,2012-03-31,298270,384145,682415
2453,48,$CMIG4,2012-06-30,372837,480181,853018
2453,48,$CMIG4,2012-09-30,372837,480181,853018
2453,48,$CMIG4,2012-12-31,372837,479818,852655
2453,48,$CMIG4,2013-03-31,372837,480181,853018
2453,48,$CMIG4,2013-06-30,420765,541907,962672
2453,48,$CMIG4,2013-09-30,420765,541907,962672
2453,48,$CMIG4,2013-12-31,420765,838077,1258842
2453,48,$CMIG4,2014-03-31,420765,838077,1258842
2453,48,$CMIG4,2014-06-30,420765,838077,1258842
2453,48,$CMIG4,2014-09-30,420765,838077,1258842
2453,48,$CMIG4,2014-12-31,420765,838077,1258842
2453,48,$CMIG4,2015-03-31,420765,838077,1258842
2453,48,$CMIG4,2015-06-30,420765,838077,1258842
2453,48,$CMIG4,2015-09-30,420765,838077,1258842
2453,48,$CMIG4,2015-12-31,420765,838077,1258842
2453,48,$CMIG4,2016-03-31,420765,838077,1258842
2453,48,$CMIG4,2016-06-30,420765,838077,1258842
2453,48,$CMIG4,2016-09-30,420765,838077,1258842
2453,48,$CMIG4,2016-12-31,420765,838077,1258842
2453,48,$CMIG4,2017-03-31,420765,838077,1258842
2453,48,$CMIG4,2017-06-30,420765,838077,1258842
2453,48,$CMIG4,2017-09-30,420765,838077,1258842
2453,48,$CMIG4,2017-12-31,420765,838077,1258842
2453,48,$CMIG4,2018-03-31,420765,838077,1258842
2453,48,$CMIG4,2018-06-30,487614,971138,1458752
2453,48,$CMIG4,2018-09-30,487614,971138,1458752
2453,48,$CMIG4,2018-12-31,487614,971138,1458752
2453,48,$CMIG4,2019-03-31,487614,971138,1458752
2453,48,$CMIG4,2019-06-30,487614,971138,1458752
2453,48,$CMIG4,2019-09-30,487614,971138,1458752
2453,48,$CMIG4,2019-12-31,487614,971138,1458752
2453,48,$CMIG4,2020-03-31,487614,971138,1458752
2453,48,$CMIG4,2020-06-30,487614,971138,1458752
2453,48,$CMIG4,2020-09-30,507670,1011082,1518752
2461,38,$CLSC3,2010-12-31,15527,23044,38571
2461,38,$CLSC3,2011-03-31,15527,23044,38571
2461,38,$CLSC3,2011-06-30,15527,23044,38571
2461,38,$CLSC3,2011-09-30,15527,23044,38571
2461,38,$CLSC3,2011-12-31,15527,23044,38571
2461,38,$CLSC3,2012-03-31,15527,23044,38571
2461,38,$CLSC3,2012-06-30,15527,23044,38571
2461,38,$CLSC3,2012-09-30,15527,23044,38571
2461,38,$CLSC3,2012-12-31,15527,23044,38571
2461,38,$CLSC3,2013-03-31,15527,23044,38571
2461,38,$CLSC3,2013-06-30,15527,23044,38571
2461,38,$CLSC3,2013-09-30,15527,23044,38571
2461,38,$CLSC3,2013-12-31,15527,23044,38571
2461,38,$CLSC3,2014-03-31,15527,23044,38571
2461,38,$CLSC3,2014-06-30,15527,23044,38571
2461,38,$CLSC3,2014-09-30,15527,23044,38571
2461,38,$CLSC3,2014-12-31,15527,23044,38571
2461,38,$CLSC3,2015-03-31,15527,23044,38571
2461,38,$CLSC3,2015-06-30,15527,23044,38571
2461,38,$CLSC3,2015-09-30,15527,23044,38571
2461,38,$CLSC3,2015-12-31,15527,23044,38571
2461,38,$CLSC3,2016-03-31,15527,23044,38571
2461,38,$CLSC3,2016-06-30,15527,23044,38571
2461,38,$CLSC3,2016-09-30,15527,23044,38571
2461,38,$CLSC3,2016-12-31,15527,23044,38571
2461,38,$CLSC3,2017-03-31,15527,23044,38571
2461,38,$CLSC3,2017-06-30,15527,23044,38571
2461,38,$CLSC3,2017-09-30,15527,23044,38571
2461,38,$CLSC3,2017-12-31,15527,23044,38571
2461,38,$CLSC3,2018-03-31,15527,23044,38571
2461,38,$CLSC3,2018-06-30,15527,23044,38571
2461,38,$CLSC3,2018-09-30,15527,23044,38571
2461,38,$CLSC3,2018-12-31,15527,23044,38571
2461,38,$CLSC3,2019-03-31,15527,23044,38571
2461,38,$CLSC3,2019-06-30,15527,23044,38571
2461,38,$CLSC3,2019-09-30,15527,23044,38571
2461,38,$CLSC3,2019-12-31,15527,23044,38571
2461,38,$CLSC3,2020-03-31,15527,23044,38571
2461,38,$CLSC3,2020-06-30,15527,23044,38571
2461,38,$CLSC3,2020-09-30,15527,23044,38571
2461,39,$CLSC4,2010-12-31,15527,23044,38571
2461,39,$CLSC4,2011-03-31,15527,23044,38571
2461,39,$CLSC4,2011-06-30,15527,23044,38571
2461,39,$CLSC4,2011-09-30,15527,23044,38571
2461,39,$CLSC4,2011-12-31,15527,23044,38571
2461,39,$CLSC4,2012-03-31,15527,23044,38571
2461,39,$CLSC4,2012-06-30,15527,23044,38571
2461,39,$CLSC4,2012-09-30,15527,23044,38571
2461,39,$CLSC4,2012-12-31,15527,23044,38571
2461,39,$CLSC4,2013-03-31,15527,23044,38571
2461,39,$CLSC4,2013-06-30,15527,23044,38571
2461,39,$CLSC4,2013-09-30,15527,23044,38571
2461,39,$CLSC4,2013-12-31,15527,23044,38571
2461,39,$CLSC4,2014-03-31,15527,23044,38571
2461,39,$CLSC4,2014-06-30,15527,23044,38571
2461,39,$CLSC4,2014-09-30,15527,23044,38571
2461,39,$CLSC4,2014-12-31,15527,23044,38571
2461,39,$CLSC4,2015-03-31,15527,23044,38571
2461,39,$CLSC4,2015-06-30,15527,23044,38571
2461,39,$CLSC4,2015-09-30,15527,23044,38571
2461,39,$CLSC4,2015-12-31,15527,23044,38571
2461,39,$CLSC4,2016-03-31,15527,23044,38571
2461,39,$CLSC4,2016-06-30,15527,23044,38571
2461,39,$CLSC4,2016-09-30,15527,23044,38571
2461,39,$CLSC4,2016-12-31,15527,23044,38571
2461,39,$CLSC4,2017-03-31,15527,23044,38571
2461,39,$CLSC4,2017-06-30,15527,23044,38571
2461,39,$CLSC4,2017-09-30,15527,23044,38571
2461,39,$CLSC4,2017-12-31,15527,23044,38571
2461,39,$CLSC4,2018-03-31,15527,23044,38571
2461,39,$CLSC4,2018-06-30,15527,23044,38571
2461,39,$CLSC4,2018-09-30,15527,23044,38571
2461,39,$CLSC4,2018-12-31,15527,23044,38571
2461,39,$CLSC4,2019-03-31,15527,23044,38571
2461,39,$CLSC4,2019-06-30,15527,23044,38571
2461,39,$CLSC4,2019-09-30,15527,23044,38571
2461,39,$CLSC4,2019-12-31,15527,23044,38571
2461,39,$CLSC4,2020-03-31,15527,23044,38571
2461,39,$CLSC4,2020-06-30,15527,23044,38571
2461,39,$CLSC4,2020-09-30,15527,23044,38571
2577,35,$CESP3,2010-12-31,109168,218335,327503
2577,35,$CESP3,2011-03-31,109168,218335,327503
2577,35,$CESP3,2011-06-30,109168,218335,327503
2577,35,$CESP3,2011-09-30,109168,218335,327503
2577,35,$CESP3,2011-12-31,109168,218335,327503
2577,35,$CESP3,2012-03-31,109168,218335,327503
2577,35,$CESP3,2012-06-30,109168,218335,327503
2577,35,$CESP3,2012-09-30,109168,218335,327503
2577,35,$CESP3,2012-12-31,109168,218335,327503
2577,35,$CESP3,2013-03-31,109168,218335,327503
2577,35,$CESP3,2013-06-30,109168,218335,327503
2577,35,$CESP3,2013-09-30,109168,218335,327503
2577,35,$CESP3,2013-12-31,109168,218335,327503
2577,35,$CESP3,2014-03-31,109168,218335,327503
2577,35,$CESP3,2014-06-30,109168,218335,327503
2577,35,$CESP3,2014-09-30,109168,218335,327503
2577,35,$CESP3,2014-12-31,109168,218335,327503
2577,35,$CESP3,2015-03-31,109168,218335,327503
2577,35,$CESP3,2015-06-30,109168,218335,327503
2577,35,$CESP3,2015-09-30,109168,218335,327503
2577,35,$CESP3,2015-12-31,109168,218335,327503
2577,35,$CESP3,2016-03-31,109168,218335,327503
2577,35,$CESP3,2016-06-30,109168,218335,327503
2577,35,$CESP3,2016-09-30,109168,218335,327503
2577,35,$CESP3,2016-12-31,109168,218335,327503
2577,35,$CESP3,2017-03-31,109168,218335,327503
2577,35,$CESP3,2017-06-30,109168,218335,327503
2577,35,$CESP3,2017-09-30,109168,218335,327503
2577,35,$CESP3,2017-12-31,109168,218335,327503
2577,35,$CESP3,2018-03-31,109168,218335,327503
2577,35,$CESP3,2018-06-30,109168,218335,327503
2577,35,$CESP3,2018-09-30,109168,218335,327503
2577,35,$CESP3,2018-12-31,109168,218335,327503
2577,35,$CESP3,2019-03-31,109168,218335,327503
2577,35,$CESP3,2019-06-30,109168,218335,327503
2577,35,$CESP3,2019-09-30,109168,218335,327503
2577,35,$CESP3,2019-12-31,109168,218335,327503
2577,35,$CESP3,2020-03-31,109168,218335,327503
2577,35,$CESP3,2020-06-30,109168,218335,327503
2577,35,$CESP3,2020-09-30,109168,218335,327503
2577,36,$CESP5,2010-12-31,109168,218335,327503
2577,36,$CESP5,2011-03-31,109168,218335,327503
2577,36,$CESP5,2011-06-30,109168,218335,327503
2577,36,$CESP5,2011-09-30,109168,218335,327503
2577,36,$CESP5,2011-12-31,109168,218335,327503
2577,36,$CESP5,2012-03-31,109168,218335,327503
2577,36,$CESP5,2012-06-30,109168,218335,327503
2577,36,$CESP5,2012-09-30,109168,218335,327503
2577,36,$CESP5,2012-12-31,109168,218335,327503
2577,36,$CESP5,2013-03-31,109168,218335,327503
2577,36,$CESP5,2013-06-30,109168,218335,327503
2577,36,$CESP5,2013-09-30,109168,218335,327503
2577,36,$CESP5,2013-12-31,109168,218335,327503
2577,36,$CESP5,2014-03-31,109168,218335,327503
2577,36,$CESP5,2014-06-30,109168,218335,327503
2577,36,$CESP5,2014-09-30,109168,218335,327503
2577,36,$CESP5,2014-12-31,109168,218335,327503
2577,36,$CESP5,2015-03-31,109168,218335,327503
2577,36,$CESP5,2015-06-30,109168,218335,327503
2577,36,$CESP5,2015-09-30,109168,218335,327503
2577,36,$CESP5,2015-12-31,109168,218335,327503
2577,36,$CESP5,2016-03-31,109168,218335,327503
2577,36,$CESP5,2016-06-30,109168,218335,327503
2577,36,$CESP5,2016-09-30,109168,218335,327503
2577,36,$CESP5,2016-12-31,109168,218335,327503
2577,36,$CESP5,2017-03-31,109168,218335,327503
2577,36,$CESP5,2017-06-30,109168,218335,327503
2577,36,$CESP5,2017-09-30,109168,218335,327503
2577,36,$CESP5,2017-12-31,109168,218335,327503
2577,36,$CESP5,2018-03-31,109168,218335,327503
2577,36,$CESP5,2018-06-30,109168,218335,327503
2577,36,$CESP5,2018-09-30,109168,218335,327503
2577,36,$CESP5,2018-12-31,109168,218335,327503
2577,36,$CESP5,2019-03-31,109168,218335,327503
2577,36,$CESP5,2019-06-30,109168,218335,327503
2577,36,$CESP5,2019-09-30,109168,218335,327503
2577,36,$CESP5,2019-12-31,109168,218335,327503
2577,36,$CESP5,2020-03-31,109168,218335,327503
2577,36,$CESP5,2020-06-30,109168,218335,327503
2577,36,$CESP5,2020-09-30,109168,218335,327503
2577,37,$CESP6,2010-12-31,109168,218335,327503
2577,37,$CESP6,2011-03-31,109168,218335,327503
2577,37,$CESP6,2011-06-30,109168,218335,327503
2577,37,$CESP6,2011-09-30,109168,218335,327503
2577,37,$CESP6,2011-12-31,109168,218335,327503
2577,37,$CESP6,2012-03-31,109168,218335,327503
2577,37,$CESP6,2012-06-30,109168,218335,327503
2577,37,$CESP6,2012-09-30,109168,218335,327503
2577,37,$CESP6,2012-12-31,109168,218335,327503
2577,37,$CESP6,2013-03-31,109168,218335,327503
2577,37,$CESP6,2013-06-30,109168,218335,327503
2577,37,$CESP6,2013-09-30,109168,218335,327503
2577,37,$CESP6,2013-12-31,109168,218335,327503
2577,37,$CESP6,2014-03-31,109168,218335,327503
2577,37,$CESP6,2014-06-30,109168,218335,327503
2577,37,$CESP6,2014-09-30,109168,218335,327503
2577,37,$CESP6,2014-12-31,109168,218335,327503
2577,37,$CESP6,2015-03-31,109168,218335,327503
2577,37,$CESP6,2015-06-30,109168,218335,327503
2577,37,$CESP6,2015-09-30,109168,218335,327503
2577,37,$CESP6,2015-12-31,109168,218335,327503
2577,37,$CESP6,2016-03-31,109168,218335,327503
2577,37,$CESP6,2016-06-30,109168,218335,327503
2577,37,$CESP6,2016-09-30,109168,218335,327503
2577,37,$CESP6,2016-12-31,109168,218335,327503
2577,37,$CESP6,2017-03-31,109168,218335,327503
2577,37,$CESP6,2017-06-30,109168,218335,327503
2577,37,$CESP6,2017-09-30,109168,218335,327503
2577,37,$CESP6,2017-12-31,109168,218335,327503
2577,37,$CESP6,2018-03-31,109168,218335,327503
2577,37,$CESP6,2018-06-30,109168,218335,327503
2577,37,$CESP6,2018-09-30,109168,218335,327503
2577,37,$CESP6,2018-12-31,109168,218335,327503
2577,37,$CESP6,2019-03-31,109168,218335,327503
2577,37,$CESP6,2019-06-30,109168,218335,327503
2577,37,$CESP6,2019-09-30,109168,218335,327503
2577,37,$CESP6,2019-12-31,109168,218335,327503
2577,37,$CESP6,2020-03-31,109168,218335,327503
2577,37,$CESP6,2020-06-30,109168,218335,327503
2577,37,$CESP6,2020-09-30,109168,218335,327503
3050,34,$CBEE3,2010-12-31,3922515918,0,3922515918
3050,34,$CBEE3,2011-03-31,3922515918,0,3922515918
3050,34,$CBEE3,2011-06-30,3922515918,0,3922515918
3050,34,$CBEE3,2011-09-30,3922515918,0,3922515918
3050,34,$CBEE3,2011-12-31,3922515918,0,3922515918
3050,34,$CBEE3,2012-03-31,3922515918,0,3922515918
3050,34,$CBEE3,2012-06-30,3922515918,0,3922515918
3050,34,$CBEE3,2012-09-30,3922515918,0,3922515918
3050,34,$CBEE3,2012-12-31,3922515918,0,3922515918
3050,34,$CBEE3,2013-03-31,3922515918,0,3922515918
3050,34,$CBEE3,2013-06-30,3922515918,0,3922515918
3050,34,$CBEE3,2013-09-30,3922515918,0,3922515918
3050,34,$CBEE3,2013-12-31,3922515918,0,3922515918
3050,34,$CBEE3,2014-03-31,3922515918,0,3922515918
3050,34,$CBEE3,2014-06-30,3922515918,0,3922515918
3050,34,$CBEE3,2014-09-30,3922515918,0,3922515918
3050,34,$CBEE3,2014-12-31,3922515918,0,3922515918
3050,34,$CBEE3,2015-03-31,3922515918,0,3922515918
3050,34,$CBEE3,2015-06-30,3922515918,0,3922515918
3050,34,$CBEE3,2015-09-30,3922515915,0,3922515915
3050,34,$CBEE3,2015-12-31,3922515918,0,3922515918
3050,34,$CBEE3,2016-03-31,98062,0,98062
3050,34,$CBEE3,2016-06-30,98063,0,98063
3050,34,$CBEE3,2016-09-30,98063,0,98063
3050,34,$CBEE3,2016-12-31,98063,0,98063
3050,34,$CBEE3,2017-03-31,98062,0,98062
3050,34,$CBEE3,2017-06-30,98063,0,98063
3050,34,$CBEE3,2017-09-30,98063,0,98063
3050,34,$CBEE3,2017-12-31,166634,0,166634
3050,34,$CBEE3,2018-03-31,166634,0,166634
3050,34,$CBEE3,2018-06-30,166634,0,166634
3050,34,$CBEE3,2018-09-30,166634,0,166634
3050,34,$CBEE3,2018-12-31,166634,0,166634
3050,34,$CBEE3,2019-03-31,166634,0,166634
3050,34,$CBEE3,2019-06-30,166634,0,166634
3050,34,$CBEE3,2019-09-30,166634,0,166634
3050,34,$CBEE3,2019-12-31,166634,0,166634
3050,34,$CBEE3,2020-03-31,166634,0,166634
3050,34,$CBEE3,2020-06-30,166634,0,166634
3050,34,$CBEE3,2020-09-30,166634,0,166634
3069,40,$FESA3,2010-12-31,29440000,58880000,88320000
3069,40,$FESA3,2011-03-31,29440,58880,88320
3069,40,$FESA3,2011-06-30,29440,58880,88320
3069,40,$FESA3,2011-09-30,29440,58880,88320
3069,40,$FESA3,2011-12-31,29440000,58880000,88320000
3069,40,$FESA3,2012-03-31,29440,58880,88320
3069,40,$FESA3,2012-06-30,29440,58880,88320
3069,40,$FESA3,2012-09-30,29440,58880,88320
3069,40,$FESA3,2012-12-31,29440000,58880000,88320000
3069,40,$FESA3,2013-03-31,29440,58880,88320
3069,40,$FESA3,2013-06-30,29440,58880,88320
3069,40,$FESA3,2013-09-30,29440,58880,88320
3069,40,$FESA3,2013-12-31,29440000,58880000,88320000
3069,40,$FESA3,2014-03-31,29440000,58880000,88320000
3069,40,$FESA3,2014-06-30,29440000,58880000,88320000
3069,40,$FESA3,2014-09-30,29440000,58880000,88320000
3069,40,$FESA3,2014-12-31,29440000,58880000,88320000
3069,40,$FESA3,2015-03-31,29440000,58880000,88320000
3069,40,$FESA3,2015-06-30,29440000,58880000,88320000
3069,40,$FESA3,2015-09-30,29440000,58880000,88320000
3069,40,$FESA3,2015-12-31,29440000,58880000,88320000
3069,40,$FESA3,2016-03-31,29440000,58880000,88320000
3069,40,$FESA3,2016-06-30,29440000,58880000,88320000
3069,40,$FESA3,2016-09-30,29440000,58880000,88320000
3069,40,$FESA3,2016-12-31,29440000,58880000,88320000
3069,40,$FESA3,2017-03-31,29440000,58880000,88320000
3069,40,$FESA3,2017-06-30,29440000,58880000,88320000
3069,40,$FESA3,2017-09-30,29440000,58880000,88320000
3069,40,$FESA3,2017-12-31,29440000,58880000,88320000
3069,40,$FESA3,2018-03-31,29440000,58880000,88320000
3069,40,$FESA3,2018-06-30,29440000,58880000,88320000
3069,40,$FESA3,2018-09-30,29440000,58880000,88320000
3069,40,$FESA3,2018-12-31,29440000,58880000,88320000
3069,40,$FESA3,2019-03-31,29440000,58880000,88320000
3069,40,$FESA3,2019-06-30,29440000,58880000,88320000
3069,40,$FESA3,2019-09-30,29440000,58880000,88320000
3069,40,$FESA3,2019-12-31,29440000,58880000,88320000
3069,40,$FESA3,2020-03-31,29440000,58880000,88320000
3069,40,$FESA3,2020-06-30,29440000,58880000,88320000
3069,40,$FESA3,2020-09-30,29440000,58880000,88320000
3069,41,$FESA4,2010-12-31,29440000,58880000,88320000
3069,41,$FESA4,2011-03-31,29440,58880,88320
3069,41,$FESA4,2011-06-30,29440,58880,88320
3069,41,$FESA4,2011-09-30,29440,58880,88320
3069,41,$FESA4,2011-12-31,29440000,58880000,88320000
3069,41,$FESA4,2012-03-31,29440,58880,88320
3069,41,$FESA4,2012-06-30,29440,58880,88320
3069,41,$FESA4,2012-09-30,29440,58880,88320
3069,41,$FESA4,2012-12-31,29440000,58880000,88320000
3069,41,$FESA4,2013-03-31,29440,58880,88320
3069,41,$FESA4,2013-06-30,29440,58880,88320
3069,41,$FESA4,2013-09-30,29440,58880,88320
3069,41,$FESA4,2013-12-31,29440000,58880000,88320000
3069,41,$FESA4,2014-03-31,29440000,58880000,88320000
3069,41,$FESA4,2014-06-30,29440000,58880000,88320000
3069,41,$FESA4,2014-09-30,29440000,58880000,88320000
3069,41,$FESA4,2014-12-31,29440000,58880000,88320000
3069,41,$FESA4,2015-03-31,29440000,58880000,88320000
3069,41,$FESA4,2015-06-30,29440000,58880000,88320000
3069,41,$FESA4,2015-09-30,29440000,58880000,88320000
3069,41,$FESA4,2015-12-31,29440000,58880000,88320000
3069,41,$FESA4,2016-03-31,29440000,58880000,88320000
3069,41,$FESA4,2016-06-30,29440000,58880000,88320000
3069,41,$FESA4,2016-09-30,29440000,58880000,88320000
3069,41,$FESA4,2016-12-31,29440000,58880000,88320000
3069,41,$FESA4,2017-03-31,29440000,58880000,88320000
3069,41,$FESA4,2017-06-30,29440000,58880000,88320000
3069,41,$FESA4,2017-09-30,29440000,58880000,88320000
3069,41,$FESA4,2017-12-31,29440000,58880000,88320000
3069,41,$FESA4,2018-03-31,29440000,58880000,88320000
3069,41,$FESA4,2018-06-30,29440000,58880000,88320000
3069,41,$FESA4,2018-09-30,29440000,58880000,88320000
3069,41,$FESA4,2018-12-31,29440000,58880000,88320000
3069,41,$FESA4,2019-03-31,29440000,58880000,88320000
3069,41,$FESA4,2019-06-30,29440000,58880000,88320000
3069,41,$FESA4,2019-09-30,29440000,58880000,88320000
3069,41,$FESA4,2019-12-31,29440000,58880000,88320000
3069,41,$FESA4,2020-03-31,29440000,58880000,88320000
3069,41,$FESA4,2020-06-30,29440000,58880000,88320000
3069,41,$FESA4,2020-09-30,29440000,58880000,88320000
3077,42,$CEDO3,2010-12-31,2036899,1532160,3569059
3077,42,$CEDO3,2011-03-31,2036899,1532160,3569059
3077,42,$CEDO3,2011-06-30,5707104,4292896,10000000
3077,42,$CEDO3,2011-09-30,5707104,4292896,10000000
3077,42,$CEDO3,2011-12-31,5707104,4292896,10000000
3077,42,$CEDO3,2012-03-31,5707104,4292896,10000000
3077,42,$CEDO3,2012-06-30,5707104,4292896,10000000
3077,42,$CEDO3,2012-09-30,5707104,4292896,10000000
3077,42,$CEDO3,2012-12-31,5707104,4292896,10000000
3077,42,$CEDO3,2013-03-31,5707104,4292896,10000000
3077,42,$CEDO3,2013-06-30,5707104,4292896,10000000
3077,42,$CEDO3,2013-09-30,5707104,4292896,10000000
3077,42,$CEDO3,2013-12-31,5707104,4292896,10000000
3077,42,$CEDO3,2014-03-31,5707104,4292896,10000000
3077,42,$CEDO3,2014-06-30,5707104,4292896,10000000
3077,42,$CEDO3,2014-09-30,5707104,4292896,10000000
3077,42,$CEDO3,2014-12-31,5707104,4292896,10000000
3077,42,$CEDO3,2015-03-31,5707104,4292896,10000000
3077,42,$CEDO3,2015-06-30,5707104,4292896,10000000
3077,42,$CEDO3,2015-09-30,5707104,4292896,10000000
3077,42,$CEDO3,2015-12-31,5707104,4292896,10000000
3077,42,$CEDO3,2016-03-31,5707104,4292896,10000000
3077,42,$CEDO3,2016-06-30,5707104,4292896,10000000
3077,42,$CEDO3,2016-09-30,5707104,4292896,10000000
3077,42,$CEDO3,2016-12-31,5707104,4292896,10000000
3077,42,$CEDO3,2017-03-31,5707104,4292896,10000000
3077,42,$CEDO3,2017-06-30,5707104,4292896,10000000
3077,42,$CEDO3,2017-09-30,5707104,4292896,10000000
3077,42,$CEDO3,2017-12-31,5707104,4292896,10000000
3077,42,$CEDO3,2018-03-31,5707104,4292896,10000000
3077,42,$CEDO3,2018-06-30,5707104,4292896,10000000
3077,42,$CEDO3,2018-09-30,5707104,4292896,10000000
3077,42,$CEDO3,2018-12-31,5707104,4292896,10000000
3077,42,$CEDO3,2019-03-31,5707104,4292896,10000000
3077,42,$CEDO3,2019-06-30,5707104,4292896,10000000
3077,42,$CEDO3,2019-09-30,5707104,4292896,10000000
3077,42,$CEDO3,2019-12-31,5707104,4292896,10000000
3077,42,$CEDO3,2020-03-31,5707104,4292896,10000000
3077,42,$CEDO3,2020-06-30,5707104,4292896,10000000
3077,42,$CEDO3,2020-09-30,5707104,4292896,10000000
3077,43,$CEDO4,2010-12-31,2036899,1532160,3569059
3077,43,$CEDO4,2011-03-31,2036899,1532160,3569059
3077,43,$CEDO4,2011-06-30,5707104,4292896,10000000
3077,43,$CEDO4,2011-09-30,5707104,4292896,10000000
3077,43,$CEDO4,2011-12-31,5707104,4292896,10000000
3077,43,$CEDO4,2012-03-31,5707104,4292896,10000000
3077,43,$CEDO4,2012-06-30,5707104,4292896,10000000
3077,43,$CEDO4,2012-09-30,5707104,4292896,10000000
3077,43,$CEDO4,2012-12-31,5707104,4292896,10000000
3077,43,$CEDO4,2013-03-31,5707104,4292896,10000000
3077,43,$CEDO4,2013-06-30,5707104,4292896,10000000
3077,43,$CEDO4,2013-09-30,5707104,4292896,10000000
3077,43,$CEDO4,2013-12-31,5707104,4292896,10000000
3077,43,$CEDO4,2014-03-31,5707104,4292896,10000000
3077,43,$CEDO4,2014-06-30,5707104,4292896,10000000
3077,43,$CEDO4,2014-09-30,5707104,4292896,10000000
3077,43,$CEDO4,2014-12-31,5707104,4292896,10000000
3077,43,$CEDO4,2015-03-31,5707104,4292896,10000000
3077,43,$CEDO4,2015-06-30,5707104,4292896,10000000
3077,43,$CEDO4,2015-09-30,5707104,4292896,10000000
3077,43,$CEDO4,2015-12-31,5707104,4292896,10000000
3077,43,$CEDO4,2016-03-31,5707104,4292896,10000000
3077,43,$CEDO4,2016-06-30,5707104,4292896,10000000
3077,43,$CEDO4,2016-09-30,5707104,4292896,10000000
3077,43,$CEDO4,2016-12-31,5707104,4292896,10000000
3077,43,$CEDO4,2017-03-31,5707104,4292896,10000000
3077,43,$CEDO4,2017-06-30,5707104,4292896,10000000
3077,43,$CEDO4,2017-09-30,5707104,4292896,10000000
3077,43,$CEDO4,2017-12-31,5707104,4292896,10000000
3077,43,$CEDO4,2018-03-31,5707104,4292896,10000000
3077,43,$CEDO4,2018-06-30,5707104,4292896,10000000
3077,43,$CEDO4,2018-09-30,5707104,4292896,10000000
3077,43,$CEDO4,2018-12-31,5707104,4292896,10000000
3077,43,$CEDO4,2019-03-31,5707104,4292896,10000000
3077,43,$CEDO4,2019-06-30,5707104,4292896,10000000
3077,43,$CEDO4,2019-09-30,5707104,4292896,10000000
3077,43,$CEDO4,2019-12-31,5707104,4292896,10000000
3077,43,$CEDO4,2020-03-31,5707104,4292896,10000000
3077,43,$CEDO4,2020-06-30,5707104,4292896,10000000
3077,43,$CEDO4,2020-09-30,5707104,4292896,10000000
3115,44,$CSAB3,2010-12-31,3840,3840,7680
3115,44,$CSAB3,2011-03-31,3840,3840,7680
3115,44,$CSAB3,2011-06-30,3840,3840,7680
3115,44,$CSAB3,2011-09-30,3840,3840,7680
3115,44,$CSAB3,2011-12-31,3840,3840,7680
3115,44,$CSAB3,2012-03-31,3840,3840,7680
3115,44,$CSAB3,2012-06-30,3840,3840,7680
3115,44,$CSAB3,2012-09-30,3840,3840,7680
3115,44,$CSAB3,2012-12-31,3840,3840,7680
3115,44,$CSAB3,2013-03-31,3840,3840,7680
3115,44,$CSAB3,2013-06-30,3840,3840,7680
3115,44,$CSAB3,2013-09-30,3840,3840,7680
3115,44,$CSAB3,2013-12-31,3840,3840,7680
3115,44,$CSAB3,2014-03-31,3840,3840,7680
3115,44,$CSAB3,2014-06-30,3840,3840,7680
3115,44,$CSAB3,2014-09-30,3840,3840,7680
3115,44,$CSAB3,2014-12-31,3840,3840,7680
3115,44,$CSAB3,2015-03-31,3840,3840,7680
3115,44,$CSAB3,2015-06-30,3840,3840,7680
3115,44,$CSAB3,2015-09-30,3840,3840,7680
3115,44,$CSAB3,2015-12-31,3840,3840,7680
3115,44,$CSAB3,2016-03-31,3840,3840,7680
3115,44,$CSAB3,2016-06-30,3840,3840,7680
3115,44,$CSAB3,2016-09-30,3840,3840,7680
3115,44,$CSAB3,2016-12-31,3840,3840,7680
3115,44,$CSAB3,2017-03-31,3840,3840,7680
3115,44,$CSAB3,2017-06-30,3840,3840,7680
3115,44,$CSAB3,2017-09-30,3840,3840,7680
3115,44,$CSAB3,2017-12-31,3840,3840,7680
3115,44,$CSAB3,2018-03-31,3840,3840,7680
3115,44,$CSAB3,2018-06-30,3840,3840,7680
3115,44,$CSAB3,2018-09-30,3840,3840,7680
3115,44,$CSAB3,2018-12-31,3840,3840,7680
3115,44,$CSAB3,2019-03-31,3840,3840,7680
3115,44,$CSAB3,2019-06-30,3840,3840,7680
3115,44,$CSAB3,2019-09-30,3840,3840,7680
3115,44,$CSAB3,2019-12-31,3840,3840,7680
3115,44,$CSAB3,2020-03-31,3840,3840,7680
3115,44,$CSAB3,2020-06-30,3840,3840,7680
3115,44,$CSAB3,2020-09-30,3840,3840,7680
3115,45,$CSAB4,2010-12-31,3840,3840,7680
3115,45,$CSAB4,2011-03-31,3840,3840,7680
3115,45,$CSAB4,2011-06-30,3840,3840,7680
3115,45,$CSAB4,2011-09-30,3840,3840,7680
3115,45,$CSAB4,2011-12-31,3840,3840,7680
3115,45,$CSAB4,2012-03-31,3840,3840,7680
3115,45,$CSAB4,2012-06-30,3840,3840,7680
3115,45,$CSAB4,2012-09-30,3840,3840,7680
3115,45,$CSAB4,2012-12-31,3840,3840,7680
3115,45,$CSAB4,2013-03-31,3840,3840,7680
3115,45,$CSAB4,2013-06-30,3840,3840,7680
3115,45,$CSAB4,2013-09-30,3840,3840,7680
3115,45,$CSAB4,2013-12-31,3840,3840,7680
3115,45,$CSAB4,2014-03-31,3840,3840,7680
3115,45,$CSAB4,2014-06-30,3840,3840,7680
3115,45,$CSAB4,2014-09-30,3840,3840,7680
3115,45,$CSAB4,2014-12-31,3840,3840,7680
3115,45,$CSAB4,2015-03-31,3840,3840,7680
3115,45,$CSAB4,2015-06-30,3840,3840,7680
3115,45,$CSAB4,2015-09-30,3840,3840,7680
3115,45,$CSAB4,2015-12-31,3840,3840,7680
3115,45,$CSAB4,2016-03-31,3840,3840,7680
3115,45,$CSAB4,2016-06-30,3840,3840,7680
3115,45,$CSAB4,2016-09-30,3840,3840,7680
3115,45,$CSAB4,2016-12-31,3840,3840,7680
3115,45,$CSAB4,2017-03-31,3840,3840,7680
3115,45,$CSAB4,2017-06-30,3840,3840,7680
3115,45,$CSAB4,2017-09-30,3840,3840,7680
3115,45,$CSAB4,2017-12-31,3840,3840,7680
3115,45,$CSAB4,2018-03-31,3840,3840,7680
3115,45,$CSAB4,2018-06-30,3840,3840,7680
3115,45,$CSAB4,2018-09-30,3840,3840,7680
3115,45,$CSAB4,2018-12-31,3840,3840,7680
3115,45,$CSAB4,2019-03-31,3840,3840,7680
3115,45,$CSAB4,2019-06-30,3840,3840,7680
3115,45,$CSAB4,2019-09-30,3840,3840,7680
3115,45,$CSAB4,2019-12-31,3840,3840,7680
3115,45,$CSAB4,2020-03-31,3840,3840,7680
3115,45,$CSAB4,2020-06-30,3840,3840,7680
3115,45,$CSAB4,2020-09-30,3840,3840,7680
3158,53,$CTNM3,2010-12-31,43532,73143,116675
3158,53,$CTNM3,2011-03-31,43532,73143,116675
3158,53,$CTNM3,2011-06-30,43532,73143,116675
3158,53,$CTNM3,2011-09-30,43532,73143,116675
3158,53,$CTNM3,2011-12-31,43532,73143,116675
3158,53,$CTNM3,2012-03-31,43532,73143,116675
3158,53,$CTNM3,2012-06-30,43532,73143,116675
3158,53,$CTNM3,2012-09-30,43532,73143,116675
3158,53,$CTNM3,2012-12-31,43532,73143,116675
3158,53,$CTNM3,2013-03-31,55652,67017,122669
3158,53,$CTNM3,2013-06-30,55651,66895,122546
3158,53,$CTNM3,2013-09-30,55651,66895,122546
3158,53,$CTNM3,2013-12-31,55651,66895,122546
3158,53,$CTNM3,2014-03-31,55651,66895,122546
3158,53,$CTNM3,2014-06-30,55651,66895,122546
3158,53,$CTNM3,2014-09-30,55651,66895,122546
3158,53,$CTNM3,2014-12-31,55651,66895,122546
3158,53,$CTNM3,2015-03-31,55651,66895,122546
3158,53,$CTNM3,2015-06-30,55651,66895,122546
3158,53,$CTNM3,2015-09-30,13913,16723,30636
3158,53,$CTNM3,2015-12-31,13913,16723,30636
3158,53,$CTNM3,2016-03-31,13912,16724,30636
3158,53,$CTNM3,2016-06-30,13912,16724,30636
3158,53,$CTNM3,2016-09-30,13912,16724,30636
3158,53,$CTNM3,2016-12-31,13913,16723,30636
3158,53,$CTNM3,2017-03-31,13912,16724,30636
3158,53,$CTNM3,2017-06-30,13912,16724,30636
3158,53,$CTNM3,2017-09-30,13912,16724,30636
3158,53,$CTNM3,2017-12-31,13913,16723,30636
3158,53,$CTNM3,2018-03-31,13912,16724,30636
3158,53,$CTNM3,2018-06-30,13912,16724,30636
3158,53,$CTNM3,2018-09-30,13912,16724,30636
3158,53,$CTNM3,2018-12-31,13913,16723,30636
3158,53,$CTNM3,2019-03-31,13913,16723,30636
3158,53,$CTNM3,2019-06-30,13913,16723,30636
3158,53,$CTNM3,2019-09-30,13913,16723,30636
3158,53,$CTNM3,2019-12-31,13913,16723,30636
3158,53,$CTNM3,2020-03-31,13913,16723,30636
3158,53,$CTNM3,2020-06-30,13913,16723,30636
3158,53,$CTNM3,2020-09-30,13913,16723,30636
3158,54,$CTNM4,2010-12-31,43532,73143,116675
3158,54,$CTNM4,2011-03-31,43532,73143,116675
3158,54,$CTNM4,2011-06-30,43532,73143,116675
3158,54,$CTNM4,2011-09-30,43532,73143,116675
3158,54,$CTNM4,2011-12-31,43532,73143,116675
3158,54,$CTNM4,2012-03-31,43532,73143,116675
3158,54,$CTNM4,2012-06-30,43532,73143,116675
3158,54,$CTNM4,2012-09-30,43532,73143,116675
3158,54,$CTNM4,2012-12-31,43532,73143,116675
3158,54,$CTNM4,2013-03-31,55652,67017,122669
3158,54,$CTNM4,2013-06-30,55651,66895,122546
3158,54,$CTNM4,2013-09-30,55651,66895,122546
3158,54,$CTNM4,2013-12-31,55651,66895,122546
3158,54,$CTNM4,2014-03-31,55651,66895,122546
3158,54,$CTNM4,2014-06-30,55651,66895,122546
3158,54,$CTNM4,2014-09-30,55651,66895,122546
3158,54,$CTNM4,2014-12-31,55651,66895,122546
3158,54,$CTNM4,2015-03-31,55651,66895,122546
3158,54,$CTNM4,2015-06-30,55651,66895,122546
3158,54,$CTNM4,2015-09-30,13913,16723,30636
3158,54,$CTNM4,2015-12-31,13913,16723,30636
3158,54,$CTNM4,2016-03-31,13912,16724,30636
3158,54,$CTNM4,2016-06-30,13912,16724,30636
3158,54,$CTNM4,2016-09-30,13912,16724,30636
3158,54,$CTNM4,2016-12-31,13913,16723,30636
3158,54,$CTNM4,2017-03-31,13912,16724,30636
3158,54,$CTNM4,2017-06-30,13912,16724,30636
3158,54,$CTNM4,2017-09-30,13912,16724,30636
3158,54,$CTNM4,2017-12-31,13913,16723,30636
3158,54,$CTNM4,2018-03-31,13912,16724,30636
3158,54,$CTNM4,2018-06-30,13912,16724,30636
3158,54,$CTNM4,2018-09-30,13912,16724,30636
3158,54,$CTNM4,2018-12-31,13913,16723,30636
3158,54,$CTNM4,2019-03-31,13913,16723,30636
3158,54,$CTNM4,2019-06-30,13913,16723,30636
3158,54,$CTNM4,2019-09-30,13913,16723,30636
3158,54,$CTNM4,2019-12-31,13913,16723,30636
3158,54,$CTNM4,2020-03-31,13913,16723,30636
3158,54,$CTNM4,2020-06-30,13913,16723,30636
3158,54,$CTNM4,2020-09-30,13913,16723,30636
3190,57,$REDE3,2010-12-31,221158,100917,322075
3190,57,$REDE3,2011-03-31,221158,100917,322075
3190,57,$REDE3,2011-06-30,221158,100917,322075
3190,57,$REDE3,2011-09-30,294110,132482,426592
3190,57,$REDE3,2011-12-31,294110,132482,426592
3190,57,$REDE3,2012-03-31,294110,132482,426592
3190,57,$REDE3,2012-06-30,294110,132482,426592
3190,57,$REDE3,2012-09-30,294110,132482,426592
3190,57,$REDE3,2012-12-31,294110,132482,426592
3190,57,$REDE3,2013-03-31,294110,132482,426592
3190,57,$REDE3,2013-06-30,294110,132482,426592
3190,57,$REDE3,2013-09-30,294110,132482,426592
3190,57,$REDE3,2013-12-31,294110,132482,426592
3190,57,$REDE3,2014-03-31,294110,132482,426592
3190,57,$REDE3,2014-06-30,294110,132482,426592
3190,57,$REDE3,2014-09-30,1182320,532575,1714895
3190,57,$REDE3,2014-12-31,1182320,532575,1714895
3190,57,$REDE3,2015-03-31,1182320,532575,1714895
3190,57,$REDE3,2015-06-30,1182320,532575,1714895
3190,57,$REDE3,2015-09-30,1182320,532575,1714895
3190,57,$REDE3,2015-12-31,1182320,532575,1714895
3190,57,$REDE3,2016-03-31,1182320,532575,1714895
3190,57,$REDE3,2016-06-30,1182320,532575,1714895
3190,57,$REDE3,2016-09-30,1182320203,532575323,1714895526
3190,57,$REDE3,2016-12-31,1418784,639091,2057875
3190,57,$REDE3,2017-03-31,1418784243,639090387,2057874630
3190,57,$REDE3,2017-06-30,2057874630,0,2057874630
3190,57,$REDE3,2017-09-30,2057874630,0,2057874630
3190,57,$REDE3,2017-12-31,2057875,0,2057875
3190,57,$REDE3,2018-03-31,2057874630,0,2057874630
3190,57,$REDE3,2018-06-30,2057874630,0,2057874630
3190,57,$REDE3,2018-09-30,2057874630,0,2057874630
3190,57,$REDE3,2018-12-31,2057874630,0,2057874630
3190,57,$REDE3,2019-03-31,2057874630,0,2057874630
3190,57,$REDE3,2019-06-30,2057874630,0,2057874630
3190,57,$REDE3,2019-09-30,2057874630,0,2057874630
3190,57,$REDE3,2019-12-31,2057874630,0,2057874630
3190,57,$REDE3,2020-03-31,2057874630,0,2057874630
3190,57,$REDE3,2020-06-30,2110323374,0,2110323374
3190,57,$REDE3,2020-09-30,2110323374,0,2110323374
3204,428,$eeel3,2010-12-31,380669270,6560558,387229828
3204,428,$eeel3,2011-03-31,380669270,6560558,387229828
3204,428,$eeel3,2011-06-30,380669270,6560558,387229828
3204,428,$eeel3,2011-09-30,380669270,6560558,387229828
3204,428,$eeel3,2011-12-31,380669270,6560558,387229828
3204,428,$eeel3,2012-03-31,380669270,6560558,387229828
3204,428,$eeel3,2012-06-30,380669270,6560558,387229828
3204,428,$eeel3,2012-09-30,380669270,6560558,387229828
3204,428,$eeel3,2012-12-31,380669270,6560558,387229828
3204,428,$eeel3,2013-03-31,380669270,6560558,387229828
3204,428,$eeel3,2013-06-30,380669270,6560558,387229828
3204,428,$eeel3,2013-09-30,380669270,6560558,387229828
3204,428,$eeel3,2013-12-31,380669270,6560558,387229828
3204,428,$eeel3,2014-03-31,380669270,6560558,387229828
3204,428,$eeel3,2014-06-30,380669270,6560558,387229828
3204,428,$eeel3,2014-09-30,380669270,6560558,387229828
3204,428,$eeel3,2014-12-31,380669270,6560558,387229828
3204,428,$eeel3,2015-03-31,380669270,6560558,387229828
3204,428,$eeel3,2015-06-30,380669270,6560558,387229828
3204,428,$eeel3,2015-09-30,380669270,6560558,387229828
3204,428,$eeel3,2015-12-31,380669270,6560558,387229828
3204,428,$eeel3,2016-03-31,380669270,6560558,387229828
3204,428,$eeel3,2016-06-30,9516732,164014,9680746
3204,428,$eeel3,2016-09-30,9516732,164014,9680746
3204,428,$eeel3,2016-12-31,9516732,164014,9680746
3204,428,$eeel3,2017-03-31,9516732,164014,9680746
3204,428,$eeel3,2017-06-30,9516732,164014,9680746
3204,428,$eeel3,2017-09-30,9516732,164014,9680746
3204,428,$eeel3,2017-12-31,9516732,164014,9680746
3204,428,$eeel3,2018-03-31,9516732,164014,9680746
3204,428,$eeel3,2018-06-30,9516732,164014,9680746
3204,428,$eeel3,2018-09-30,9516732,164014,9680746
3204,428,$eeel3,2018-12-31,9516732,164014,9680746
3204,428,$eeel3,2019-03-31,9516732,164014,9680746
3204,428,$eeel3,2019-06-30,9516732,164014,9680746
3204,428,$eeel3,2019-09-30,9516732,164014,9680746
3204,428,$eeel3,2019-12-31,9516732,164014,9680746
3204,428,$eeel3,2020-03-31,9516732,164014,9680746
3204,428,$eeel3,2020-06-30,9516732,164014,9680746
3204,428,$eeel3,2020-09-30,9507970,153287,9661257
3204,429,$eeel4,2010-12-31,380669270,6560558,387229828
3204,429,$eeel4,2011-03-31,380669270,6560558,387229828
3204,429,$eeel4,2011-06-30,380669270,6560558,387229828
3204,429,$eeel4,2011-09-30,380669270,6560558,387229828
3204,429,$eeel4,2011-12-31,380669270,6560558,387229828
3204,429,$eeel4,2012-03-31,380669270,6560558,387229828
3204,429,$eeel4,2012-06-30,380669270,6560558,387229828
3204,429,$eeel4,2012-09-30,380669270,6560558,387229828
3204,429,$eeel4,2012-12-31,380669270,6560558,387229828
3204,429,$eeel4,2013-03-31,380669270,6560558,387229828
3204,429,$eeel4,2013-06-30,380669270,6560558,387229828
3204,429,$eeel4,2013-09-30,380669270,6560558,387229828
3204,429,$eeel4,2013-12-31,380669270,6560558,387229828
3204,429,$eeel4,2014-03-31,380669270,6560558,387229828
3204,429,$eeel4,2014-06-30,380669270,6560558,387229828
3204,429,$eeel4,2014-09-30,380669270,6560558,387229828
3204,429,$eeel4,2014-12-31,380669270,6560558,387229828
3204,429,$eeel4,2015-03-31,380669270,6560558,387229828
3204,429,$eeel4,2015-06-30,380669270,6560558,387229828
3204,429,$eeel4,2015-09-30,380669270,6560558,387229828
3204,429,$eeel4,2015-12-31,380669270,6560558,387229828
3204,429,$eeel4,2016-03-31,380669270,6560558,387229828
3204,429,$eeel4,2016-06-30,9516732,164014,9680746
3204,429,$eeel4,2016-09-30,9516732,164014,9680746
3204,429,$eeel4,2016-12-31,9516732,164014,9680746
3204,429,$eeel4,2017-03-31,9516732,164014,9680746
3204,429,$eeel4,2017-06-30,9516732,164014,9680746
3204,429,$eeel4,2017-09-30,9516732,164014,9680746
3204,429,$eeel4,2017-12-31,9516732,164014,9680746
3204,429,$eeel4,2018-03-31,9516732,164014,9680746
3204,429,$eeel4,2018-06-30,9516732,164014,9680746
3204,429,$eeel4,2018-09-30,9516732,164014,9680746
3204,429,$eeel4,2018-12-31,9516732,164014,9680746
3204,429,$eeel4,2019-03-31,9516732,164014,9680746
3204,429,$eeel4,2019-06-30,9516732,164014,9680746
3204,429,$eeel4,2019-09-30,9516732,164014,9680746
3204,429,$eeel4,2019-12-31,9516732,164014,9680746
3204,429,$eeel4,2020-03-31,9516732,164014,9680746
3204,429,$eeel4,2020-06-30,9516732,164014,9680746
3204,429,$eeel4,2020-09-30,9507970,153287,9661257
3298,46,$HBTS5,2010-12-31,3153,5981,9134
3298,46,$HBTS5,2011-03-31,3153,5981,9134
3298,46,$HBTS5,2011-06-30,3153,5981,9134
3298,46,$HBTS5,2011-09-30,3153,5981,9134
3298,46,$HBTS5,2011-12-31,3152764,5980923,9133687
3298,46,$HBTS5,2012-03-31,3152764,5980923,9133687
3298,46,$HBTS5,2012-06-30,3152764,5980923,9133687
3298,46,$HBTS5,2012-09-30,3152764,5980923,9133687
3298,46,$HBTS5,2012-12-31,3152764,5980923,9133687
3298,46,$HBTS5,2013-03-31,3152764,5980923,9133687
3298,46,$HBTS5,2013-06-30,3152764,5980923,9133687
3298,46,$HBTS5,2013-09-30,3152764,5980923,9133687
3298,46,$HBTS5,2013-12-31,3152764,5980923,9133687
3298,46,$HBTS5,2014-03-31,3152764,5980923,9133687
3298,46,$HBTS5,2014-06-30,3152764,5980923,9133687
3298,46,$HBTS5,2014-09-30,3152764,5980923,9133687
3298,46,$HBTS5,2014-12-31,3152764,5980923,9133687
3298,46,$HBTS5,2015-03-31,3152764,5980923,9133687
3298,46,$HBTS5,2015-06-30,3152764,5980923,9133687
3298,46,$HBTS5,2015-09-30,3152764,5980923,9133687
3298,46,$HBTS5,2015-12-31,3152764,5980923,9133687
3298,46,$HBTS5,2016-03-31,3152764,5980923,9133687
3298,46,$HBTS5,2016-06-30,3152764,5980923,9133687
3298,46,$HBTS5,2016-09-30,3152764,5980923,9133687
3298,46,$HBTS5,2016-12-31,3152764,5980923,9133687
3298,46,$HBTS5,2017-03-31,3152764,5980923,9133687
3298,46,$HBTS5,2017-06-30,3152764,5980923,9133687
3298,46,$HBTS5,2017-09-30,3152764,5980923,9133687
3298,46,$HBTS5,2017-12-31,3152764,5980923,9133687
3298,46,$HBTS5,2018-03-31,3152764,5980923,9133687
3298,46,$HBTS5,2018-06-30,3152764,5980923,9133687
3298,46,$HBTS5,2018-09-30,3152764,5980923,9133687
3298,46,$HBTS5,2018-12-31,3152764,5980923,9133687
3298,46,$HBTS5,2019-03-31,3152764,5980923,9133687
3298,46,$HBTS5,2019-06-30,3152764,5980923,9133687
3298,46,$HBTS5,2019-09-30,3152764,5980923,9133687
3298,46,$HBTS5,2019-12-31,3152764,5980923,9133687
3298,46,$HBTS5,2020-03-31,3152764,5980923,9133687
3298,46,$HBTS5,2020-06-30,3152764,5980923,9133687
3298,46,$HBTS5,2020-09-30,3152764,5980923,9133687
3549,55,$SC303,2010-12-31,480,480,960
3549,55,$SC303,2011-03-31,480,480,960
3549,55,$SC303,2011-06-30,480,480,960
3549,55,$SC303,2011-09-30,480,480,960
3549,55,$SC303,2011-12-31,480,480,960
3549,55,$SC303,2012-03-31,480,480,960
3549,55,$SC303,2012-06-30,480,480,960
3549,55,$SC303,2012-09-30,480,480,960
3549,55,$SC303,2012-12-31,480,480,960
3549,55,$SC303,2013-03-31,480,480,960
3549,55,$SC303,2013-06-30,480,480,960
3549,55,$SC303,2013-09-30,480,480,960
3549,55,$SC303,2013-12-31,480,480,960
3549,55,$SC303,2014-03-31,480,480,960
3549,55,$SC303,2014-06-30,480,480,960
3549,55,$SC303,2014-09-30,480,480,960
3549,55,$SC303,2014-12-31,480,480,960
3549,55,$SC303,2015-03-31,480,480,960
3549,55,$SC303,2015-06-30,480,480,960
3549,55,$SC303,2015-09-30,480,480,960
3549,55,$SC303,2015-12-31,480,480,960
3549,55,$SC303,2016-03-31,480,480,960
3549,55,$SC303,2016-06-30,480,480,960
3549,55,$SC303,2016-09-30,480,480,960
3549,55,$SC303,2016-12-31,480,480,960
3549,55,$SC303,2017-03-31,480,480,960
3549,55,$SC303,2017-06-30,480,480,960
3549,55,$SC303,2017-09-30,480,480,960
3549,55,$SC303,2017-12-31,480,480,960
3549,55,$SC303,2018-03-31,480,480,960
3549,55,$SC303,2018-06-30,480,480,960
3549,55,$SC303,2018-09-30,480,480,960
3549,55,$SC303,2018-12-31,480,480,960
3549,55,$SC303,2019-03-31,480,480,960
3549,55,$SC303,2019-06-30,480,480,960
3549,55,$SC303,2019-09-30,480,480,960
3549,55,$SC303,2019-12-31,480,480,960
3549,55,$SC303,2020-03-31,480,480,960
3549,55,$SC303,2020-06-30,480,480,960
3549,55,$SC303,2020-09-30,480,480,960
3549,56,$SCL04,2010-12-31,480,480,960
3549,56,$SCL04,2011-03-31,480,480,960
3549,56,$SCL04,2011-06-30,480,480,960
3549,56,$SCL04,2011-09-30,480,480,960
3549,56,$SCL04,2011-12-31,480,480,960
3549,56,$SCL04,2012-03-31,480,480,960
3549,56,$SCL04,2012-06-30,480,480,960
3549,56,$SCL04,2012-09-30,480,480,960
3549,56,$SCL04,2012-12-31,480,480,960
3549,56,$SCL04,2013-03-31,480,480,960
3549,56,$SCL04,2013-06-30,480,480,960
3549,56,$SCL04,2013-09-30,480,480,960
3549,56,$SCL04,2013-12-31,480,480,960
3549,56,$SCL04,2014-03-31,480,480,960
3549,56,$SCL04,2014-06-30,480,480,960
3549,56,$SCL04,2014-09-30,480,480,960
3549,56,$SCL04,2014-12-31,480,480,960
3549,56,$SCL04,2015-03-31,480,480,960
3549,56,$SCL04,2015-06-30,480,480,960
3549,56,$SCL04,2015-09-30,480,480,960
3549,56,$SCL04,2015-12-31,480,480,960
3549,56,$SCL04,2016-03-31,480,480,960
3549,56,$SCL04,2016-06-30,480,480,960
3549,56,$SCL04,2016-09-30,480,480,960
3549,56,$SCL04,2016-12-31,480,480,960
3549,56,$SCL04,2017-03-31,480,480,960
3549,56,$SCL04,2017-06-30,480,480,960
3549,56,$SCL04,2017-09-30,480,480,960
3549,56,$SCL04,2017-12-31,480,480,960
3549,56,$SCL04,2018-03-31,480,480,960
3549,56,$SCL04,2018-06-30,480,480,960
3549,56,$SCL04,2018-09-30,480,480,960
3549,56,$SCL04,2018-12-31,480,480,960
3549,56,$SCL04,2019-03-31,480,480,960
3549,56,$SCL04,2019-06-30,480,480,960
3549,56,$SCL04,2019-09-30,480,480,960
3549,56,$SCL04,2019-12-31,480,480,960
3549,56,$SCL04,2020-03-31,480,480,960
3549,56,$SCL04,2020-06-30,480,480,960
3549,56,$SCL04,2020-09-30,480,480,960
3891,49,$CNOR4,2010-12-31,59439,46327,105766
3891,49,$CNOR4,2011-03-31,59439,46327,105766
3891,49,$CNOR4,2011-06-30,59439,46327,105766
3891,49,$CNOR4,2011-09-30,59439,46327,105766
3891,49,$CNOR4,2011-12-31,59439,46327,105766
3891,49,$CNOR4,2012-03-31,59439,46327,105766
3891,49,$CNOR4,2012-06-30,59439,46327,105766
3891,49,$CNOR4,2012-09-30,59439,46327,105766
3891,49,$CNOR4,2012-12-31,59439,46327,105766
3891,49,$CNOR4,2013-03-31,59439,46327,105766
3891,49,$CNOR4,2013-06-30,59439,46327,105766
3891,49,$CNOR4,2013-09-30,59439,46327,105766
3891,49,$CNOR4,2013-12-31,59439,46327,105766
3891,49,$CNOR4,2014-03-31,59439,46327,105766
3891,49,$CNOR4,2014-06-30,59439,46327,105766
3891,49,$CNOR4,2014-09-30,59439,46327,105766
3891,49,$CNOR4,2014-12-31,59439,46327,105766
3891,49,$CNOR4,2015-03-31,59439,46327,105766
3891,49,$CNOR4,2015-06-30,59439,46327,105766
3891,49,$CNOR4,2015-09-30,59439,46327,105766
3891,49,$CNOR4,2015-12-31,59043,44472,103515
3891,49,$CNOR4,2016-03-31,59043,44472,103515
3891,49,$CNOR4,2016-06-30,59042,44472,103514
3891,49,$CNOR4,2016-09-30,59042969,44471587,103514556
3891,49,$CNOR4,2016-12-31,59042969,44471587,103514556
3891,49,$CNOR4,2017-03-31,58783569,44319187,103102756
3891,49,$CNOR4,2017-06-30,58783569,44319187,103102756
3891,49,$CNOR4,2017-09-30,58783569,44319187,103102756
3891,49,$CNOR4,2017-12-31,58742969,44233987,102976956
3891,49,$CNOR4,2018-03-31,58736269,44206287,102942556
3891,49,$CNOR4,2018-06-30,58736269,44206287,102942556
3891,49,$CNOR4,2018-09-30,58736269,44206287,102942556
3891,49,$CNOR4,2018-12-31,58736269,44206287,102942556
3891,49,$CNOR4,2019-03-31,58736269,44206287,102942556
3891,49,$CNOR4,2019-06-30,58736269,44206287,102942556
3891,49,$CNOR4,2019-09-30,58736269,44206287,102942556
3891,49,$CNOR4,2019-12-31,58736269,44206287,102942556
3891,49,$CNOR4,2020-03-31,58736269,44206287,102942556
3891,49,$CNOR4,2020-06-30,58736269,44206287,102942556
3891,49,$CNOR4,2020-09-30,58736269,44206287,102942556
3891,50,$NPR1,2010-12-31,59439,46327,105766
3891,50,$NPR1,2011-03-31,59439,46327,105766
3891,50,$NPR1,2011-06-30,59439,46327,105766
3891,50,$NPR1,2011-09-30,59439,46327,105766
3891,50,$NPR1,2011-12-31,59439,46327,105766
3891,50,$NPR1,2012-03-31,59439,46327,105766
3891,50,$NPR1,2012-06-30,59439,46327,105766
3891,50,$NPR1,2012-09-30,59439,46327,105766
3891,50,$NPR1,2012-12-31,59439,46327,105766
3891,50,$NPR1,2013-03-31,59439,46327,105766
3891,50,$NPR1,2013-06-30,59439,46327,105766
3891,50,$NPR1,2013-09-30,59439,46327,105766
3891,50,$NPR1,2013-12-31,59439,46327,105766
3891,50,$NPR1,2014-03-31,59439,46327,105766
3891,50,$NPR1,2014-06-30,59439,46327,105766
3891,50,$NPR1,2014-09-30,59439,46327,105766
3891,50,$NPR1,2014-12-31,59439,46327,105766
3891,50,$NPR1,2015-03-31,59439,46327,105766
3891,50,$NPR1,2015-06-30,59439,46327,105766
3891,50,$NPR1,2015-09-30,59439,46327,105766
3891,50,$NPR1,2015-12-31,59043,44472,103515
3891,50,$NPR1,2016-03-31,59043,44472,103515
3891,50,$NPR1,2016-06-30,59042,44472,103514
3891,50,$NPR1,2016-09-30,59042969,44471587,103514556
3891,50,$NPR1,2016-12-31,59042969,44471587,103514556
3891,50,$NPR1,2017-03-31,58783569,44319187,103102756
3891,50,$NPR1,2017-06-30,58783569,44319187,103102756
3891,50,$NPR1,2017-09-30,58783569,44319187,103102756
3891,50,$NPR1,2017-12-31,58742969,44233987,102976956
3891,50,$NPR1,2018-03-31,58736269,44206287,102942556
3891,50,$NPR1,2018-06-30,58736269,44206287,102942556
3891,50,$NPR1,2018-09-30,58736269,44206287,102942556
3891,50,$NPR1,2018-12-31,58736269,44206287,102942556
3891,50,$NPR1,2019-03-31,58736269,44206287,102942556
3891,50,$NPR1,2019-06-30,58736269,44206287,102942556
3891,50,$NPR1,2019-09-30,58736269,44206287,102942556
3891,50,$NPR1,2019-12-31,58736269,44206287,102942556
3891,50,$NPR1,2020-03-31,58736269,44206287,102942556
3891,50,$NPR1,2020-06-30,58736269,44206287,102942556
3891,50,$NPR1,2020-09-30,58736269,44206287,102942556
3891,51,$CRIV3,2010-12-31,59439,46327,105766
3891,51,$CRIV3,2011-03-31,59439,46327,105766
3891,51,$CRIV3,2011-06-30,59439,46327,105766
3891,51,$CRIV3,2011-09-30,59439,46327,105766
3891,51,$CRIV3,2011-12-31,59439,46327,105766
3891,51,$CRIV3,2012-03-31,59439,46327,105766
3891,51,$CRIV3,2012-06-30,59439,46327,105766
3891,51,$CRIV3,2012-09-30,59439,46327,105766
3891,51,$CRIV3,2012-12-31,59439,46327,105766
3891,51,$CRIV3,2013-03-31,59439,46327,105766
3891,51,$CRIV3,2013-06-30,59439,46327,105766
3891,51,$CRIV3,2013-09-30,59439,46327,105766
3891,51,$CRIV3,2013-12-31,59439,46327,105766
3891,51,$CRIV3,2014-03-31,59439,46327,105766
3891,51,$CRIV3,2014-06-30,59439,46327,105766
3891,51,$CRIV3,2014-09-30,59439,46327,105766
3891,51,$CRIV3,2014-12-31,59439,46327,105766
3891,51,$CRIV3,2015-03-31,59439,46327,105766
3891,51,$CRIV3,2015-06-30,59439,46327,105766
3891,51,$CRIV3,2015-09-30,59439,46327,105766
3891,51,$CRIV3,2015-12-31,59043,44472,103515
3891,51,$CRIV3,2016-03-31,59043,44472,103515
3891,51,$CRIV3,2016-06-30,59042,44472,103514
3891,51,$CRIV3,2016-09-30,59042969,44471587,103514556
3891,51,$CRIV3,2016-12-31,59042969,44471587,103514556
3891,51,$CRIV3,2017-03-31,58783569,44319187,103102756
3891,51,$CRIV3,2017-06-30,58783569,44319187,103102756
3891,51,$CRIV3,2017-09-30,58783569,44319187,103102756
3891,51,$CRIV3,2017-12-31,58742969,44233987,102976956
3891,51,$CRIV3,2018-03-31,58736269,44206287,102942556
3891,51,$CRIV3,2018-06-30,58736269,44206287,102942556
3891,51,$CRIV3,2018-09-30,58736269,44206287,102942556
3891,51,$CRIV3,2018-12-31,58736269,44206287,102942556
3891,51,$CRIV3,2019-03-31,58736269,44206287,102942556
3891,51,$CRIV3,2019-06-30,58736269,44206287,102942556
3891,51,$CRIV3,2019-09-30,58736269,44206287,102942556
3891,51,$CRIV3,2019-12-31,58736269,44206287,102942556
3891,51,$CRIV3,2020-03-31,58736269,44206287,102942556
3891,51,$CRIV3,2020-06-30,58736269,44206287,102942556
3891,51,$CRIV3,2020-09-30,58736269,44206287,102942556
3891,52,$CRIV4,2010-12-31,59439,46327,105766
3891,52,$CRIV4,2011-03-31,59439,46327,105766
3891,52,$CRIV4,2011-06-30,59439,46327,105766
3891,52,$CRIV4,2011-09-30,59439,46327,105766
3891,52,$CRIV4,2011-12-31,59439,46327,105766
3891,52,$CRIV4,2012-03-31,59439,46327,105766
3891,52,$CRIV4,2012-06-30,59439,46327,105766
3891,52,$CRIV4,2012-09-30,59439,46327,105766
3891,52,$CRIV4,2012-12-31,59439,46327,105766
3891,52,$CRIV4,2013-03-31,59439,46327,105766
3891,52,$CRIV4,2013-06-30,59439,46327,105766
3891,52,$CRIV4,2013-09-30,59439,46327,105766
3891,52,$CRIV4,2013-12-31,59439,46327,105766
3891,52,$CRIV4,2014-03-31,59439,46327,105766
3891,52,$CRIV4,2014-06-30,59439,46327,105766
3891,52,$CRIV4,2014-09-30,59439,46327,105766
3891,52,$CRIV4,2014-12-31,59439,46327,105766
3891,52,$CRIV4,2015-03-31,59439,46327,105766
3891,52,$CRIV4,2015-06-30,59439,46327,105766
3891,52,$CRIV4,2015-09-30,59439,46327,105766
3891,52,$CRIV4,2015-12-31,59043,44472,103515
3891,52,$CRIV4,2016-03-31,59043,44472,103515
3891,52,$CRIV4,2016-06-30,59042,44472,103514
3891,52,$CRIV4,2016-09-30,59042969,44471587,103514556
3891,52,$CRIV4,2016-12-31,59042969,44471587,103514556
3891,52,$CRIV4,2017-03-31,58783569,44319187,103102756
3891,52,$CRIV4,2017-06-30,58783569,44319187,103102756
3891,52,$CRIV4,2017-09-30,58783569,44319187,103102756
3891,52,$CRIV4,2017-12-31,58742969,44233987,102976956
3891,52,$CRIV4,2018-03-31,58736269,44206287,102942556
3891,52,$CRIV4,2018-06-30,58736269,44206287,102942556
3891,52,$CRIV4,2018-09-30,58736269,44206287,102942556
3891,52,$CRIV4,2018-12-31,58736269,44206287,102942556
3891,52,$CRIV4,2019-03-31,58736269,44206287,102942556
3891,52,$CRIV4,2019-06-30,58736269,44206287,102942556
3891,52,$CRIV4,2019-09-30,58736269,44206287,102942556
3891,52,$CRIV4,2019-12-31,58736269,44206287,102942556
3891,52,$CRIV4,2020-03-31,58736269,44206287,102942556
3891,52,$CRIV4,2020-06-30,58736269,44206287,102942556
3891,52,$CRIV4,2020-09-30,58736269,44206287,102942556
3980,61,$GGBR3,2010-12-31,505601,1011201,1516802
3980,61,$GGBR3,2011-03-31,505600573,1011201145,1516801718
3980,61,$GGBR3,2011-06-30,573627483,1146031245,1719658728
3980,61,$GGBR3,2011-09-30,573627483,1146031245,1719658728
3980,61,$GGBR3,2011-12-31,573628,1146031,1719659
3980,61,$GGBR3,2012-03-31,573627483,1146031245,1719658728
3980,61,$GGBR3,2012-06-30,573627483,1146031245,1719658728
3980,61,$GGBR3,2012-09-30,573627483,1146031245,1719658728
3980,61,$GGBR3,2012-12-31,573627483,1146031245,1719658728
3980,61,$GGBR3,2013-03-31,573627483,1146031245,1719658728
3980,61,$GGBR3,2013-06-30,573627483,1146031245,1719658728
3980,61,$GGBR3,2013-09-30,573627483,1146031245,1719658728
3980,61,$GGBR3,2013-12-31,573627483,1146031245,1719658728
3980,61,$GGBR3,2014-03-31,573627483,1146031245,1719658728
3980,61,$GGBR3,2014-06-30,573627483,1146031245,1719658728
3980,61,$GGBR3,2014-09-30,573627483,1146031245,1719658728
3980,61,$GGBR3,2014-12-31,573627483,1146031245,1719658728
3980,61,$GGBR3,2015-03-31,573627483,1146031245,1719658728
3980,61,$GGBR3,2015-06-30,573627483,1146031245,1719658728
3980,61,$GGBR3,2015-09-30,573627483,1146031245,1719658728
3980,61,$GGBR3,2015-12-31,573627483,1146031245,1719658728
3980,61,$GGBR3,2016-03-31,573627483,1146031245,1719658728
3980,61,$GGBR3,2016-06-30,573627483,1146031245,1719658728
3980,61,$GGBR3,2016-09-30,573627483,1146031245,1719658728
3980,61,$GGBR3,2016-12-31,573627483,1146031245,1719658728
3980,61,$GGBR3,2017-03-31,573627483,1146031245,1719658728
3980,61,$GGBR3,2017-06-30,573627483,1146031245,1719658728
3980,61,$GGBR3,2017-09-30,573627483,1146031245,1719658728
3980,61,$GGBR3,2017-12-31,573627483,1146031245,1719658728
3980,61,$GGBR3,2018-03-31,573627483,1146031245,1719658728
3980,61,$GGBR3,2018-06-30,573627483,1146031245,1719658728
3980,61,$GGBR3,2018-09-30,573627483,1146031245,1719658728
3980,61,$GGBR3,2018-12-31,573627483,1146031245,1719658728
3980,61,$GGBR3,2019-03-31,573627483,1146031245,1719658728
3980,61,$GGBR3,2019-06-30,573627483,1146031245,1719658728
3980,61,$GGBR3,2019-09-30,573627483,1146031245,1719658728
3980,61,$GGBR3,2019-12-31,573627483,1146031245,1719658728
3980,61,$GGBR3,2020-03-31,573627483,1146031245,1719658728
3980,61,$GGBR3,2020-06-30,573627483,1146031245,1719658728
3980,61,$GGBR3,2020-09-30,573627483,1146031245,1719658728
3980,62,$GGBR4,2010-12-31,505601,1011201,1516802
3980,62,$GGBR4,2011-03-31,505600573,1011201145,1516801718
3980,62,$GGBR4,2011-06-30,573627483,1146031245,1719658728
3980,62,$GGBR4,2011-09-30,573627483,1146031245,1719658728
3980,62,$GGBR4,2011-12-31,573628,1146031,1719659
3980,62,$GGBR4,2012-03-31,573627483,1146031245,1719658728
3980,62,$GGBR4,2012-06-30,573627483,1146031245,1719658728
3980,62,$GGBR4,2012-09-30,573627483,1146031245,1719658728
3980,62,$GGBR4,2012-12-31,573627483,1146031245,1719658728
3980,62,$GGBR4,2013-03-31,573627483,1146031245,1719658728
3980,62,$GGBR4,2013-06-30,573627483,1146031245,1719658728
3980,62,$GGBR4,2013-09-30,573627483,1146031245,1719658728
3980,62,$GGBR4,2013-12-31,573627483,1146031245,1719658728
3980,62,$GGBR4,2014-03-31,573627483,1146031245,1719658728
3980,62,$GGBR4,2014-06-30,573627483,1146031245,1719658728
3980,62,$GGBR4,2014-09-30,573627483,1146031245,1719658728
3980,62,$GGBR4,2014-12-31,573627483,1146031245,1719658728
3980,62,$GGBR4,2015-03-31,573627483,1146031245,1719658728
3980,62,$GGBR4,2015-06-30,573627483,1146031245,1719658728
3980,62,$GGBR4,2015-09-30,573627483,1146031245,1719658728
3980,62,$GGBR4,2015-12-31,573627483,1146031245,1719658728
3980,62,$GGBR4,2016-03-31,573627483,1146031245,1719658728
3980,62,$GGBR4,2016-06-30,573627483,1146031245,1719658728
3980,62,$GGBR4,2016-09-30,573627483,1146031245,1719658728
3980,62,$GGBR4,2016-12-31,573627483,1146031245,1719658728
3980,62,$GGBR4,2017-03-31,573627483,1146031245,1719658728
3980,62,$GGBR4,2017-06-30,573627483,1146031245,1719658728
3980,62,$GGBR4,2017-09-30,573627483,1146031245,1719658728
3980,62,$GGBR4,2017-12-31,573627483,1146031245,1719658728
3980,62,$GGBR4,2018-03-31,573627483,1146031245,1719658728
3980,62,$GGBR4,2018-06-30,573627483,1146031245,1719658728
3980,62,$GGBR4,2018-09-30,573627483,1146031245,1719658728
3980,62,$GGBR4,2018-12-31,573627483,1146031245,1719658728
3980,62,$GGBR4,2019-03-31,573627483,1146031245,1719658728
3980,62,$GGBR4,2019-06-30,573627483,1146031245,1719658728
3980,62,$GGBR4,2019-09-30,573627483,1146031245,1719658728
3980,62,$GGBR4,2019-12-31,573627483,1146031245,1719658728
3980,62,$GGBR4,2020-03-31,573627483,1146031245,1719658728
3980,62,$GGBR4,2020-06-30,573627483,1146031245,1719658728
3980,62,$GGBR4,2020-09-30,573627483,1146031245,1719658728
4030,69,$4030,2010-12-31,1483033685,0,1483033685
4030,69,$4030,2011-03-31,1483033685,0,1483033685
4030,69,$4030,2011-06-30,1483033685,0,1483033685
4030,69,$4030,2011-09-30,1457970108,0,1457970108
4030,69,$4030,2011-12-31,1457970108,0,1457970108
4030,69,$4030,2012-03-31,1457970108,0,1457970108
4030,69,$4030,2012-06-30,1457970108,0,1457970108
4030,69,$4030,2012-09-30,1457970108,0,1457970108
4030,69,$4030,2012-12-31,1457970108,0,1457970108
4030,69,$4030,2013-03-31,1457970108,0,1457970108
4030,69,$4030,2013-06-30,1457970108,0,1457970108
4030,69,$4030,2013-09-30,1457970108,0,1457970108
4030,69,$4030,2013-12-31,1457970108,0,1457970108
4030,69,$4030,2014-03-31,1457970108,0,1457970108
4030,69,$4030,2014-06-30,1457970108,0,1457970108
4030,69,$4030,2014-09-30,1387524047,0,1387524047
4030,69,$4030,2014-12-31,1387524047,0,1387524047
4030,69,$4030,2015-03-31,1387524047,0,1387524047
4030,69,$4030,2015-06-30,1387524047,0,1387524047
4030,69,$4030,2015-09-30,1387524047,0,1387524047
4030,69,$4030,2015-12-31,1387524047,0,1387524047
4030,69,$4030,2015-12-31,1387524047,0,1387524047
4030,69,$4030,2016-03-31,1387524047,0,1387524047
4030,69,$4030,2016-06-30,1387524047,0,1387524047
4030,69,$4030,2016-09-30,1387524047,0,1387524047
4030,69,$4030,2016-09-30,1387524047,0,1387524047
4030,69,$4030,2016-12-31,1387524047,0,1387524047
4030,69,$4030,2017-03-31,1387524047,0,1387524047
4030,69,$4030,2017-06-30,1387524047,0,1387524047
4030,69,$4030,2017-09-30,1387524047,0,1387524047
4030,69,$4030,2017-12-31,1387524047,0,1387524047
4030,69,$4030,2017-12-31,1387524047,0,1387524047
4030,69,$4030,2018-03-31,1387524047,0,1387524047
4030,69,$4030,2018-06-30,1387524047,0,1387524047
4030,69,$4030,2018-09-30,1387524047,0,1387524047
4030,69,$4030,2018-12-31,1387524047,0,1387524047
4030,69,$4030,2019-03-31,1387524047,0,1387524047
4030,69,$4030,2019-06-30,1387524047,0,1387524047
4030,69,$4030,2019-09-30,1387524047,0,1387524047
4030,69,$4030,2019-12-31,1387524047,0,1387524047
4030,69,$4030,2020-03-31,1387524047,0,1387524047
4030,69,$4030,2020-06-30,1387524047,0,1387524047
4030,69,$4030,2020-09-30,1387524047,0,1387524047
4081,65,$CTSA3,2010-12-31,38041,1258,39299
4081,65,$CTSA3,2011-03-31,38041,1258,39299
4081,65,$CTSA3,2011-06-30,38041,1258,39299
4081,65,$CTSA3,2011-09-30,38041,1258,39299
4081,65,$CTSA3,2011-12-31,38041,1258,39299
4081,65,$CTSA3,2012-03-31,38041,1258,39299
4081,65,$CTSA3,2012-06-30,38041,1258,39299
4081,65,$CTSA3,2012-09-30,38041,1258,39299
4081,65,$CTSA3,2012-12-31,38041,1258,39299
4081,65,$CTSA3,2013-03-31,38041,1258,39299
4081,65,$CTSA3,2013-06-30,38041,1258,39299
4081,65,$CTSA3,2013-09-30,38041,1258,39299
4081,65,$CTSA3,2013-12-31,38041,1258,39299
4081,65,$CTSA3,2014-03-31,38041,1258,39299
4081,65,$CTSA3,2014-06-30,38041,1258,39299
4081,65,$CTSA3,2014-09-30,38041,1258,39299
4081,65,$CTSA3,2014-12-31,38041,1258,39299
4081,65,$CTSA3,2015-03-31,38041,1258,39299
4081,65,$CTSA3,2015-06-30,38041,1258,39299
4081,65,$CTSA3,2015-09-30,38041,1258,39299
4081,65,$CTSA3,2015-12-31,38041,1258,39299
4081,65,$CTSA3,2016-03-31,38041,1258,39299
4081,65,$CTSA3,2016-06-30,38041,1258,39299
4081,65,$CTSA3,2016-09-30,38041,1258,39299
4081,65,$CTSA3,2016-12-31,38041,1258,39299
4081,65,$CTSA3,2017-03-31,38041,1258,39299
4081,65,$CTSA3,2017-06-30,38041,1258,39299
4081,65,$CTSA3,2017-09-30,38041,1258,39299
4081,65,$CTSA3,2017-12-31,38041,1258,39299
4081,65,$CTSA3,2018-03-31,38041,1258,39299
4081,65,$CTSA3,2018-06-30,38041,1258,39299
4081,65,$CTSA3,2018-09-30,38041,1258,39299
4081,65,$CTSA3,2018-12-31,38041,1258,39299
4081,65,$CTSA3,2019-03-31,38041,1258,39299
4081,65,$CTSA3,2019-06-30,38041,1258,39299
4081,65,$CTSA3,2019-09-30,38041,1258,39299
4081,65,$CTSA3,2019-12-31,38041,1258,39299
4081,65,$CTSA3,2020-03-31,38041,1258,39299
4081,65,$CTSA3,2020-06-30,38041,73258,111299
4081,65,$CTSA3,2020-09-30,38041,73258,111299
4146,63,$CTKA3,2010-12-31,6121,8285,14406
4146,63,$CTKA3,2011-03-31,6121,8285,14406
4146,63,$CTKA3,2011-06-30,6121,8285,14406
4146,63,$CTKA3,2011-09-30,6121,8285,14406
4146,63,$CTKA3,2011-12-31,6121,8285,14406
4146,63,$CTKA3,2012-03-31,6121,8285,14406
4146,63,$CTKA3,2012-06-30,6121,8285,14406
4146,63,$CTKA3,2012-09-30,6121,8285,14406
4146,63,$CTKA3,2012-12-31,6121,8285,14406
4146,63,$CTKA3,2013-03-31,6121,8285,14406
4146,63,$CTKA3,2013-06-30,6121,8285,14406
4146,63,$CTKA3,2013-09-30,6121,8285,14406
4146,63,$CTKA3,2013-12-31,6121,8285,14406
4146,63,$CTKA3,2014-03-31,6121,8285,14406
4146,63,$CTKA3,2014-06-30,6121,8285,14406
4146,63,$CTKA3,2014-09-30,6121,8285,14406
4146,63,$CTKA3,2014-12-31,28784,33270,62054
4146,63,$CTKA3,2015-03-31,28784041,33269710,62053751
4146,63,$CTKA3,2015-06-30,28784,33270,62054
4146,63,$CTKA3,2015-09-30,28784,33270,62054
4146,63,$CTKA3,2015-12-31,28784,33270,62054
4146,63,$CTKA3,2016-03-31,28784,33270,62054
4146,63,$CTKA3,2016-06-30,2878,3327,6205
4146,63,$CTKA3,2016-09-30,2878,3327,6205
4146,63,$CTKA3,2016-12-31,2878,3327,6205
4146,63,$CTKA3,2017-03-31,2878,3327,6205
4146,63,$CTKA3,2017-06-30,2878,3327,6205
4146,63,$CTKA3,2017-09-30,2878,3327,6205
4146,63,$CTKA3,2017-12-31,2878,3327,6205
4146,63,$CTKA3,2018-03-31,2878,3327,6205
4146,63,$CTKA3,2018-06-30,2878,3327,6205
4146,63,$CTKA3,2018-09-30,2878,3327,6205
4146,63,$CTKA3,2018-12-31,2878,3327,6205
4146,63,$CTKA3,2019-03-31,2878,3327,6205
4146,63,$CTKA3,2019-06-30,2878,3327,6205
4146,63,$CTKA3,2019-09-30,2878,3327,6205
4146,63,$CTKA3,2019-12-31,2878,3327,6205
4146,63,$CTKA3,2020-03-31,2878,3327,6205
4146,63,$CTKA3,2020-06-30,2878,3327,6205
4146,63,$CTKA3,2020-09-30,2878,3327,6205
4146,64,$CTKA4,2010-12-31,6121,8285,14406
4146,64,$CTKA4,2011-03-31,6121,8285,14406
4146,64,$CTKA4,2011-06-30,6121,8285,14406
4146,64,$CTKA4,2011-09-30,6121,8285,14406
4146,64,$CTKA4,2011-12-31,6121,8285,14406
4146,64,$CTKA4,2012-03-31,6121,8285,14406
4146,64,$CTKA4,2012-06-30,6121,8285,14406
4146,64,$CTKA4,2012-09-30,6121,8285,14406
4146,64,$CTKA4,2012-12-31,6121,8285,14406
4146,64,$CTKA4,2013-03-31,6121,8285,14406
4146,64,$CTKA4,2013-06-30,6121,8285,14406
4146,64,$CTKA4,2013-09-30,6121,8285,14406
4146,64,$CTKA4,2013-12-31,6121,8285,14406
4146,64,$CTKA4,2014-03-31,6121,8285,14406
4146,64,$CTKA4,2014-06-30,6121,8285,14406
4146,64,$CTKA4,2014-09-30,6121,8285,14406
4146,64,$CTKA4,2014-12-31,28784,33270,62054
4146,64,$CTKA4,2015-03-31,28784041,33269710,62053751
4146,64,$CTKA4,2015-06-30,28784,33270,62054
4146,64,$CTKA4,2015-09-30,28784,33270,62054
4146,64,$CTKA4,2015-12-31,28784,33270,62054
4146,64,$CTKA4,2016-03-31,28784,33270,62054
4146,64,$CTKA4,2016-06-30,2878,3327,6205
4146,64,$CTKA4,2016-09-30,2878,3327,6205
4146,64,$CTKA4,2016-12-31,2878,3327,6205
4146,64,$CTKA4,2017-03-31,2878,3327,6205
4146,64,$CTKA4,2017-06-30,2878,3327,6205
4146,64,$CTKA4,2017-09-30,2878,3327,6205
4146,64,$CTKA4,2017-12-31,2878,3327,6205
4146,64,$CTKA4,2018-03-31,2878,3327,6205
4146,64,$CTKA4,2018-06-30,2878,3327,6205
4146,64,$CTKA4,2018-09-30,2878,3327,6205
4146,64,$CTKA4,2018-12-31,2878,3327,6205
4146,64,$CTKA4,2019-03-31,2878,3327,6205
4146,64,$CTKA4,2019-06-30,2878,3327,6205
4146,64,$CTKA4,2019-09-30,2878,3327,6205
4146,64,$CTKA4,2019-12-31,2878,3327,6205
4146,64,$CTKA4,2020-03-31,2878,3327,6205
4146,64,$CTKA4,2020-06-30,2878,3327,6205
4146,64,$CTKA4,2020-09-30,2878,3327,6205
4170,91,$VALE3,2010-12-31,3256725,2108580,5365305
4170,91,$VALE3,2011-03-31,3256725,2108580,5365305
4170,91,$VALE3,2011-06-30,3256725,2108580,5365305
4170,91,$VALE3,2011-09-30,3256725,2108580,5365305
4170,91,$VALE3,2011-09-30,3256725,2108580,5365305
4170,91,$VALE3,2011-12-31,3256725,2108580,5365305
4170,91,$VALE3,2011-12-31,3256725,2108580,5365305
4170,91,$VALE3,2012-03-31,3256725,2108580,5365305
4170,91,$VALE3,2012-06-30,3256725,2108580,5365305
4170,91,$VALE3,2012-09-30,3256725,2108580,5365305
4170,91,$VALE3,2012-12-31,3256725,2108580,5365305
4170,91,$VALE3,2013-03-31,3256725,2108580,5365305
4170,91,$VALE3,2013-03-31,3256725,2108580,5365305
4170,91,$VALE3,2013-06-30,3256725,2108580,5365305
4170,91,$VALE3,2013-06-30,3256725,2108580,5365305
4170,91,$VALE3,2013-09-30,3256725,2108580,5365305
4170,91,$VALE3,2013-12-31,3256725,2108580,5365305
4170,91,$VALE3,2013-12-31,3256725,2108580,5365305
4170,91,$VALE3,2014-03-31,3256725,2108580,5365305
4170,91,$VALE3,2014-06-30,3217188,2027128,5244316
4170,91,$VALE3,2014-09-30,3217188,2027128,5244316
4170,91,$VALE3,2014-12-31,3217188,2027128,5244316
4170,91,$VALE3,2015-03-31,3217188,2027128,5244316
4170,91,$VALE3,2015-06-30,3217188,2027128,5244316
4170,91,$VALE3,2015-09-30,3217188,2027128,5244316
4170,91,$VALE3,2015-12-31,3217188,2027128,5244316
4170,91,$VALE3,2016-03-31,3217188,2027128,5244316
4170,91,$VALE3,2016-06-30,3217188,2027128,5244316
4170,91,$VALE3,2016-09-30,3217188,2027128,5244316
4170,91,$VALE3,2016-12-31,3217188,2027128,5244316
4170,91,$VALE3,2017-03-31,3217188,2027128,5244316
4170,91,$VALE3,2017-06-30,3217188,2027128,5244316
4170,91,$VALE3,2017-09-30,4997545,307140,5304685
4170,91,$VALE3,2017-12-31,5284475,0,5284475
4170,91,$VALE3,2018-03-31,5284475,0,5284475
4170,91,$VALE3,2018-06-30,5284475,0,5284475
4170,91,$VALE3,2018-09-30,5284475,0,5284475
4170,91,$VALE3,2018-12-31,5284475,0,5284475
4170,91,$VALE3,2018-12-31,5284475,0,5284475
4170,91,$VALE3,2019-03-31,5284475,0,5284475
4170,91,$VALE3,2019-06-30,5284475,0,5284475
4170,91,$VALE3,2019-09-30,5284475,0,5284475
4170,91,$VALE3,2019-12-31,5284475,0,5284475
4170,91,$VALE3,2019-12-31,5284475,0,5284475
4170,91,$VALE3,2020-03-31,5284475,0,5284475
4170,91,$VALE3,2020-06-30,5284475,0,5284475
4170,91,$VALE3,2020-09-30,5284475,0,5284475
4170,91,$VALE3,2020-09-30,5284475,0,5284475
4537,70,$CGRA4,2010-12-31,8759925,12913750,21673675
4537,70,$CGRA4,2011-03-31,8759925,12913750,21673675
4537,70,$CGRA4,2011-06-30,8759925,12949533,21709458
4537,70,$CGRA4,2011-09-30,8759925,12949533,21709458
4537,70,$CGRA4,2011-12-31,8759925,12949533,21709458
4537,70,$CGRA4,2012-03-31,8759925,12949533,21709458
4537,70,$CGRA4,2012-06-30,8759925,13008320,21768245
4537,70,$CGRA4,2012-09-30,8759925,13008320,21768245
4537,70,$CGRA4,2012-12-31,8759925,13008320,21768245
4537,70,$CGRA4,2013-03-31,8759925,13008320,21768245
4537,70,$CGRA4,2013-06-30,8759925,13056020,21815945
4537,70,$CGRA4,2013-09-30,8759925,13056020,21815945
4537,70,$CGRA4,2013-12-31,8759925,13056020,21815945
4537,70,$CGRA4,2014-03-31,8759925,13056020,21815945
4537,70,$CGRA4,2014-06-30,8759925,13108445,21868370
4537,70,$CGRA4,2014-09-30,8759925,13108445,21868370
4537,70,$CGRA4,2014-12-31,8759925,13108445,21868370
4537,70,$CGRA4,2015-03-31,8759925,13108445,21868370
4537,70,$CGRA4,2015-06-30,8759925,13164095,21924020
4537,70,$CGRA4,2015-09-30,8759925,13164095,21924020
4537,70,$CGRA4,2015-12-31,8759925,13164095,21924020
4537,70,$CGRA4,2016-03-31,8759925,13164095,21924020
4537,70,$CGRA4,2016-06-30,8759925,13278949,22038874
4537,70,$CGRA4,2016-09-30,8759925,13278949,22038874
4537,70,$CGRA4,2016-12-31,8759925,13278949,22038874
4537,70,$CGRA4,2017-03-31,8759925,13278949,22038874
4537,70,$CGRA4,2017-06-30,8459925,12455405,20915330
4537,70,$CGRA4,2017-09-30,8459925,12455405,20915330
4537,70,$CGRA4,2017-12-31,8459925,12455405,20915330
4537,70,$CGRA4,2018-03-31,8459925,12455405,20915330
4537,70,$CGRA4,2018-06-30,8196525,12016981,20213506
4537,70,$CGRA4,2018-09-30,8196525,12016981,20213506
4537,70,$CGRA4,2018-12-31,8196525,12016981,20213506
4537,70,$CGRA4,2019-03-31,8196525,12016981,20213506
4537,70,$CGRA4,2019-06-30,8174413,11926570,20100983
4537,70,$CGRA4,2019-09-30,8174413,11926570,20100983
4537,70,$CGRA4,2019-12-31,8174413,11926570,20100983
4537,70,$CGRA4,2020-03-31,8174413,11926570,20100983
4537,70,$CGRA4,2020-06-30,8174413,11926570,20100983
4537,70,$CGRA4,2020-09-30,8174413,11973166,20147579
4669,71,$GUAR3,2010-12-31,31200000,31200000,62400000
4669,71,$GUAR3,2011-03-31,31200,31200,62400
4669,71,$GUAR3,2011-06-30,31200,31200,62400
4669,71,$GUAR3,2011-09-30,31200,31200,62400
4669,71,$GUAR3,2011-12-31,31200000,31200000,62400000
4669,71,$GUAR3,2012-03-31,31200,31200,62400
4669,71,$GUAR3,2012-06-30,31200,31200,62400
4669,71,$GUAR3,2012-09-30,31200,31200,62400
4669,71,$GUAR3,2012-12-31,31200000,31200000,62400000
4669,71,$GUAR3,2013-03-31,31200,31200,62400
4669,71,$GUAR3,2013-06-30,31200,31200,62400
4669,71,$GUAR3,2013-09-30,31200,31200,62400
4669,71,$GUAR3,2013-12-31,31200000,31200000,62400000
4669,71,$GUAR3,2014-03-31,31200,31200,62400
4669,71,$GUAR3,2014-06-30,31200,31200,62400
4669,71,$GUAR3,2014-09-30,31200,31200,62400
4669,71,$GUAR3,2014-12-31,31200000,31200000,62400000
4669,71,$GUAR3,2015-03-31,31200,31200,62400
4669,71,$GUAR3,2015-06-30,31200,31200,62400
4669,71,$GUAR3,2015-09-30,31200,31200,62400
4669,71,$GUAR3,2015-12-31,31200000,31200000,62400000
4669,71,$GUAR3,2016-03-31,31200,31200,62400
4669,71,$GUAR3,2016-06-30,31200,31200,62400
4669,71,$GUAR3,2016-09-30,31200,31200,62400
4669,71,$GUAR3,2016-12-31,31200000,31200000,62400000
4669,71,$GUAR3,2017-03-31,31200,31200,62400
4669,71,$GUAR3,2017-06-30,31200,31200,62400
4669,71,$GUAR3,2017-09-30,31200,31200,62400
4669,71,$GUAR3,2017-12-31,31200000,31200000,62400000
4669,71,$GUAR3,2018-03-31,31200,31200,62400
4669,71,$GUAR3,2018-06-30,31200,31200,62400
4669,71,$GUAR3,2018-09-30,31200,31200,62400
4669,71,$GUAR3,2018-12-31,31200000,31200000,62400000
4669,71,$GUAR3,2019-03-31,62400,0,62400
4669,71,$GUAR3,2019-06-30,499200,0,499200
4669,71,$GUAR3,2019-09-30,499200,0,499200
4669,71,$GUAR3,2019-12-31,499200,0,499200
4669,71,$GUAR3,2020-03-31,499200000,0,499200000
4669,71,$GUAR3,2020-06-30,499200000,0,499200000
4669,71,$GUAR3,2020-09-30,499200000,0,499200000
4669,72,$GUAR4,2010-12-31,31200000,31200000,62400000
4669,72,$GUAR4,2011-03-31,31200,31200,62400
4669,72,$GUAR4,2011-06-30,31200,31200,62400
4669,72,$GUAR4,2011-09-30,31200,31200,62400
4669,72,$GUAR4,2011-12-31,31200000,31200000,62400000
4669,72,$GUAR4,2012-03-31,31200,31200,62400
4669,72,$GUAR4,2012-06-30,31200,31200,62400
4669,72,$GUAR4,2012-09-30,31200,31200,62400
4669,72,$GUAR4,2012-12-31,31200000,31200000,62400000
4669,72,$GUAR4,2013-03-31,31200,31200,62400
4669,72,$GUAR4,2013-06-30,31200,31200,62400
4669,72,$GUAR4,2013-09-30,31200,31200,62400
4669,72,$GUAR4,2013-12-31,31200000,31200000,62400000
4669,72,$GUAR4,2014-03-31,31200,31200,62400
4669,72,$GUAR4,2014-06-30,31200,31200,62400
4669,72,$GUAR4,2014-09-30,31200,31200,62400
4669,72,$GUAR4,2014-12-31,31200000,31200000,62400000
4669,72,$GUAR4,2015-03-31,31200,31200,62400
4669,72,$GUAR4,2015-06-30,31200,31200,62400
4669,72,$GUAR4,2015-09-30,31200,31200,62400
4669,72,$GUAR4,2015-12-31,31200000,31200000,62400000
4669,72,$GUAR4,2016-03-31,31200,31200,62400
4669,72,$GUAR4,2016-06-30,31200,31200,62400
4669,72,$GUAR4,2016-09-30,31200,31200,62400
4669,72,$GUAR4,2016-12-31,31200000,31200000,62400000
4669,72,$GUAR4,2017-03-31,31200,31200,62400
4669,72,$GUAR4,2017-06-30,31200,31200,62400
4669,72,$GUAR4,2017-09-30,31200,31200,62400
4669,72,$GUAR4,2017-12-31,31200000,31200000,62400000
4669,72,$GUAR4,2018-03-31,31200,31200,62400
4669,72,$GUAR4,2018-06-30,31200,31200,62400
4669,72,$GUAR4,2018-09-30,31200,31200,62400
4669,72,$GUAR4,2018-12-31,31200000,31200000,62400000
4669,72,$GUAR4,2019-03-31,62400,0,62400
4669,72,$GUAR4,2019-06-30,499200,0,499200
4669,72,$GUAR4,2019-09-30,499200,0,499200
4669,72,$GUAR4,2019-12-31,499200,0,499200
4669,72,$GUAR4,2020-03-31,499200000,0,499200000
4669,72,$GUAR4,2020-06-30,499200000,0,499200000
4669,72,$GUAR4,2020-09-30,499200000,0,499200000
4685,431,$468-5,2010-12-31,14049,4073,18122
4685,431,$468-5,2011-03-31,14049,4073,18122
4685,431,$468-5,2011-06-30,14049,4073,18122
4685,431,$468-5,2011-09-30,14049,4073,18122
4685,431,$468-5,2011-12-31,14049,4073,18122
4685,431,$468-5,2012-03-31,14049,4073,18122
4685,431,$468-5,2012-06-30,14049,4073,18122
4685,431,$468-5,2012-09-30,14049,4073,18122
4685,431,$468-5,2012-12-31,14049,4073,18122
4685,431,$468-5,2013-03-31,14049,4073,18122
4685,431,$468-5,2013-06-30,14049,4073,18122
4685,431,$468-5,2013-09-30,14049,4073,18122
4685,431,$468-5,2013-12-31,14049,4073,18122
4685,431,$468-5,2014-03-31,14049,4073,18122
4685,431,$468-5,2014-06-30,14049,4073,18122
4685,431,$468-5,2014-09-30,14049,4073,18122
4685,431,$468-5,2014-12-31,14049,4073,18122
4685,431,$468-5,2015-03-31,14049,4073,18122
4685,431,$468-5,2015-06-30,14049,4073,18122
4685,431,$468-5,2015-09-30,14049,4073,18122
4685,431,$468-5,2015-12-31,14049,4073,18122
4685,431,$468-5,2016-03-31,14049,4073,18122
4685,431,$468-5,2016-06-30,14049,4073,18122
4685,431,$468-5,2016-09-30,14049,4073,18122
4685,431,$468-5,2016-12-31,14049,4073,18122
4685,431,$468-5,2017-03-31,14049,4073,18122
4685,431,$468-5,2017-06-30,14049,4073,18122
4685,431,$468-5,2017-09-30,14049,4073,18122
4685,431,$468-5,2017-12-31,14049,4073,18122
4685,431,$468-5,2018-03-31,14049,4073,18122
4685,431,$468-5,2018-06-30,14049,4073,18122
4685,431,$468-5,2018-09-30,14049,4073,18122
4685,431,$468-5,2018-12-31,14049,4073,18122
4685,431,$468-5,2019-03-31,14049,4073,18122
4685,431,$468-5,2019-06-30,14049,4073,18122
4685,431,$468-5,2019-09-30,14049,4073,18122
4685,431,$468-5,2019-12-31,14049,4073,18122
4685,431,$468-5,2020-03-31,14049,4073,18122
4685,431,$468-5,2020-06-30,14049,4073,18122
4685,431,$468-5,2020-09-30,14049,4073,18122
4707,74,$CNPB7,2010-12-31,40394932,33251456,73646388
4707,74,$CNPB7,2011-03-31,40394932,33251456,73646388
4707,74,$CNPB7,2011-06-30,40394932,33251456,73646388
4707,74,$CNPB7,2011-09-30,40394932,33251456,73646388
4707,74,$CNPB7,2011-12-31,40394932,33251456,73646388
4707,74,$CNPB7,2012-03-31,40394932,33251456,73646388
4707,74,$CNPB7,2012-06-30,40394932,33251456,73646388
4707,74,$CNPB7,2012-09-30,40394932,33251456,73646388
4707,74,$CNPB7,2012-12-31,40394932,33251456,73646388
4707,74,$CNPB7,2013-03-31,40394932,33251456,73646388
4707,74,$CNPB7,2013-06-30,40394932,33251456,73646388
4707,74,$CNPB7,2013-09-30,40394932,33251456,73646388
4707,74,$CNPB7,2013-12-31,40394932,33251456,73646388
4707,74,$CNPB7,2014-03-31,40394932,33251456,73646388
4707,74,$CNPB7,2014-06-30,40394932,33251456,73646388
4707,74,$CNPB7,2014-09-30,40394932,33251456,73646388
4707,74,$CNPB7,2014-12-31,40394932,33251456,73646388
4707,74,$CNPB7,2015-03-31,40394932,33251456,73646388
4707,74,$CNPB7,2015-06-30,40394932,33251456,73646388
4707,74,$CNPB7,2015-09-30,40394932,33251456,73646388
4707,74,$CNPB7,2015-12-31,40394932,33251456,73646388
4707,74,$CNPB7,2016-03-31,40394932,33251456,73646388
4707,74,$CNPB7,2016-06-30,40394932,33251456,73646388
4707,74,$CNPB7,2016-09-30,40394932,33251456,73646388
4707,74,$CNPB7,2016-12-31,40394932,33251456,73646388
4707,74,$CNPB7,2017-03-31,40394932,33251456,73646388
4707,74,$CNPB7,2017-06-30,40394932,33251456,73646388
4707,74,$CNPB7,2017-09-30,40394932,33251456,73646388
4707,74,$CNPB7,2017-12-31,40394932,33251456,73646388
4707,74,$CNPB7,2018-03-31,40394932,33251456,73646388
4707,74,$CNPB7,2018-06-30,40394932,33251456,73646388
4707,74,$CNPB7,2018-09-30,40394932,33251456,73646388
4707,74,$CNPB7,2018-12-31,40394932,33251456,73646388
4707,74,$CNPB7,2019-03-31,40394932,33251456,73646388
4707,74,$CNPB7,2019-06-30,40394932,33251456,73646388
4707,74,$CNPB7,2019-09-30,40394932,33251456,73646388
4707,74,$CNPB7,2019-12-31,40394932,33251456,73646388
4707,74,$CNPB7,2020-03-31,40394932,33251456,73646388
4707,74,$CNPB7,2020-06-30,40394932,33251456,73646388
4707,74,$CNPB7,2020-09-30,40394932,33251456,73646388
4707,75,$CNPD3,2010-12-31,40394932,33251456,73646388
4707,75,$CNPD3,2011-03-31,40394932,33251456,73646388
4707,75,$CNPD3,2011-06-30,40394932,33251456,73646388
4707,75,$CNPD3,2011-09-30,40394932,33251456,73646388
4707,75,$CNPD3,2011-12-31,40394932,33251456,73646388
4707,75,$CNPD3,2012-03-31,40394932,33251456,73646388
4707,75,$CNPD3,2012-06-30,40394932,33251456,73646388
4707,75,$CNPD3,2012-09-30,40394932,33251456,73646388
4707,75,$CNPD3,2012-12-31,40394932,33251456,73646388
4707,75,$CNPD3,2013-03-31,40394932,33251456,73646388
4707,75,$CNPD3,2013-06-30,40394932,33251456,73646388
4707,75,$CNPD3,2013-09-30,40394932,33251456,73646388
4707,75,$CNPD3,2013-12-31,40394932,33251456,73646388
4707,75,$CNPD3,2014-03-31,40394932,33251456,73646388
4707,75,$CNPD3,2014-06-30,40394932,33251456,73646388
4707,75,$CNPD3,2014-09-30,40394932,33251456,73646388
4707,75,$CNPD3,2014-12-31,40394932,33251456,73646388
4707,75,$CNPD3,2015-03-31,40394932,33251456,73646388
4707,75,$CNPD3,2015-06-30,40394932,33251456,73646388
4707,75,$CNPD3,2015-09-30,40394932,33251456,73646388
4707,75,$CNPD3,2015-12-31,40394932,33251456,73646388
4707,75,$CNPD3,2016-03-31,40394932,33251456,73646388
4707,75,$CNPD3,2016-06-30,40394932,33251456,73646388
4707,75,$CNPD3,2016-09-30,40394932,33251456,73646388
4707,75,$CNPD3,2016-12-31,40394932,33251456,73646388
4707,75,$CNPD3,2017-03-31,40394932,33251456,73646388
4707,75,$CNPD3,2017-06-30,40394932,33251456,73646388
4707,75,$CNPD3,2017-09-30,40394932,33251456,73646388
4707,75,$CNPD3,2017-12-31,40394932,33251456,73646388
4707,75,$CNPD3,2018-03-31,40394932,33251456,73646388
4707,75,$CNPD3,2018-06-30,40394932,33251456,73646388
4707,75,$CNPD3,2018-09-30,40394932,33251456,73646388
4707,75,$CNPD3,2018-12-31,40394932,33251456,73646388
4707,75,$CNPD3,2019-03-31,40394932,33251456,73646388
4707,75,$CNPD3,2019-06-30,40394932,33251456,73646388
4707,75,$CNPD3,2019-09-30,40394932,33251456,73646388
4707,75,$CNPD3,2019-12-31,40394932,33251456,73646388
4707,75,$CNPD3,2020-03-31,40394932,33251456,73646388
4707,75,$CNPD3,2020-06-30,40394932,33251456,73646388
4707,75,$CNPD3,2020-09-30,40394932,33251456,73646388
4707,76,$CNPF8,2010-12-31,40394932,33251456,73646388
4707,76,$CNPF8,2011-03-31,40394932,33251456,73646388
4707,76,$CNPF8,2011-06-30,40394932,33251456,73646388
4707,76,$CNPF8,2011-09-30,40394932,33251456,73646388
4707,76,$CNPF8,2011-12-31,40394932,33251456,73646388
4707,76,$CNPF8,2012-03-31,40394932,33251456,73646388
4707,76,$CNPF8,2012-06-30,40394932,33251456,73646388
4707,76,$CNPF8,2012-09-30,40394932,33251456,73646388
4707,76,$CNPF8,2012-12-31,40394932,33251456,73646388
4707,76,$CNPF8,2013-03-31,40394932,33251456,73646388
4707,76,$CNPF8,2013-06-30,40394932,33251456,73646388
4707,76,$CNPF8,2013-09-30,40394932,33251456,73646388
4707,76,$CNPF8,2013-12-31,40394932,33251456,73646388
4707,76,$CNPF8,2014-03-31,40394932,33251456,73646388
4707,76,$CNPF8,2014-06-30,40394932,33251456,73646388
4707,76,$CNPF8,2014-09-30,40394932,33251456,73646388
4707,76,$CNPF8,2014-12-31,40394932,33251456,73646388
4707,76,$CNPF8,2015-03-31,40394932,33251456,73646388
4707,76,$CNPF8,2015-06-30,40394932,33251456,73646388
4707,76,$CNPF8,2015-09-30,40394932,33251456,73646388
4707,76,$CNPF8,2015-12-31,40394932,33251456,73646388
4707,76,$CNPF8,2016-03-31,40394932,33251456,73646388
4707,76,$CNPF8,2016-06-30,40394932,33251456,73646388
4707,76,$CNPF8,2016-09-30,40394932,33251456,73646388
4707,76,$CNPF8,2016-12-31,40394932,33251456,73646388
4707,76,$CNPF8,2017-03-31,40394932,33251456,73646388
4707,76,$CNPF8,2017-06-30,40394932,33251456,73646388
4707,76,$CNPF8,2017-09-30,40394932,33251456,73646388
4707,76,$CNPF8,2017-12-31,40394932,33251456,73646388
4707,76,$CNPF8,2018-03-31,40394932,33251456,73646388
4707,76,$CNPF8,2018-06-30,40394932,33251456,73646388
4707,76,$CNPF8,2018-09-30,40394932,33251456,73646388
4707,76,$CNPF8,2018-12-31,40394932,33251456,73646388
4707,76,$CNPF8,2019-03-31,40394932,33251456,73646388
4707,76,$CNPF8,2019-06-30,40394932,33251456,73646388
4707,76,$CNPF8,2019-09-30,40394932,33251456,73646388
4707,76,$CNPF8,2019-12-31,40394932,33251456,73646388
4707,76,$CNPF8,2020-03-31,40394932,33251456,73646388
4707,76,$CNPF8,2020-06-30,40394932,33251456,73646388
4707,76,$CNPF8,2020-09-30,40394932,33251456,73646388
4707,77,$CNPA9,2010-12-31,40394932,33251456,73646388
4707,77,$CNPA9,2011-03-31,40394932,33251456,73646388
4707,77,$CNPA9,2011-06-30,40394932,33251456,73646388
4707,77,$CNPA9,2011-09-30,40394932,33251456,73646388
4707,77,$CNPA9,2011-12-31,40394932,33251456,73646388
4707,77,$CNPA9,2012-03-31,40394932,33251456,73646388
4707,77,$CNPA9,2012-06-30,40394932,33251456,73646388
4707,77,$CNPA9,2012-09-30,40394932,33251456,73646388
4707,77,$CNPA9,2012-12-31,40394932,33251456,73646388
4707,77,$CNPA9,2013-03-31,40394932,33251456,73646388
4707,77,$CNPA9,2013-06-30,40394932,33251456,73646388
4707,77,$CNPA9,2013-09-30,40394932,33251456,73646388
4707,77,$CNPA9,2013-12-31,40394932,33251456,73646388
4707,77,$CNPA9,2014-03-31,40394932,33251456,73646388
4707,77,$CNPA9,2014-06-30,40394932,33251456,73646388
4707,77,$CNPA9,2014-09-30,40394932,33251456,73646388
4707,77,$CNPA9,2014-12-31,40394932,33251456,73646388
4707,77,$CNPA9,2015-03-31,40394932,33251456,73646388
4707,77,$CNPA9,2015-06-30,40394932,33251456,73646388
4707,77,$CNPA9,2015-09-30,40394932,33251456,73646388
4707,77,$CNPA9,2015-12-31,40394932,33251456,73646388
4707,77,$CNPA9,2016-03-31,40394932,33251456,73646388
4707,77,$CNPA9,2016-06-30,40394932,33251456,73646388
4707,77,$CNPA9,2016-09-30,40394932,33251456,73646388
4707,77,$CNPA9,2016-12-31,40394932,33251456,73646388
4707,77,$CNPA9,2017-03-31,40394932,33251456,73646388
4707,77,$CNPA9,2017-06-30,40394932,33251456,73646388
4707,77,$CNPA9,2017-09-30,40394932,33251456,73646388
4707,77,$CNPA9,2017-12-31,40394932,33251456,73646388
4707,77,$CNPA9,2018-03-31,40394932,33251456,73646388
4707,77,$CNPA9,2018-06-30,40394932,33251456,73646388
4707,77,$CNPA9,2018-09-30,40394932,33251456,73646388
4707,77,$CNPA9,2018-12-31,40394932,33251456,73646388
4707,77,$CNPA9,2019-03-31,40394932,33251456,73646388
4707,77,$CNPA9,2019-06-30,40394932,33251456,73646388
4707,77,$CNPA9,2019-09-30,40394932,33251456,73646388
4707,77,$CNPA9,2019-12-31,40394932,33251456,73646388
4707,77,$CNPA9,2020-03-31,40394932,33251456,73646388
4707,77,$CNPA9,2020-06-30,40394932,33251456,73646388
4707,77,$CNPA9,2020-09-30,40394932,33251456,73646388
4707,78,$CNPE1,2010-12-31,40394932,33251456,73646388
4707,78,$CNPE1,2011-03-31,40394932,33251456,73646388
4707,78,$CNPE1,2011-06-30,40394932,33251456,73646388
4707,78,$CNPE1,2011-09-30,40394932,33251456,73646388
4707,78,$CNPE1,2011-12-31,40394932,33251456,73646388
4707,78,$CNPE1,2012-03-31,40394932,33251456,73646388
4707,78,$CNPE1,2012-06-30,40394932,33251456,73646388
4707,78,$CNPE1,2012-09-30,40394932,33251456,73646388
4707,78,$CNPE1,2012-12-31,40394932,33251456,73646388
4707,78,$CNPE1,2013-03-31,40394932,33251456,73646388
4707,78,$CNPE1,2013-06-30,40394932,33251456,73646388
4707,78,$CNPE1,2013-09-30,40394932,33251456,73646388
4707,78,$CNPE1,2013-12-31,40394932,33251456,73646388
4707,78,$CNPE1,2014-03-31,40394932,33251456,73646388
4707,78,$CNPE1,2014-06-30,40394932,33251456,73646388
4707,78,$CNPE1,2014-09-30,40394932,33251456,73646388
4707,78,$CNPE1,2014-12-31,40394932,33251456,73646388
4707,78,$CNPE1,2015-03-31,40394932,33251456,73646388
4707,78,$CNPE1,2015-06-30,40394932,33251456,73646388
4707,78,$CNPE1,2015-09-30,40394932,33251456,73646388
4707,78,$CNPE1,2015-12-31,40394932,33251456,73646388
4707,78,$CNPE1,2016-03-31,40394932,33251456,73646388
4707,78,$CNPE1,2016-06-30,40394932,33251456,73646388
4707,78,$CNPE1,2016-09-30,40394932,33251456,73646388
4707,78,$CNPE1,2016-12-31,40394932,33251456,73646388
4707,78,$CNPE1,2017-03-31,40394932,33251456,73646388
4707,78,$CNPE1,2017-06-30,40394932,33251456,73646388
4707,78,$CNPE1,2017-09-30,40394932,33251456,73646388
4707,78,$CNPE1,2017-12-31,40394932,33251456,73646388
4707,78,$CNPE1,2018-03-31,40394932,33251456,73646388
4707,78,$CNPE1,2018-06-30,40394932,33251456,73646388
4707,78,$CNPE1,2018-09-30,40394932,33251456,73646388
4707,78,$CNPE1,2018-12-31,40394932,33251456,73646388
4707,78,$CNPE1,2019-03-31,40394932,33251456,73646388
4707,78,$CNPE1,2019-06-30,40394932,33251456,73646388
4707,78,$CNPE1,2019-09-30,40394932,33251456,73646388
4707,78,$CNPE1,2019-12-31,40394932,33251456,73646388
4707,78,$CNPE1,2020-03-31,40394932,33251456,73646388
4707,78,$CNPE1,2020-06-30,40394932,33251456,73646388
4707,78,$CNPE1,2020-09-30,40394932,33251456,73646388
4707,79,$CNPC5,2010-12-31,40394932,33251456,73646388
4707,79,$CNPC5,2011-03-31,40394932,33251456,73646388
4707,79,$CNPC5,2011-06-30,40394932,33251456,73646388
4707,79,$CNPC5,2011-09-30,40394932,33251456,73646388
4707,79,$CNPC5,2011-12-31,40394932,33251456,73646388
4707,79,$CNPC5,2012-03-31,40394932,33251456,73646388
4707,79,$CNPC5,2012-06-30,40394932,33251456,73646388
4707,79,$CNPC5,2012-09-30,40394932,33251456,73646388
4707,79,$CNPC5,2012-12-31,40394932,33251456,73646388
4707,79,$CNPC5,2013-03-31,40394932,33251456,73646388
4707,79,$CNPC5,2013-06-30,40394932,33251456,73646388
4707,79,$CNPC5,2013-09-30,40394932,33251456,73646388
4707,79,$CNPC5,2013-12-31,40394932,33251456,73646388
4707,79,$CNPC5,2014-03-31,40394932,33251456,73646388
4707,79,$CNPC5,2014-06-30,40394932,33251456,73646388
4707,79,$CNPC5,2014-09-30,40394932,33251456,73646388
4707,79,$CNPC5,2014-12-31,40394932,33251456,73646388
4707,79,$CNPC5,2015-03-31,40394932,33251456,73646388
4707,79,$CNPC5,2015-06-30,40394932,33251456,73646388
4707,79,$CNPC5,2015-09-30,40394932,33251456,73646388
4707,79,$CNPC5,2015-12-31,40394932,33251456,73646388
4707,79,$CNPC5,2016-03-31,40394932,33251456,73646388
4707,79,$CNPC5,2016-06-30,40394932,33251456,73646388
4707,79,$CNPC5,2016-09-30,40394932,33251456,73646388
4707,79,$CNPC5,2016-12-31,40394932,33251456,73646388
4707,79,$CNPC5,2017-03-31,40394932,33251456,73646388
4707,79,$CNPC5,2017-06-30,40394932,33251456,73646388
4707,79,$CNPC5,2017-09-30,40394932,33251456,73646388
4707,79,$CNPC5,2017-12-31,40394932,33251456,73646388
4707,79,$CNPC5,2018-03-31,40394932,33251456,73646388
4707,79,$CNPC5,2018-06-30,40394932,33251456,73646388
4707,79,$CNPC5,2018-09-30,40394932,33251456,73646388
4707,79,$CNPC5,2018-12-31,40394932,33251456,73646388
4707,79,$CNPC5,2019-03-31,40394932,33251456,73646388
4707,79,$CNPC5,2019-06-30,40394932,33251456,73646388
4707,79,$CNPC5,2019-09-30,40394932,33251456,73646388
4707,79,$CNPC5,2019-12-31,40394932,33251456,73646388
4707,79,$CNPC5,2020-03-31,40394932,33251456,73646388
4707,79,$CNPC5,2020-06-30,40394932,33251456,73646388
4707,79,$CNPC5,2020-09-30,40394932,33251456,73646388
4707,80,$BRGE3,2010-12-31,40394932,33251456,73646388
4707,80,$BRGE3,2011-03-31,40394932,33251456,73646388
4707,80,$BRGE3,2011-06-30,40394932,33251456,73646388
4707,80,$BRGE3,2011-09-30,40394932,33251456,73646388
4707,80,$BRGE3,2011-12-31,40394932,33251456,73646388
4707,80,$BRGE3,2012-03-31,40394932,33251456,73646388
4707,80,$BRGE3,2012-06-30,40394932,33251456,73646388
4707,80,$BRGE3,2012-09-30,40394932,33251456,73646388
4707,80,$BRGE3,2012-12-31,40394932,33251456,73646388
4707,80,$BRGE3,2013-03-31,40394932,33251456,73646388
4707,80,$BRGE3,2013-06-30,40394932,33251456,73646388
4707,80,$BRGE3,2013-09-30,40394932,33251456,73646388
4707,80,$BRGE3,2013-12-31,40394932,33251456,73646388
4707,80,$BRGE3,2014-03-31,40394932,33251456,73646388
4707,80,$BRGE3,2014-06-30,40394932,33251456,73646388
4707,80,$BRGE3,2014-09-30,40394932,33251456,73646388
4707,80,$BRGE3,2014-12-31,40394932,33251456,73646388
4707,80,$BRGE3,2015-03-31,40394932,33251456,73646388
4707,80,$BRGE3,2015-06-30,40394932,33251456,73646388
4707,80,$BRGE3,2015-09-30,40394932,33251456,73646388
4707,80,$BRGE3,2015-12-31,40394932,33251456,73646388
4707,80,$BRGE3,2016-03-31,40394932,33251456,73646388
4707,80,$BRGE3,2016-06-30,40394932,33251456,73646388
4707,80,$BRGE3,2016-09-30,40394932,33251456,73646388
4707,80,$BRGE3,2016-12-31,40394932,33251456,73646388
4707,80,$BRGE3,2017-03-31,40394932,33251456,73646388
4707,80,$BRGE3,2017-06-30,40394932,33251456,73646388
4707,80,$BRGE3,2017-09-30,40394932,33251456,73646388
4707,80,$BRGE3,2017-12-31,40394932,33251456,73646388
4707,80,$BRGE3,2018-03-31,40394932,33251456,73646388
4707,80,$BRGE3,2018-06-30,40394932,33251456,73646388
4707,80,$BRGE3,2018-09-30,40394932,33251456,73646388
4707,80,$BRGE3,2018-12-31,40394932,33251456,73646388
4707,80,$BRGE3,2019-03-31,40394932,33251456,73646388
4707,80,$BRGE3,2019-06-30,40394932,33251456,73646388
4707,80,$BRGE3,2019-09-30,40394932,33251456,73646388
4707,80,$BRGE3,2019-12-31,40394932,33251456,73646388
4707,80,$BRGE3,2020-03-31,40394932,33251456,73646388
4707,80,$BRGE3,2020-06-30,40394932,33251456,73646388
4707,80,$BRGE3,2020-09-30,40394932,33251456,73646388
4707,81,$BRGE6,2010-12-31,40394932,33251456,73646388
4707,81,$BRGE6,2011-03-31,40394932,33251456,73646388
4707,81,$BRGE6,2011-06-30,40394932,33251456,73646388
4707,81,$BRGE6,2011-09-30,40394932,33251456,73646388
4707,81,$BRGE6,2011-12-31,40394932,33251456,73646388
4707,81,$BRGE6,2012-03-31,40394932,33251456,73646388
4707,81,$BRGE6,2012-06-30,40394932,33251456,73646388
4707,81,$BRGE6,2012-09-30,40394932,33251456,73646388
4707,81,$BRGE6,2012-12-31,40394932,33251456,73646388
4707,81,$BRGE6,2013-03-31,40394932,33251456,73646388
4707,81,$BRGE6,2013-06-30,40394932,33251456,73646388
4707,81,$BRGE6,2013-09-30,40394932,33251456,73646388
4707,81,$BRGE6,2013-12-31,40394932,33251456,73646388
4707,81,$BRGE6,2014-03-31,40394932,33251456,73646388
4707,81,$BRGE6,2014-06-30,40394932,33251456,73646388
4707,81,$BRGE6,2014-09-30,40394932,33251456,73646388
4707,81,$BRGE6,2014-12-31,40394932,33251456,73646388
4707,81,$BRGE6,2015-03-31,40394932,33251456,73646388
4707,81,$BRGE6,2015-06-30,40394932,33251456,73646388
4707,81,$BRGE6,2015-09-30,40394932,33251456,73646388
4707,81,$BRGE6,2015-12-31,40394932,33251456,73646388
4707,81,$BRGE6,2016-03-31,40394932,33251456,73646388
4707,81,$BRGE6,2016-06-30,40394932,33251456,73646388
4707,81,$BRGE6,2016-09-30,40394932,33251456,73646388
4707,81,$BRGE6,2016-12-31,40394932,33251456,73646388
4707,81,$BRGE6,2017-03-31,40394932,33251456,73646388
4707,81,$BRGE6,2017-06-30,40394932,33251456,73646388
4707,81,$BRGE6,2017-09-30,40394932,33251456,73646388
4707,81,$BRGE6,2017-12-31,40394932,33251456,73646388
4707,81,$BRGE6,2018-03-31,40394932,33251456,73646388
4707,81,$BRGE6,2018-06-30,40394932,33251456,73646388
4707,81,$BRGE6,2018-09-30,40394932,33251456,73646388
4707,81,$BRGE6,2018-12-31,40394932,33251456,73646388
4707,81,$BRGE6,2019-03-31,40394932,33251456,73646388
4707,81,$BRGE6,2019-06-30,40394932,33251456,73646388
4707,81,$BRGE6,2019-09-30,40394932,33251456,73646388
4707,81,$BRGE6,2019-12-31,40394932,33251456,73646388
4707,81,$BRGE6,2020-03-31,40394932,33251456,73646388
4707,81,$BRGE6,2020-06-30,40394932,33251456,73646388
4707,81,$BRGE6,2020-09-30,40394932,33251456,73646388
4707,82,$BRGE8,2010-12-31,40394932,33251456,73646388
4707,82,$BRGE8,2011-03-31,40394932,33251456,73646388
4707,82,$BRGE8,2011-06-30,40394932,33251456,73646388
4707,82,$BRGE8,2011-09-30,40394932,33251456,73646388
4707,82,$BRGE8,2011-12-31,40394932,33251456,73646388
4707,82,$BRGE8,2012-03-31,40394932,33251456,73646388
4707,82,$BRGE8,2012-06-30,40394932,33251456,73646388
4707,82,$BRGE8,2012-09-30,40394932,33251456,73646388
4707,82,$BRGE8,2012-12-31,40394932,33251456,73646388
4707,82,$BRGE8,2013-03-31,40394932,33251456,73646388
4707,82,$BRGE8,2013-06-30,40394932,33251456,73646388
4707,82,$BRGE8,2013-09-30,40394932,33251456,73646388
4707,82,$BRGE8,2013-12-31,40394932,33251456,73646388
4707,82,$BRGE8,2014-03-31,40394932,33251456,73646388
4707,82,$BRGE8,2014-06-30,40394932,33251456,73646388
4707,82,$BRGE8,2014-09-30,40394932,33251456,73646388
4707,82,$BRGE8,2014-12-31,40394932,33251456,73646388
4707,82,$BRGE8,2015-03-31,40394932,33251456,73646388
4707,82,$BRGE8,2015-06-30,40394932,33251456,73646388
4707,82,$BRGE8,2015-09-30,40394932,33251456,73646388
4707,82,$BRGE8,2015-12-31,40394932,33251456,73646388
4707,82,$BRGE8,2016-03-31,40394932,33251456,73646388
4707,82,$BRGE8,2016-06-30,40394932,33251456,73646388
4707,82,$BRGE8,2016-09-30,40394932,33251456,73646388
4707,82,$BRGE8,2016-12-31,40394932,33251456,73646388
4707,82,$BRGE8,2017-03-31,40394932,33251456,73646388
4707,82,$BRGE8,2017-06-30,40394932,33251456,73646388
4707,82,$BRGE8,2017-09-30,40394932,33251456,73646388
4707,82,$BRGE8,2017-12-31,40394932,33251456,73646388
4707,82,$BRGE8,2018-03-31,40394932,33251456,73646388
4707,82,$BRGE8,2018-06-30,40394932,33251456,73646388
4707,82,$BRGE8,2018-09-30,40394932,33251456,73646388
4707,82,$BRGE8,2018-12-31,40394932,33251456,73646388
4707,82,$BRGE8,2019-03-31,40394932,33251456,73646388
4707,82,$BRGE8,2019-06-30,40394932,33251456,73646388
4707,82,$BRGE8,2019-09-30,40394932,33251456,73646388
4707,82,$BRGE8,2019-12-31,40394932,33251456,73646388
4707,82,$BRGE8,2020-03-31,40394932,33251456,73646388
4707,82,$BRGE8,2020-06-30,40394932,33251456,73646388
4707,82,$BRGE8,2020-09-30,40394932,33251456,73646388
4707,83,$BRGE12,2010-12-31,40394932,33251456,73646388
4707,83,$BRGE12,2011-03-31,40394932,33251456,73646388
4707,83,$BRGE12,2011-06-30,40394932,33251456,73646388
4707,83,$BRGE12,2011-09-30,40394932,33251456,73646388
4707,83,$BRGE12,2011-12-31,40394932,33251456,73646388
4707,83,$BRGE12,2012-03-31,40394932,33251456,73646388
4707,83,$BRGE12,2012-06-30,40394932,33251456,73646388
4707,83,$BRGE12,2012-09-30,40394932,33251456,73646388
4707,83,$BRGE12,2012-12-31,40394932,33251456,73646388
4707,83,$BRGE12,2013-03-31,40394932,33251456,73646388
4707,83,$BRGE12,2013-06-30,40394932,33251456,73646388
4707,83,$BRGE12,2013-09-30,40394932,33251456,73646388
4707,83,$BRGE12,2013-12-31,40394932,33251456,73646388
4707,83,$BRGE12,2014-03-31,40394932,33251456,73646388
4707,83,$BRGE12,2014-06-30,40394932,33251456,73646388
4707,83,$BRGE12,2014-09-30,40394932,33251456,73646388
4707,83,$BRGE12,2014-12-31,40394932,33251456,73646388
4707,83,$BRGE12,2015-03-31,40394932,33251456,73646388
4707,83,$BRGE12,2015-06-30,40394932,33251456,73646388
4707,83,$BRGE12,2015-09-30,40394932,33251456,73646388
4707,83,$BRGE12,2015-12-31,40394932,33251456,73646388
4707,83,$BRGE12,2016-03-31,40394932,33251456,73646388
4707,83,$BRGE12,2016-06-30,40394932,33251456,73646388
4707,83,$BRGE12,2016-09-30,40394932,33251456,73646388
4707,83,$BRGE12,2016-12-31,40394932,33251456,73646388
4707,83,$BRGE12,2017-03-31,40394932,33251456,73646388
4707,83,$BRGE12,2017-06-30,40394932,33251456,73646388
4707,83,$BRGE12,2017-09-30,40394932,33251456,73646388
4707,83,$BRGE12,2017-12-31,40394932,33251456,73646388
4707,83,$BRGE12,2018-03-31,40394932,33251456,73646388
4707,83,$BRGE12,2018-06-30,40394932,33251456,73646388
4707,83,$BRGE12,2018-09-30,40394932,33251456,73646388
4707,83,$BRGE12,2018-12-31,40394932,33251456,73646388
4707,83,$BRGE12,2019-03-31,40394932,33251456,73646388
4707,83,$BRGE12,2019-06-30,40394932,33251456,73646388
4707,83,$BRGE12,2019-09-30,40394932,33251456,73646388
4707,83,$BRGE12,2019-12-31,40394932,33251456,73646388
4707,83,$BRGE12,2020-03-31,40394932,33251456,73646388
4707,83,$BRGE12,2020-06-30,40394932,33251456,73646388
4707,83,$BRGE12,2020-09-30,40394932,33251456,73646388
4707,84,$BRGE5,2010-12-31,40394932,33251456,73646388
4707,84,$BRGE5,2011-03-31,40394932,33251456,73646388
4707,84,$BRGE5,2011-06-30,40394932,33251456,73646388
4707,84,$BRGE5,2011-09-30,40394932,33251456,73646388
4707,84,$BRGE5,2011-12-31,40394932,33251456,73646388
4707,84,$BRGE5,2012-03-31,40394932,33251456,73646388
4707,84,$BRGE5,2012-06-30,40394932,33251456,73646388
4707,84,$BRGE5,2012-09-30,40394932,33251456,73646388
4707,84,$BRGE5,2012-12-31,40394932,33251456,73646388
4707,84,$BRGE5,2013-03-31,40394932,33251456,73646388
4707,84,$BRGE5,2013-06-30,40394932,33251456,73646388
4707,84,$BRGE5,2013-09-30,40394932,33251456,73646388
4707,84,$BRGE5,2013-12-31,40394932,33251456,73646388
4707,84,$BRGE5,2014-03-31,40394932,33251456,73646388
4707,84,$BRGE5,2014-06-30,40394932,33251456,73646388
4707,84,$BRGE5,2014-09-30,40394932,33251456,73646388
4707,84,$BRGE5,2014-12-31,40394932,33251456,73646388
4707,84,$BRGE5,2015-03-31,40394932,33251456,73646388
4707,84,$BRGE5,2015-06-30,40394932,33251456,73646388
4707,84,$BRGE5,2015-09-30,40394932,33251456,73646388
4707,84,$BRGE5,2015-12-31,40394932,33251456,73646388
4707,84,$BRGE5,2016-03-31,40394932,33251456,73646388
4707,84,$BRGE5,2016-06-30,40394932,33251456,73646388
4707,84,$BRGE5,2016-09-30,40394932,33251456,73646388
4707,84,$BRGE5,2016-12-31,40394932,33251456,73646388
4707,84,$BRGE5,2017-03-31,40394932,33251456,73646388
4707,84,$BRGE5,2017-06-30,40394932,33251456,73646388
4707,84,$BRGE5,2017-09-30,40394932,33251456,73646388
4707,84,$BRGE5,2017-12-31,40394932,33251456,73646388
4707,84,$BRGE5,2018-03-31,40394932,33251456,73646388
4707,84,$BRGE5,2018-06-30,40394932,33251456,73646388
4707,84,$BRGE5,2018-09-30,40394932,33251456,73646388
4707,84,$BRGE5,2018-12-31,40394932,33251456,73646388
4707,84,$BRGE5,2019-03-31,40394932,33251456,73646388
4707,84,$BRGE5,2019-06-30,40394932,33251456,73646388
4707,84,$BRGE5,2019-09-30,40394932,33251456,73646388
4707,84,$BRGE5,2019-12-31,40394932,33251456,73646388
4707,84,$BRGE5,2020-03-31,40394932,33251456,73646388
4707,84,$BRGE5,2020-06-30,40394932,33251456,73646388
4707,84,$BRGE5,2020-09-30,40394932,33251456,73646388
4707,85,$BRGE11,2010-12-31,40394932,33251456,73646388
4707,85,$BRGE11,2011-03-31,40394932,33251456,73646388
4707,85,$BRGE11,2011-06-30,40394932,33251456,73646388
4707,85,$BRGE11,2011-09-30,40394932,33251456,73646388
4707,85,$BRGE11,2011-12-31,40394932,33251456,73646388
4707,85,$BRGE11,2012-03-31,40394932,33251456,73646388
4707,85,$BRGE11,2012-06-30,40394932,33251456,73646388
4707,85,$BRGE11,2012-09-30,40394932,33251456,73646388
4707,85,$BRGE11,2012-12-31,40394932,33251456,73646388
4707,85,$BRGE11,2013-03-31,40394932,33251456,73646388
4707,85,$BRGE11,2013-06-30,40394932,33251456,73646388
4707,85,$BRGE11,2013-09-30,40394932,33251456,73646388
4707,85,$BRGE11,2013-12-31,40394932,33251456,73646388
4707,85,$BRGE11,2014-03-31,40394932,33251456,73646388
4707,85,$BRGE11,2014-06-30,40394932,33251456,73646388
4707,85,$BRGE11,2014-09-30,40394932,33251456,73646388
4707,85,$BRGE11,2014-12-31,40394932,33251456,73646388
4707,85,$BRGE11,2015-03-31,40394932,33251456,73646388
4707,85,$BRGE11,2015-06-30,40394932,33251456,73646388
4707,85,$BRGE11,2015-09-30,40394932,33251456,73646388
4707,85,$BRGE11,2015-12-31,40394932,33251456,73646388
4707,85,$BRGE11,2016-03-31,40394932,33251456,73646388
4707,85,$BRGE11,2016-06-30,40394932,33251456,73646388
4707,85,$BRGE11,2016-09-30,40394932,33251456,73646388
4707,85,$BRGE11,2016-12-31,40394932,33251456,73646388
4707,85,$BRGE11,2017-03-31,40394932,33251456,73646388
4707,85,$BRGE11,2017-06-30,40394932,33251456,73646388
4707,85,$BRGE11,2017-09-30,40394932,33251456,73646388
4707,85,$BRGE11,2017-12-31,40394932,33251456,73646388
4707,85,$BRGE11,2018-03-31,40394932,33251456,73646388
4707,85,$BRGE11,2018-06-30,40394932,33251456,73646388
4707,85,$BRGE11,2018-09-30,40394932,33251456,73646388
4707,85,$BRGE11,2018-12-31,40394932,33251456,73646388
4707,85,$BRGE11,2019-03-31,40394932,33251456,73646388
4707,85,$BRGE11,2019-06-30,40394932,33251456,73646388
4707,85,$BRGE11,2019-09-30,40394932,33251456,73646388
4707,85,$BRGE11,2019-12-31,40394932,33251456,73646388
4707,85,$BRGE11,2020-03-31,40394932,33251456,73646388
4707,85,$BRGE11,2020-06-30,40394932,33251456,73646388
4707,85,$BRGE11,2020-09-30,40394932,33251456,73646388
4707,86,$BRGE7,2010-12-31,40394932,33251456,73646388
4707,86,$BRGE7,2011-03-31,40394932,33251456,73646388
4707,86,$BRGE7,2011-06-30,40394932,33251456,73646388
4707,86,$BRGE7,2011-09-30,40394932,33251456,73646388
4707,86,$BRGE7,2011-12-31,40394932,33251456,73646388
4707,86,$BRGE7,2012-03-31,40394932,33251456,73646388
4707,86,$BRGE7,2012-06-30,40394932,33251456,73646388
4707,86,$BRGE7,2012-09-30,40394932,33251456,73646388
4707,86,$BRGE7,2012-12-31,40394932,33251456,73646388
4707,86,$BRGE7,2013-03-31,40394932,33251456,73646388
4707,86,$BRGE7,2013-06-30,40394932,33251456,73646388
4707,86,$BRGE7,2013-09-30,40394932,33251456,73646388
4707,86,$BRGE7,2013-12-31,40394932,33251456,73646388
4707,86,$BRGE7,2014-03-31,40394932,33251456,73646388
4707,86,$BRGE7,2014-06-30,40394932,33251456,73646388
4707,86,$BRGE7,2014-09-30,40394932,33251456,73646388
4707,86,$BRGE7,2014-12-31,40394932,33251456,73646388
4707,86,$BRGE7,2015-03-31,40394932,33251456,73646388
4707,86,$BRGE7,2015-06-30,40394932,33251456,73646388
4707,86,$BRGE7,2015-09-30,40394932,33251456,73646388
4707,86,$BRGE7,2015-12-31,40394932,33251456,73646388
4707,86,$BRGE7,2016-03-31,40394932,33251456,73646388
4707,86,$BRGE7,2016-06-30,40394932,33251456,73646388
4707,86,$BRGE7,2016-09-30,40394932,33251456,73646388
4707,86,$BRGE7,2016-12-31,40394932,33251456,73646388
4707,86,$BRGE7,2017-03-31,40394932,33251456,73646388
4707,86,$BRGE7,2017-06-30,40394932,33251456,73646388
4707,86,$BRGE7,2017-09-30,40394932,33251456,73646388
4707,86,$BRGE7,2017-12-31,40394932,33251456,73646388
4707,86,$BRGE7,2018-03-31,40394932,33251456,73646388
4707,86,$BRGE7,2018-06-30,40394932,33251456,73646388
4707,86,$BRGE7,2018-09-30,40394932,33251456,73646388
4707,86,$BRGE7,2018-12-31,40394932,33251456,73646388
4707,86,$BRGE7,2019-03-31,40394932,33251456,73646388
4707,86,$BRGE7,2019-06-30,40394932,33251456,73646388
4707,86,$BRGE7,2019-09-30,40394932,33251456,73646388
4707,86,$BRGE7,2019-12-31,40394932,33251456,73646388
4707,86,$BRGE7,2020-03-31,40394932,33251456,73646388
4707,86,$BRGE7,2020-06-30,40394932,33251456,73646388
4707,86,$BRGE7,2020-09-30,40394932,33251456,73646388
4723,87,$CALI3,2010-12-31,23,46,69
4723,87,$CALI3,2011-03-31,23000,46000,69000
4723,87,$CALI3,2011-06-30,23000,46000,69000
4723,87,$CALI3,2011-09-30,124040,248079,372119
4723,87,$CALI3,2011-12-31,124040,248079,372119
4723,87,$CALI3,2012-03-31,124040,248079,372119
4723,87,$CALI3,2012-06-30,124040,248079,372119
4723,87,$CALI3,2012-09-30,124040,248079,372119
4723,87,$CALI3,2012-12-31,124040,248079,372119
4723,87,$CALI3,2013-03-31,124040,248079,372119
4723,87,$CALI3,2013-06-30,124040,248079,372119
4723,87,$CALI3,2013-09-30,124040,248079,372119
4723,87,$CALI3,2013-12-31,124040,248079,372119
4723,87,$CALI3,2014-03-31,124040,248079,372119
4723,87,$CALI3,2014-06-30,124040,248079,372119
4723,87,$CALI3,2014-09-30,124040,248079,372119
4723,87,$CALI3,2014-12-31,124040,248079,372119
4723,87,$CALI3,2015-03-31,124040,248079,372119
4723,87,$CALI3,2015-06-30,124040,248079,372119
4723,87,$CALI3,2015-09-30,124040,248079,372119
4723,87,$CALI3,2015-12-31,124040,248079,372119
4723,87,$CALI3,2016-03-31,124040,248079,372119
4723,87,$CALI3,2016-06-30,124040,248079,372119
4723,87,$CALI3,2016-09-30,124040,248079,372119
4723,87,$CALI3,2016-12-31,124040,248079,372119
4723,87,$CALI3,2017-03-31,124040,248079,372119
4723,87,$CALI3,2017-06-30,124040,248079,372119
4723,87,$CALI3,2017-09-30,124040,248079,372119
4723,87,$CALI3,2017-12-31,124040,248079,372119
4723,87,$CALI3,2018-03-31,124040,248079,372119
4723,87,$CALI3,2018-06-30,124040,248079,372119
4723,87,$CALI3,2018-09-30,124040,248079,372119
4723,87,$CALI3,2018-12-31,124040,248079,372119
4723,87,$CALI3,2019-03-31,124040,248079,372119
4723,87,$CALI3,2019-06-30,124040,248079,372119
4723,87,$CALI3,2019-09-30,124040,248079,372119
4723,87,$CALI3,2019-12-31,124040,248079,372119
4723,87,$CALI3,2020-03-31,124040,248079,372119
4723,87,$CALI3,2020-06-30,124040,248079,372119
4723,87,$CALI3,2020-09-30,124040,248079,372119
4723,88,$CAL4,2010-12-31,23,46,69
4723,88,$CAL4,2011-03-31,23000,46000,69000
4723,88,$CAL4,2011-06-30,23000,46000,69000
4723,88,$CAL4,2011-09-30,124040,248079,372119
4723,88,$CAL4,2011-12-31,124040,248079,372119
4723,88,$CAL4,2012-03-31,124040,248079,372119
4723,88,$CAL4,2012-06-30,124040,248079,372119
4723,88,$CAL4,2012-09-30,124040,248079,372119
4723,88,$CAL4,2012-12-31,124040,248079,372119
4723,88,$CAL4,2013-03-31,124040,248079,372119
4723,88,$CAL4,2013-06-30,124040,248079,372119
4723,88,$CAL4,2013-09-30,124040,248079,372119
4723,88,$CAL4,2013-12-31,124040,248079,372119
4723,88,$CAL4,2014-03-31,124040,248079,372119
4723,88,$CAL4,2014-06-30,124040,248079,372119
4723,88,$CAL4,2014-09-30,124040,248079,372119
4723,88,$CAL4,2014-12-31,124040,248079,372119
4723,88,$CAL4,2015-03-31,124040,248079,372119
4723,88,$CAL4,2015-06-30,124040,248079,372119
4723,88,$CAL4,2015-09-30,124040,248079,372119
4723,88,$CAL4,2015-12-31,124040,248079,372119
4723,88,$CAL4,2016-03-31,124040,248079,372119
4723,88,$CAL4,2016-06-30,124040,248079,372119
4723,88,$CAL4,2016-09-30,124040,248079,372119
4723,88,$CAL4,2016-12-31,124040,248079,372119
4723,88,$CAL4,2017-03-31,124040,248079,372119
4723,88,$CAL4,2017-06-30,124040,248079,372119
4723,88,$CAL4,2017-09-30,124040,248079,372119
4723,88,$CAL4,2017-12-31,124040,248079,372119
4723,88,$CAL4,2018-03-31,124040,248079,372119
4723,88,$CAL4,2018-06-30,124040,248079,372119
4723,88,$CAL4,2018-09-30,124040,248079,372119
4723,88,$CAL4,2018-12-31,124040,248079,372119
4723,88,$CAL4,2019-03-31,124040,248079,372119
4723,88,$CAL4,2019-06-30,124040,248079,372119
4723,88,$CAL4,2019-09-30,124040,248079,372119
4723,88,$CAL4,2019-12-31,124040,248079,372119
4723,88,$CAL4,2020-03-31,124040,248079,372119
4723,88,$CAL4,2020-06-30,124040,248079,372119
4723,88,$CAL4,2020-09-30,124040,248079,372119
4782,66,$MEND3,2010-12-31,6977,3332,10309
4782,66,$MEND3,2011-03-31,6977,3332,10309
4782,66,$MEND3,2011-06-30,6977,3332,10309
4782,66,$MEND3,2011-09-30,6977,3332,10309
4782,66,$MEND3,2011-12-31,6977,3332,10309
4782,66,$MEND3,2012-03-31,6977,3332,10309
4782,66,$MEND3,2012-06-30,6977,3332,10309
4782,66,$MEND3,2012-09-30,6977,3332,10309
4782,66,$MEND3,2012-12-31,6977,3332,10309
4782,66,$MEND3,2013-03-31,6977,3332,10309
4782,66,$MEND3,2013-06-30,6977,3332,10309
4782,66,$MEND3,2013-09-30,6977,3332,10309
4782,66,$MEND3,2013-12-31,6977,3332,10309
4782,66,$MEND3,2014-03-31,6977,3332,10309
4782,66,$MEND3,2014-06-30,6977,3332,10309
4782,66,$MEND3,2014-09-30,6977,3332,10309
4782,66,$MEND3,2014-12-31,6977,3332,10309
4782,66,$MEND3,2015-03-31,6977,3332,10309
4782,66,$MEND3,2015-06-30,6977,3332,10309
4782,66,$MEND3,2015-09-30,6977,3332,10309
4782,66,$MEND3,2015-12-31,6977,3332,10309
4782,66,$MEND3,2016-03-31,6977,3332,10309
4782,66,$MEND3,2016-06-30,6977,3332,10309
4782,66,$MEND3,2016-09-30,6977,3332,10309
4782,66,$MEND3,2016-12-31,6977,3332,10309
4782,66,$MEND3,2017-03-31,6977,3332,10309
4782,66,$MEND3,2017-06-30,6977,3332,10309
4782,66,$MEND3,2017-09-30,6977,3332,10309
4782,66,$MEND3,2017-12-31,6977,3332,10309
4782,66,$MEND3,2018-03-31,6977,3332,10309
4782,66,$MEND3,2018-06-30,6977,3332,10309
4782,66,$MEND3,2018-09-30,6977,3332,10309
4782,66,$MEND3,2018-12-31,6977,3332,10309
4782,66,$MEND3,2019-03-31,6977,3332,10309
4782,66,$MEND3,2019-06-30,6977,3332,10309
4782,66,$MEND3,2019-09-30,6977,3332,10309
4782,66,$MEND3,2019-12-31,6977,3332,10309
4782,66,$MEND3,2020-03-31,6977,3332,10309
4782,66,$MEND3,2020-06-30,6977,3332,10309
4782,67,$MEND6,2010-12-31,6977,3332,10309
4782,67,$MEND6,2011-03-31,6977,3332,10309
4782,67,$MEND6,2011-06-30,6977,3332,10309
4782,67,$MEND6,2011-09-30,6977,3332,10309
4782,67,$MEND6,2011-12-31,6977,3332,10309
4782,67,$MEND6,2012-03-31,6977,3332,10309
4782,67,$MEND6,2012-06-30,6977,3332,10309
4782,67,$MEND6,2012-09-30,6977,3332,10309
4782,67,$MEND6,2012-12-31,6977,3332,10309
4782,67,$MEND6,2013-03-31,6977,3332,10309
4782,67,$MEND6,2013-06-30,6977,3332,10309
4782,67,$MEND6,2013-09-30,6977,3332,10309
4782,67,$MEND6,2013-12-31,6977,3332,10309
4782,67,$MEND6,2014-03-31,6977,3332,10309
4782,67,$MEND6,2014-06-30,6977,3332,10309
4782,67,$MEND6,2014-09-30,6977,3332,10309
4782,67,$MEND6,2014-12-31,6977,3332,10309
4782,67,$MEND6,2015-03-31,6977,3332,10309
4782,67,$MEND6,2015-06-30,6977,3332,10309
4782,67,$MEND6,2015-09-30,6977,3332,10309
4782,67,$MEND6,2015-12-31,6977,3332,10309
4782,67,$MEND6,2016-03-31,6977,3332,10309
4782,67,$MEND6,2016-06-30,6977,3332,10309
4782,67,$MEND6,2016-09-30,6977,3332,10309
4782,67,$MEND6,2016-12-31,6977,3332,10309
4782,67,$MEND6,2017-03-31,6977,3332,10309
4782,67,$MEND6,2017-06-30,6977,3332,10309
4782,67,$MEND6,2017-09-30,6977,3332,10309
4782,67,$MEND6,2017-12-31,6977,3332,10309
4782,67,$MEND6,2018-03-31,6977,3332,10309
4782,67,$MEND6,2018-06-30,6977,3332,10309
4782,67,$MEND6,2018-09-30,6977,3332,10309
4782,67,$MEND6,2018-12-31,6977,3332,10309
4782,67,$MEND6,2019-03-31,6977,3332,10309
4782,67,$MEND6,2019-06-30,6977,3332,10309
4782,67,$MEND6,2019-09-30,6977,3332,10309
4782,67,$MEND6,2019-12-31,6977,3332,10309
4782,67,$MEND6,2020-03-31,6977,3332,10309
4782,67,$MEND6,2020-06-30,6977,3332,10309
4782,68,$MEND5,2010-12-31,6977,3332,10309
4782,68,$MEND5,2011-03-31,6977,3332,10309
4782,68,$MEND5,2011-06-30,6977,3332,10309
4782,68,$MEND5,2011-09-30,6977,3332,10309
4782,68,$MEND5,2011-12-31,6977,3332,10309
4782,68,$MEND5,2012-03-31,6977,3332,10309
4782,68,$MEND5,2012-06-30,6977,3332,10309
4782,68,$MEND5,2012-09-30,6977,3332,10309
4782,68,$MEND5,2012-12-31,6977,3332,10309
4782,68,$MEND5,2013-03-31,6977,3332,10309
4782,68,$MEND5,2013-06-30,6977,3332,10309
4782,68,$MEND5,2013-09-30,6977,3332,10309
4782,68,$MEND5,2013-12-31,6977,3332,10309
4782,68,$MEND5,2014-03-31,6977,3332,10309
4782,68,$MEND5,2014-06-30,6977,3332,10309
4782,68,$MEND5,2014-09-30,6977,3332,10309
4782,68,$MEND5,2014-12-31,6977,3332,10309
4782,68,$MEND5,2015-03-31,6977,3332,10309
4782,68,$MEND5,2015-06-30,6977,3332,10309
4782,68,$MEND5,2015-09-30,6977,3332,10309
4782,68,$MEND5,2015-12-31,6977,3332,10309
4782,68,$MEND5,2016-03-31,6977,3332,10309
4782,68,$MEND5,2016-06-30,6977,3332,10309
4782,68,$MEND5,2016-09-30,6977,3332,10309
4782,68,$MEND5,2016-12-31,6977,3332,10309
4782,68,$MEND5,2017-03-31,6977,3332,10309
4782,68,$MEND5,2017-06-30,6977,3332,10309
4782,68,$MEND5,2017-09-30,6977,3332,10309
4782,68,$MEND5,2017-12-31,6977,3332,10309
4782,68,$MEND5,2018-03-31,6977,3332,10309
4782,68,$MEND5,2018-06-30,6977,3332,10309
4782,68,$MEND5,2018-09-30,6977,3332,10309
4782,68,$MEND5,2018-12-31,6977,3332,10309
4782,68,$MEND5,2019-03-31,6977,3332,10309
4782,68,$MEND5,2019-06-30,6977,3332,10309
4782,68,$MEND5,2019-09-30,6977,3332,10309
4782,68,$MEND5,2019-12-31,6977,3332,10309
4782,68,$MEND5,2020-03-31,6977,3332,10309
4782,68,$MEND5,2020-06-30,6977,3332,10309
4820,103,$BRKM3,2010-12-31,451669,349996,801665
4820,103,$BRKM3,2011-03-31,451669063,349996554,801665617
4820,103,$BRKM3,2011-06-30,451669063,349996554,801665617
4820,103,$BRKM3,2011-09-30,451669063,349996554,801665617
4820,103,$BRKM3,2011-12-31,451669,349996,801665
4820,103,$BRKM3,2012-03-31,451669063,349996554,801665617
4820,103,$BRKM3,2012-06-30,451668652,347299538,798968190
4820,103,$BRKM3,2012-09-30,451668652,344441938,796110590
4820,103,$BRKM3,2012-12-31,451668652,345596696,797265348
4820,103,$BRKM3,2013-03-31,451668652,345596696,797265348
4820,103,$BRKM3,2013-06-30,451668652,345596696,797265348
4820,103,$BRKM3,2013-09-30,451668652,344441938,796110590
4820,103,$BRKM3,2013-12-31,451668652,345596696,797265348
4820,103,$BRKM3,2014-03-31,451668652,345596696,797265348
4820,103,$BRKM3,2014-06-30,451668652,345596696,797265348
4820,103,$BRKM3,2014-09-30,451668652,345596696,797265348
4820,103,$BRKM3,2014-12-31,451668652,345596696,797265348
4820,103,$BRKM3,2015-03-31,451668652,345596696,797265348
4820,103,$BRKM3,2015-06-30,451668652,345596696,797265348
4820,103,$BRKM3,2015-09-30,451668652,345596696,797265348
4820,103,$BRKM3,2015-12-31,451668652,345596596,797265248
4820,103,$BRKM3,2016-03-31,451668652,345596596,797265248
4820,103,$BRKM3,2016-06-30,451668652,345596596,797265248
4820,103,$BRKM3,2016-09-30,451668652,345588952,797257604
4820,103,$BRKM3,2016-12-31,451668652,345588952,797257604
4820,103,$BRKM3,2017-03-31,451668652,345588952,797257604
4820,103,$BRKM3,2017-06-30,451668652,345588952,797257604
4820,103,$BRKM3,2017-09-30,451668652,345588952,797257604
4820,103,$BRKM3,2017-12-31,451668652,345588952,797257604
4820,103,$BRKM3,2018-03-31,451668652,345549952,797218604
4820,103,$BRKM3,2018-06-30,451668652,345549902,797218554
4820,103,$BRKM3,2018-09-30,451668652,345549902,797218554
4820,103,$BRKM3,2018-12-31,451668652,345549902,797218554
4820,103,$BRKM3,2019-03-31,451668652,345549902,797218554
4820,103,$BRKM3,2019-06-30,451668652,345549902,797218554
4820,103,$BRKM3,2019-09-30,451668652,345549902,797218554
4820,103,$BRKM3,2019-12-31,451668652,345549902,797218554
4820,103,$BRKM3,2020-03-31,451668652,345549902,797218554
4820,103,$BRKM3,2020-06-30,451668652,345549902,797218554
4820,103,$BRKM3,2020-09-30,451668652,345549902,797218554
4820,104,$BRKM5,2010-12-31,451669,349996,801665
4820,104,$BRKM5,2011-03-31,451669063,349996554,801665617
4820,104,$BRKM5,2011-06-30,451669063,349996554,801665617
4820,104,$BRKM5,2011-09-30,451669063,349996554,801665617
4820,104,$BRKM5,2011-12-31,451669,349996,801665
4820,104,$BRKM5,2012-03-31,451669063,349996554,801665617
4820,104,$BRKM5,2012-06-30,451668652,347299538,798968190
4820,104,$BRKM5,2012-09-30,451668652,344441938,796110590
4820,104,$BRKM5,2012-12-31,451668652,345596696,797265348
4820,104,$BRKM5,2013-03-31,451668652,345596696,797265348
4820,104,$BRKM5,2013-06-30,451668652,345596696,797265348
4820,104,$BRKM5,2013-09-30,451668652,344441938,796110590
4820,104,$BRKM5,2013-12-31,451668652,345596696,797265348
4820,104,$BRKM5,2014-03-31,451668652,345596696,797265348
4820,104,$BRKM5,2014-06-30,451668652,345596696,797265348
4820,104,$BRKM5,2014-09-30,451668652,345596696,797265348
4820,104,$BRKM5,2014-12-31,451668652,345596696,797265348
4820,104,$BRKM5,2015-03-31,451668652,345596696,797265348
4820,104,$BRKM5,2015-06-30,451668652,345596696,797265348
4820,104,$BRKM5,2015-09-30,451668652,345596696,797265348
4820,104,$BRKM5,2015-12-31,451668652,345596596,797265248
4820,104,$BRKM5,2016-03-31,451668652,345596596,797265248
4820,104,$BRKM5,2016-06-30,451668652,345596596,797265248
4820,104,$BRKM5,2016-09-30,451668652,345588952,797257604
4820,104,$BRKM5,2016-12-31,451668652,345588952,797257604
4820,104,$BRKM5,2017-03-31,451668652,345588952,797257604
4820,104,$BRKM5,2017-06-30,451668652,345588952,797257604
4820,104,$BRKM5,2017-09-30,451668652,345588952,797257604
4820,104,$BRKM5,2017-12-31,451668652,345588952,797257604
4820,104,$BRKM5,2018-03-31,451668652,345549952,797218604
4820,104,$BRKM5,2018-06-30,451668652,345549902,797218554
4820,104,$BRKM5,2018-09-30,451668652,345549902,797218554
4820,104,$BRKM5,2018-12-31,451668652,345549902,797218554
4820,104,$BRKM5,2019-03-31,451668652,345549902,797218554
4820,104,$BRKM5,2019-06-30,451668652,345549902,797218554
4820,104,$BRKM5,2019-09-30,451668652,345549902,797218554
4820,104,$BRKM5,2019-12-31,451668652,345549902,797218554
4820,104,$BRKM5,2020-03-31,451668652,345549902,797218554
4820,104,$BRKM5,2020-06-30,451668652,345549902,797218554
4820,104,$BRKM5,2020-09-30,451668652,345549902,797218554
4820,105,$BRKM6,2010-12-31,451669,349996,801665
4820,105,$BRKM6,2011-03-31,451669063,349996554,801665617
4820,105,$BRKM6,2011-06-30,451669063,349996554,801665617
4820,105,$BRKM6,2011-09-30,451669063,349996554,801665617
4820,105,$BRKM6,2011-12-31,451669,349996,801665
4820,105,$BRKM6,2012-03-31,451669063,349996554,801665617
4820,105,$BRKM6,2012-06-30,451668652,347299538,798968190
4820,105,$BRKM6,2012-09-30,451668652,344441938,796110590
4820,105,$BRKM6,2012-12-31,451668652,345596696,797265348
4820,105,$BRKM6,2013-03-31,451668652,345596696,797265348
4820,105,$BRKM6,2013-06-30,451668652,345596696,797265348
4820,105,$BRKM6,2013-09-30,451668652,344441938,796110590
4820,105,$BRKM6,2013-12-31,451668652,345596696,797265348
4820,105,$BRKM6,2014-03-31,451668652,345596696,797265348
4820,105,$BRKM6,2014-06-30,451668652,345596696,797265348
4820,105,$BRKM6,2014-09-30,451668652,345596696,797265348
4820,105,$BRKM6,2014-12-31,451668652,345596696,797265348
4820,105,$BRKM6,2015-03-31,451668652,345596696,797265348
4820,105,$BRKM6,2015-06-30,451668652,345596696,797265348
4820,105,$BRKM6,2015-09-30,451668652,345596696,797265348
4820,105,$BRKM6,2015-12-31,451668652,345596596,797265248
4820,105,$BRKM6,2016-03-31,451668652,345596596,797265248
4820,105,$BRKM6,2016-06-30,451668652,345596596,797265248
4820,105,$BRKM6,2016-09-30,451668652,345588952,797257604
4820,105,$BRKM6,2016-12-31,451668652,345588952,797257604
4820,105,$BRKM6,2017-03-31,451668652,345588952,797257604
4820,105,$BRKM6,2017-06-30,451668652,345588952,797257604
4820,105,$BRKM6,2017-09-30,451668652,345588952,797257604
4820,105,$BRKM6,2017-12-31,451668652,345588952,797257604
4820,105,$BRKM6,2018-03-31,451668652,345549952,797218604
4820,105,$BRKM6,2018-06-30,451668652,345549902,797218554
4820,105,$BRKM6,2018-09-30,451668652,345549902,797218554
4820,105,$BRKM6,2018-12-31,451668652,345549902,797218554
4820,105,$BRKM6,2019-03-31,451668652,345549902,797218554
4820,105,$BRKM6,2019-06-30,451668652,345549902,797218554
4820,105,$BRKM6,2019-09-30,451668652,345549902,797218554
4820,105,$BRKM6,2019-12-31,451668652,345549902,797218554
4820,105,$BRKM6,2020-03-31,451668652,345549902,797218554
4820,105,$BRKM6,2020-06-30,451668652,345549902,797218554
4820,105,$BRKM6,2020-09-30,451668652,345549902,797218554
4863,89,$CORR3,2010-12-31,7815,15338,23153
4863,89,$CORR3,2011-03-31,7815,15338,23153
4863,89,$CORR3,2011-06-30,7815,15338,23153
4863,89,$CORR3,2011-09-30,7815,15338,23153
4863,89,$CORR3,2011-12-31,7815,15338,23153
4863,89,$CORR3,2012-03-31,7815,15338,23153
4863,89,$CORR3,2012-06-30,7815,15338,23153
4863,89,$CORR3,2012-09-30,7815,15338,23153
4863,89,$CORR3,2012-12-31,7815,15338,23153
4863,89,$CORR3,2013-03-31,7815,15338,23153
4863,89,$CORR3,2013-06-30,7815,15338,23153
4863,89,$CORR3,2013-09-30,7815,15338,23153
4863,89,$CORR3,2013-12-31,7815,15338,23153
4863,89,$CORR3,2014-03-30,7815,15338,23153
4863,89,$CORR3,2014-03-31,7815,15338,23153
4863,89,$CORR3,2014-06-30,7815,15338,23153
4863,89,$CORR3,2014-09-30,7815,15338,23153
4863,89,$CORR3,2014-12-31,7815,15338,23153
4863,89,$CORR3,2015-03-31,7815,15338,23153
4863,89,$CORR3,2015-06-30,7815,15338,23153
4863,89,$CORR3,2015-09-30,7815,15338,23153
4863,89,$CORR3,2015-12-31,7815,15338,23153
4863,89,$CORR3,2016-03-31,7815,15338,23153
4863,89,$CORR3,2016-06-30,7815,15338,23153
4863,89,$CORR3,2016-09-30,7815,15338,23153
4863,89,$CORR3,2016-12-31,7815,15338,23153
4863,89,$CORR3,2017-03-31,7815,15338,23153
4863,89,$CORR3,2017-06-30,7815,15338,23153
4863,89,$CORR3,2017-09-30,7815,15338,23153
4863,89,$CORR3,2017-12-31,7815,15338,23153
4863,89,$CORR3,2018-03-31,7815,15338,23153
4863,89,$CORR3,2018-06-30,7815,15338,23153
4863,89,$CORR3,2018-09-30,7815,15338,23153
4863,89,$CORR3,2018-12-31,7815,15338,23153
4863,89,$CORR3,2019-03-31,8,15,23
4863,89,$CORR3,2019-06-30,7815,15338,23153
4863,89,$CORR3,2019-09-30,7815,15338,23153
4863,89,$CORR3,2019-12-31,7815,15338,23153
4863,89,$CORR3,2020-03-31,7815,15338,23153
4863,89,$CORR3,2020-06-30,7815,15338,23153
4863,89,$CORR3,2020-09-30,7815,15338,23153
4863,90,$CORR4,2010-12-31,7815,15338,23153
4863,90,$CORR4,2011-03-31,7815,15338,23153
4863,90,$CORR4,2011-06-30,7815,15338,23153
4863,90,$CORR4,2011-09-30,7815,15338,23153
4863,90,$CORR4,2011-12-31,7815,15338,23153
4863,90,$CORR4,2012-03-31,7815,15338,23153
4863,90,$CORR4,2012-06-30,7815,15338,23153
4863,90,$CORR4,2012-09-30,7815,15338,23153
4863,90,$CORR4,2012-12-31,7815,15338,23153
4863,90,$CORR4,2013-03-31,7815,15338,23153
4863,90,$CORR4,2013-06-30,7815,15338,23153
4863,90,$CORR4,2013-09-30,7815,15338,23153
4863,90,$CORR4,2013-12-31,7815,15338,23153
4863,90,$CORR4,2014-03-30,7815,15338,23153
4863,90,$CORR4,2014-03-31,7815,15338,23153
4863,90,$CORR4,2014-06-30,7815,15338,23153
4863,90,$CORR4,2014-09-30,7815,15338,23153
4863,90,$CORR4,2014-12-31,7815,15338,23153
4863,90,$CORR4,2015-03-31,7815,15338,23153
4863,90,$CORR4,2015-06-30,7815,15338,23153
4863,90,$CORR4,2015-09-30,7815,15338,23153
4863,90,$CORR4,2015-12-31,7815,15338,23153
4863,90,$CORR4,2016-03-31,7815,15338,23153
4863,90,$CORR4,2016-06-30,7815,15338,23153
4863,90,$CORR4,2016-09-30,7815,15338,23153
4863,90,$CORR4,2016-12-31,7815,15338,23153
4863,90,$CORR4,2017-03-31,7815,15338,23153
4863,90,$CORR4,2017-06-30,7815,15338,23153
4863,90,$CORR4,2017-09-30,7815,15338,23153
4863,90,$CORR4,2017-12-31,7815,15338,23153
4863,90,$CORR4,2018-03-31,7815,15338,23153
4863,90,$CORR4,2018-06-30,7815,15338,23153
4863,90,$CORR4,2018-09-30,7815,15338,23153
4863,90,$CORR4,2018-12-31,7815,15338,23153
4863,90,$CORR4,2019-03-31,8,15,23
4863,90,$CORR4,2019-06-30,7815,15338,23153
4863,90,$CORR4,2019-09-30,7815,15338,23153
4863,90,$CORR4,2019-12-31,7815,15338,23153
4863,90,$CORR4,2020-03-31,7815,15338,23153
4863,90,$CORR4,2020-06-30,7815,15338,23153
4863,90,$CORR4,2020-09-30,7815,15338,23153
5207,92,$DOHL3,2010-12-31,3631,1412,5043
5207,92,$DOHL3,2011-03-31,3631,1412,5043
5207,92,$DOHL3,2011-06-30,36312,14118,50430
5207,92,$DOHL3,2011-09-30,36312,14118,50430
5207,92,$DOHL3,2011-12-31,36311880,14118310,50430190
5207,92,$DOHL3,2012-03-31,36312,14118,50430
5207,92,$DOHL3,2012-06-30,36312,14118,50430
5207,92,$DOHL3,2012-09-30,36312,14118,50430
5207,92,$DOHL3,2012-12-31,36311880,14118310,50430190
5207,92,$DOHL3,2013-03-31,36311880,14118310,50430190
5207,92,$DOHL3,2013-06-30,36311880,14118310,50430190
5207,92,$DOHL3,2013-09-30,36311880,14118310,50430190
5207,92,$DOHL3,2013-12-31,36311880,14118310,50430190
5207,92,$DOHL3,2014-03-31,36311880,14118310,50430190
5207,92,$DOHL3,2014-06-30,43574256,16941972,60516228
5207,92,$DOHL3,2014-09-30,43574256,16941972,60516228
5207,92,$DOHL3,2014-12-31,43574256,16941972,60516228
5207,92,$DOHL3,2015-03-31,43574256,16941972,60516228
5207,92,$DOHL3,2015-06-30,43574256,16941972,60516228
5207,92,$DOHL3,2015-09-30,43574256,16941972,60516228
5207,92,$DOHL3,2015-12-31,43574256,16941972,60516228
5207,92,$DOHL3,2016-03-31,43574256,16941972,60516228
5207,92,$DOHL3,2016-06-30,43574256,16941972,60516228
5207,92,$DOHL3,2016-09-30,43574256,16941972,60516228
5207,92,$DOHL3,2016-12-31,43574256,16941972,60516228
5207,92,$DOHL3,2017-03-31,43574256,16941972,60516228
5207,92,$DOHL3,2017-06-30,43574256,16941972,60516228
5207,92,$DOHL3,2017-09-30,43574256,16941972,60516228
5207,92,$DOHL3,2017-12-31,43574256,16941972,60516228
5207,92,$DOHL3,2018-03-31,43574256,16941972,60516228
5207,92,$DOHL3,2018-06-30,43574256,16941972,60516228
5207,92,$DOHL3,2018-09-30,43574256,16941972,60516228
5207,92,$DOHL3,2018-12-31,43574256,16941972,60516228
5207,92,$DOHL3,2019-03-31,43574256,16941972,60516228
5207,92,$DOHL3,2019-06-30,43574256,16941972,60516228
5207,92,$DOHL3,2019-09-30,43574256,16941972,60516228
5207,92,$DOHL3,2019-12-31,43574256,16941972,60516228
5207,92,$DOHL3,2020-03-31,43574256,16941972,60516228
5207,92,$DOHL3,2020-06-30,43574256,16941972,60516228
5207,92,$DOHL3,2020-09-30,54467820,21177465,75645285
5207,93,$DOHL4,2010-12-31,3631,1412,5043
5207,93,$DOHL4,2011-03-31,3631,1412,5043
5207,93,$DOHL4,2011-06-30,36312,14118,50430
5207,93,$DOHL4,2011-09-30,36312,14118,50430
5207,93,$DOHL4,2011-12-31,36311880,14118310,50430190
5207,93,$DOHL4,2012-03-31,36312,14118,50430
5207,93,$DOHL4,2012-06-30,36312,14118,50430
5207,93,$DOHL4,2012-09-30,36312,14118,50430
5207,93,$DOHL4,2012-12-31,36311880,14118310,50430190
5207,93,$DOHL4,2013-03-31,36311880,14118310,50430190
5207,93,$DOHL4,2013-06-30,36311880,14118310,50430190
5207,93,$DOHL4,2013-09-30,36311880,14118310,50430190
5207,93,$DOHL4,2013-12-31,36311880,14118310,50430190
5207,93,$DOHL4,2014-03-31,36311880,14118310,50430190
5207,93,$DOHL4,2014-06-30,43574256,16941972,60516228
5207,93,$DOHL4,2014-09-30,43574256,16941972,60516228
5207,93,$DOHL4,2014-12-31,43574256,16941972,60516228
5207,93,$DOHL4,2015-03-31,43574256,16941972,60516228
5207,93,$DOHL4,2015-06-30,43574256,16941972,60516228
5207,93,$DOHL4,2015-09-30,43574256,16941972,60516228
5207,93,$DOHL4,2015-12-31,43574256,16941972,60516228
5207,93,$DOHL4,2016-03-31,43574256,16941972,60516228
5207,93,$DOHL4,2016-06-30,43574256,16941972,60516228
5207,93,$DOHL4,2016-09-30,43574256,16941972,60516228
5207,93,$DOHL4,2016-12-31,43574256,16941972,60516228
5207,93,$DOHL4,2017-03-31,43574256,16941972,60516228
5207,93,$DOHL4,2017-06-30,43574256,16941972,60516228
5207,93,$DOHL4,2017-09-30,43574256,16941972,60516228
5207,93,$DOHL4,2017-12-31,43574256,16941972,60516228
5207,93,$DOHL4,2018-03-31,43574256,16941972,60516228
5207,93,$DOHL4,2018-06-30,43574256,16941972,60516228
5207,93,$DOHL4,2018-09-30,43574256,16941972,60516228
5207,93,$DOHL4,2018-12-31,43574256,16941972,60516228
5207,93,$DOHL4,2019-03-31,43574256,16941972,60516228
5207,93,$DOHL4,2019-06-30,43574256,16941972,60516228
5207,93,$DOHL4,2019-09-30,43574256,16941972,60516228
5207,93,$DOHL4,2019-12-31,43574256,16941972,60516228
5207,93,$DOHL4,2020-03-31,43574256,16941972,60516228
5207,93,$DOHL4,2020-06-30,43574256,16941972,60516228
5207,93,$DOHL4,2020-09-30,54467820,21177465,75645285
5258,96,$RADL3,2010-12-31,188320020,0,188320020
5258,96,$RADL3,2011-03-31,188320020,0,188320020
5258,96,$RADL3,2011-06-30,188320020,0,188320020
5258,96,$RADL3,2011-09-30,188320020,0,188320020
5258,96,$RADL3,2011-12-31,330386000,0,330386000
5258,96,$RADL3,2012-03-31,330386000,0,330386000
5258,96,$RADL3,2012-06-30,330386000,0,330386000
5258,96,$RADL3,2012-09-30,330386000,0,330386000
5258,96,$RADL3,2012-12-31,330386000,0,330386000
5258,96,$RADL3,2013-03-31,330386000,0,330386000
5258,96,$RADL3,2013-06-30,330386000,0,330386000
5258,96,$RADL3,2013-09-30,330386000,0,330386000
5258,96,$RADL3,2013-12-31,330386000,0,330386000
5258,96,$RADL3,2014-03-31,330386000,0,330386000
5258,96,$RADL3,2014-06-30,330386000,0,330386000
5258,96,$RADL3,2014-09-30,330386000,0,330386000
5258,96,$RADL3,2014-12-31,330386000,0,330386000
5258,96,$RADL3,2015-03-31,330386000,0,330386000
5258,96,$RADL3,2015-06-30,330386000,0,330386000
5258,96,$RADL3,2015-09-30,330386000,0,330386000
5258,96,$RADL3,2015-12-31,330386000,0,330386000
5258,96,$RADL3,2016-03-31,330386000,0,330386000
5258,96,$RADL3,2016-06-30,330386000,0,330386000
5258,96,$RADL3,2016-09-30,330386000,0,330386000
5258,96,$RADL3,2016-12-31,330386000,0,330386000
5258,96,$RADL3,2017-03-31,330386000,0,330386000
5258,96,$RADL3,2017-06-30,330386000,0,330386000
5258,96,$RADL3,2017-09-30,330386000,0,330386000
5258,96,$RADL3,2017-12-31,330386000,0,330386000
5258,96,$RADL3,2018-03-31,330386000,0,330386000
5258,96,$RADL3,2018-06-30,330386000,0,330386000
5258,96,$RADL3,2018-09-30,330386000,0,330386000
5258,96,$RADL3,2018-12-31,330386000,0,330386000
5258,96,$RADL3,2019-03-31,330386000,0,330386000
5258,96,$RADL3,2019-06-30,330386000,0,330386000
5258,96,$RADL3,2019-09-30,330386000,0,330386000
5258,96,$RADL3,2019-12-31,330386000,0,330386000
5258,96,$RADL3,2020-03-31,330386000,0,330386000
5258,96,$RADL3,2020-06-30,330386000,0,330386000
5258,96,$RADL3,2020-09-30,1651930000,0,1651930000
5312,97,$MNDL3,2010-12-31,24638,22763,47401
5312,97,$MNDL3,2011-03-31,24638,22763,47401
5312,97,$MNDL3,2011-06-30,147829,136577,284406
5312,97,$MNDL3,2011-09-30,147829,136577,284406
5312,97,$MNDL3,2011-12-31,147829050,136577028,284406078
5312,97,$MNDL3,2012-03-31,257090672,0,257090672
5312,97,$MNDL3,2012-06-30,297631213,0,297631213
5312,97,$MNDL3,2012-09-30,297631213,0,297631213
5312,97,$MNDL3,2012-12-31,297631213,0,297631213
5312,97,$MNDL3,2013-03-31,2480260,0,2480260
5312,97,$MNDL3,2013-06-30,2480260,0,2480260
5312,97,$MNDL3,2013-09-30,2480260,0,2480260
5312,97,$MNDL3,2013-12-31,2480260,0,2480260
5312,97,$MNDL3,2014-03-31,2480260,0,2480260
5312,97,$MNDL3,2014-06-30,2480260,0,2480260
5312,97,$MNDL3,2014-09-30,2480260,0,2480260
5312,97,$MNDL3,2014-12-31,2480260,0,2480260
5312,97,$MNDL3,2015-03-31,2480260,0,2480260
5312,97,$MNDL3,2015-06-30,2480260,0,2480260
5312,97,$MNDL3,2015-09-30,2480260,0,2480260
5312,97,$MNDL3,2015-12-31,2480260,0,2480260
5312,97,$MNDL3,2016-03-31,2480260,0,2480260
5312,97,$MNDL3,2016-06-30,2480260,0,2480260
5312,97,$MNDL3,2016-09-30,2480260,0,2480260
5312,97,$MNDL3,2016-12-31,2480260,0,2480260
5312,97,$MNDL3,2017-03-31,2480260,0,2480260
5312,97,$MNDL3,2017-06-30,2480260,0,2480260
5312,97,$MNDL3,2017-09-30,2480260,0,2480260
5312,97,$MNDL3,2017-12-31,2480260,0,2480260
5312,97,$MNDL3,2018-03-31,2480260,0,2480260
5312,97,$MNDL3,2018-06-30,2480260,0,2480260
5312,97,$MNDL3,2018-09-30,2480260,0,2480260
5312,97,$MNDL3,2018-12-31,2480260,0,2480260
5312,97,$MNDL3,2019-03-31,2480260,0,2480260
5312,97,$MNDL3,2019-06-30,2480260,0,2480260
5312,97,$MNDL3,2019-09-30,2480260,0,2480260
5312,97,$MNDL3,2019-12-31,2480260,0,2480260
5312,97,$MNDL3,2020-03-31,2480260,0,2480260
5312,97,$MNDL3,2020-06-30,2480260,0,2480260
5312,97,$MNDL3,2020-09-30,2480260,0,2480260
5380,94,$EALT4,2010-12-31,975,1275,2250
5380,94,$EALT4,2011-03-31,975,1275,2250
5380,94,$EALT4,2011-06-30,975,1275,2250
5380,94,$EALT4,2011-09-30,975,1275,2250
5380,94,$EALT4,2011-12-31,975,1275,2250
5380,94,$EALT4,2012-03-31,975,1275,2250
5380,94,$EALT4,2012-06-30,975,1275,2250
5380,94,$EALT4,2012-09-30,975,1275,2250
5380,94,$EALT4,2012-12-31,975,1275,2250
5380,94,$EALT4,2013-03-31,975,1275,2250
5380,94,$EALT4,2013-06-30,975,1275,2250
5380,94,$EALT4,2013-09-30,975,1275,2250
5380,94,$EALT4,2013-12-31,975,1275,2250
5380,94,$EALT4,2014-03-31,975,1275,2250
5380,94,$EALT4,2014-06-30,975,1275,2250
5380,94,$EALT4,2014-09-30,975,1275,2250
5380,94,$EALT4,2014-12-31,975,1275,2250
5380,94,$EALT4,2015-03-31,975,1275,2250
5380,94,$EALT4,2015-06-30,975,1275,2250
5380,94,$EALT4,2015-09-30,975,1275,2250
5380,94,$EALT4,2015-12-31,975,1275,2250
5380,94,$EALT4,2016-03-31,975,1275,2250
5380,94,$EALT4,2016-06-30,975,1275,2250
5380,94,$EALT4,2016-09-30,975,1275,2250
5380,94,$EALT4,2016-12-31,975,1275,2250
5380,94,$EALT4,2017-03-31,975,1275,2250
5380,94,$EALT4,2017-06-30,975,1275,2250
5380,94,$EALT4,2017-09-30,975,1275,2250
5380,94,$EALT4,2017-12-31,975,1275,2250
5380,94,$EALT4,2018-03-31,975,1275,2250
5380,94,$EALT4,2018-06-30,9750,12750,22500
5380,94,$EALT4,2018-09-30,9750,12750,22500
5380,94,$EALT4,2018-12-31,9750,12750,22500
5380,94,$EALT4,2019-03-31,9750,12750,22500
5380,94,$EALT4,2019-06-30,9750,12750,22500
5380,94,$EALT4,2019-09-30,9750,12750,22500
5380,94,$EALT4,2019-12-31,9750,12750,22500
5380,94,$EALT4,2020-03-31,9755,12745,22500
5380,94,$EALT4,2020-06-30,9755,12745,22500
5380,94,$EALT4,2020-09-30,9750,12750,22500
5380,95,$EALT3,2010-12-31,975,1275,2250
5380,95,$EALT3,2011-03-31,975,1275,2250
5380,95,$EALT3,2011-06-30,975,1275,2250
5380,95,$EALT3,2011-09-30,975,1275,2250
5380,95,$EALT3,2011-12-31,975,1275,2250
5380,95,$EALT3,2012-03-31,975,1275,2250
5380,95,$EALT3,2012-06-30,975,1275,2250
5380,95,$EALT3,2012-09-30,975,1275,2250
5380,95,$EALT3,2012-12-31,975,1275,2250
5380,95,$EALT3,2013-03-31,975,1275,2250
5380,95,$EALT3,2013-06-30,975,1275,2250
5380,95,$EALT3,2013-09-30,975,1275,2250
5380,95,$EALT3,2013-12-31,975,1275,2250
5380,95,$EALT3,2014-03-31,975,1275,2250
5380,95,$EALT3,2014-06-30,975,1275,2250
5380,95,$EALT3,2014-09-30,975,1275,2250
5380,95,$EALT3,2014-12-31,975,1275,2250
5380,95,$EALT3,2015-03-31,975,1275,2250
5380,95,$EALT3,2015-06-30,975,1275,2250
5380,95,$EALT3,2015-09-30,975,1275,2250
5380,95,$EALT3,2015-12-31,975,1275,2250
5380,95,$EALT3,2016-03-31,975,1275,2250
5380,95,$EALT3,2016-06-30,975,1275,2250
5380,95,$EALT3,2016-09-30,975,1275,2250
5380,95,$EALT3,2016-12-31,975,1275,2250
5380,95,$EALT3,2017-03-31,975,1275,2250
5380,95,$EALT3,2017-06-30,975,1275,2250
5380,95,$EALT3,2017-09-30,975,1275,2250
5380,95,$EALT3,2017-12-31,975,1275,2250
5380,95,$EALT3,2018-03-31,975,1275,2250
5380,95,$EALT3,2018-06-30,9750,12750,22500
5380,95,$EALT3,2018-09-30,9750,12750,22500
5380,95,$EALT3,2018-12-31,9750,12750,22500
5380,95,$EALT3,2019-03-31,9750,12750,22500
5380,95,$EALT3,2019-06-30,9750,12750,22500
5380,95,$EALT3,2019-09-30,9750,12750,22500
5380,95,$EALT3,2019-12-31,9750,12750,22500
5380,95,$EALT3,2020-03-31,9755,12745,22500
5380,95,$EALT3,2020-06-30,9755,12745,22500
5380,95,$EALT3,2020-09-30,9750,12750,22500
5410,100,$WEGE3,2010-12-31,620905029,0,620905029
5410,100,$WEGE3,2011-03-31,620905029,0,620905029
5410,100,$WEGE3,2011-06-30,620405029,0,620405029
5410,100,$WEGE3,2011-09-30,620405029,0,620405029
5410,100,$WEGE3,2011-12-31,620405029,0,620405029
5410,100,$WEGE3,2012-03-31,620405029,0,620405029
5410,100,$WEGE3,2012-06-30,620405029,0,620405029
5410,100,$WEGE3,2012-09-30,620405029,0,620405029
5410,100,$WEGE3,2012-12-31,620405029,0,620405029
5410,100,$WEGE3,2013-03-31,620405029,0,620405029
5410,100,$WEGE3,2013-06-30,620419011,0,620419011
5410,100,$WEGE3,2013-09-30,620905029,0,620905029
5410,100,$WEGE3,2013-12-31,620905029,0,620905029
5410,100,$WEGE3,2014-03-31,620905029,0,620905029
5410,100,$WEGE3,2014-06-30,807176538,0,807176538
5410,100,$WEGE3,2014-09-30,807176538,0,807176538
5410,100,$WEGE3,2014-12-31,807176538,0,807176538
5410,100,$WEGE3,2015-03-31,807176538,0,807176538
5410,100,$WEGE3,2015-06-30,1614353076,0,1614353076
5410,100,$WEGE3,2015-09-30,1614353076,0,1614353076
5410,100,$WEGE3,2015-12-31,1614353076,0,1614353076
5410,100,$WEGE3,2016-03-31,1614353076,0,1614353076
5410,100,$WEGE3,2016-06-30,1614353076,0,1614353076
5410,100,$WEGE3,2016-09-30,1614353076,0,1614353076
5410,100,$WEGE3,2016-12-31,1614353076,0,1614353076
5410,100,$WEGE3,2017-03-31,1614353076,0,1614353076
5410,100,$WEGE3,2017-06-30,1614353076,0,1614353076
5410,100,$WEGE3,2017-09-30,1614353076,0,1614353076
5410,100,$WEGE3,2017-12-31,1614353076,0,1614353076
5410,100,$WEGE3,2018-03-31,1614353076,0,1614353076
5410,100,$WEGE3,2018-06-30,2098658999,0,2098658999
5410,100,$WEGE3,2018-09-30,2098658999,0,2098658999
5410,100,$WEGE3,2018-12-31,2098658999,0,2098658999
5410,100,$WEGE3,2019-03-31,2098658999,0,2098658999
5410,100,$WEGE3,2019-06-30,2098658999,0,2098658999
5410,100,$WEGE3,2019-09-30,2098658999,0,2098658999
5410,100,$WEGE3,2019-12-31,2098658999,0,2098658999
5410,100,$WEGE3,2020-03-31,2098658999,0,2098658999
5410,100,$WEGE3,2020-06-30,2098658999,0,2098658999
5410,100,$WEGE3,2020-09-30,2098658999,0,2098658999
5762,106,$ETER3,2010-12-31,89500000,0,89500000
5762,106,$ETER3,2011-03-31,89500,0,89500
5762,106,$ETER3,2011-06-30,89500,0,89500
5762,106,$ETER3,2011-09-30,89500,0,89500
5762,106,$ETER3,2011-12-31,89500,0,89500
5762,106,$ETER3,2012-03-31,89500,0,89500
5762,106,$ETER3,2012-06-30,89500,0,89500
5762,106,$ETER3,2012-09-30,89500,0,89500
5762,106,$ETER3,2012-12-31,89500,0,89500
5762,106,$ETER3,2013-03-31,89500,0,89500
5762,106,$ETER3,2013-06-30,89500,0,89500
5762,106,$ETER3,2013-09-30,89500,0,89500
5762,106,$ETER3,2013-12-31,89500,0,89500
5762,106,$ETER3,2014-03-31,89500,0,89500
5762,106,$ETER3,2014-06-30,89500,0,89500
5762,106,$ETER3,2014-09-30,179000,0,179000
5762,106,$ETER3,2014-12-31,179000,0,179000
5762,106,$ETER3,2015-03-31,179000,0,179000
5762,106,$ETER3,2015-06-30,179000,0,179000
5762,106,$ETER3,2015-09-30,179000,0,179000
5762,106,$ETER3,2015-12-31,179000,0,179000
5762,106,$ETER3,2016-03-31,179000,0,179000
5762,106,$ETER3,2016-06-30,179000,0,179000
5762,106,$ETER3,2016-09-30,179000,0,179000
5762,106,$ETER3,2016-12-31,179000,0,179000
5762,106,$ETER3,2017-03-31,179000,0,179000
5762,106,$ETER3,2017-06-30,179000,0,179000
5762,106,$ETER3,2017-09-30,179000,0,179000
5762,106,$ETER3,2017-12-31,179000,0,179000
5762,106,$ETER3,2018-03-31,179000,0,179000
5762,106,$ETER3,2018-06-30,179000,0,179000
5762,106,$ETER3,2018-09-30,179000,0,179000
5762,106,$ETER3,2018-12-31,29833,0,29833
5762,106,$ETER3,2019-03-31,29833,0,29833
5762,106,$ETER3,2019-06-30,29833,0,29833
5762,106,$ETER3,2019-09-30,31774,0,31774
5762,106,$ETER3,2019-12-31,31774,0,31774
5762,106,$ETER3,2020-03-31,31774,0,31774
5762,106,$ETER3,2020-06-30,31774,0,31774
5762,106,$ETER3,2020-09-30,51676,0,51676
5770,107,$EUCA3,2010-12-31,31258,61361,92619
5770,107,$EUCA3,2011-03-31,31257700,61361556,92619256
5770,107,$EUCA3,2011-06-30,31257700,61361556,92619256
5770,107,$EUCA3,2011-09-30,31257700,61361556,92619256
5770,107,$EUCA3,2011-12-31,31258,61361,92619
5770,107,$EUCA3,2012-03-31,31258,61361,92619
5770,107,$EUCA3,2012-06-30,31258,61361,92619
5770,107,$EUCA3,2012-09-30,31258,61361,92619
5770,107,$EUCA3,2012-12-31,31258,61361,92619
5770,107,$EUCA3,2013-03-31,31258,61361,92619
5770,107,$EUCA3,2013-06-30,31258,61361,92619
5770,107,$EUCA3,2013-09-30,31258,61361,92619
5770,107,$EUCA3,2013-12-31,31258,61361,92619
5770,107,$EUCA3,2014-03-31,31258,61361,92619
5770,107,$EUCA3,2014-06-30,31258,61361,92619
5770,107,$EUCA3,2014-09-30,31258,61361,92619
5770,107,$EUCA3,2014-12-31,31258,61361,92619
5770,107,$EUCA3,2015-03-31,31258,61361,92619
5770,107,$EUCA3,2015-06-30,31258,61361,92619
5770,107,$EUCA3,2015-09-30,31258,61361,92619
5770,107,$EUCA3,2015-12-31,31258,61361,92619
5770,107,$EUCA3,2016-03-31,31258,61361,92619
5770,107,$EUCA3,2016-06-30,31258,61361,92619
5770,107,$EUCA3,2016-09-30,31258,61361,92619
5770,107,$EUCA3,2016-12-31,31258,61361,92619
5770,107,$EUCA3,2017-03-31,31258,61361,92619
5770,107,$EUCA3,2017-06-30,31258,61361,92619
5770,107,$EUCA3,2017-09-30,31258,61361,92619
5770,107,$EUCA3,2017-12-31,31258,61361,92619
5770,107,$EUCA3,2018-03-31,31258,61361,92619
5770,107,$EUCA3,2018-06-30,31258,61361,92619
5770,107,$EUCA3,2018-09-30,31258,61361,92619
5770,107,$EUCA3,2018-12-31,31258,61361,92619
5770,107,$EUCA3,2019-03-31,31258,61361,92619
5770,107,$EUCA3,2019-06-30,31258,61361,92619
5770,107,$EUCA3,2019-09-30,31258,61361,92619
5770,107,$EUCA3,2019-12-31,31258,61361,92619
5770,107,$EUCA3,2020-03-31,31258,61361,92619
5770,107,$EUCA3,2020-06-30,31258,61361,92619
5770,107,$EUCA3,2020-09-30,31258,61361,92619
5770,108,$EUCA4,2010-12-31,31258,61361,92619
5770,108,$EUCA4,2011-03-31,31257700,61361556,92619256
5770,108,$EUCA4,2011-06-30,31257700,61361556,92619256
5770,108,$EUCA4,2011-09-30,31257700,61361556,92619256
5770,108,$EUCA4,2011-12-31,31258,61361,92619
5770,108,$EUCA4,2012-03-31,31258,61361,92619
5770,108,$EUCA4,2012-06-30,31258,61361,92619
5770,108,$EUCA4,2012-09-30,31258,61361,92619
5770,108,$EUCA4,2012-12-31,31258,61361,92619
5770,108,$EUCA4,2013-03-31,31258,61361,92619
5770,108,$EUCA4,2013-06-30,31258,61361,92619
5770,108,$EUCA4,2013-09-30,31258,61361,92619
5770,108,$EUCA4,2013-12-31,31258,61361,92619
5770,108,$EUCA4,2014-03-31,31258,61361,92619
5770,108,$EUCA4,2014-06-30,31258,61361,92619
5770,108,$EUCA4,2014-09-30,31258,61361,92619
5770,108,$EUCA4,2014-12-31,31258,61361,92619
5770,108,$EUCA4,2015-03-31,31258,61361,92619
5770,108,$EUCA4,2015-06-30,31258,61361,92619
5770,108,$EUCA4,2015-09-30,31258,61361,92619
5770,108,$EUCA4,2015-12-31,31258,61361,92619
5770,108,$EUCA4,2016-03-31,31258,61361,92619
5770,108,$EUCA4,2016-06-30,31258,61361,92619
5770,108,$EUCA4,2016-09-30,31258,61361,92619
5770,108,$EUCA4,2016-12-31,31258,61361,92619
5770,108,$EUCA4,2017-03-31,31258,61361,92619
5770,108,$EUCA4,2017-06-30,31258,61361,92619
5770,108,$EUCA4,2017-09-30,31258,61361,92619
5770,108,$EUCA4,2017-12-31,31258,61361,92619
5770,108,$EUCA4,2018-03-31,31258,61361,92619
5770,108,$EUCA4,2018-06-30,31258,61361,92619
5770,108,$EUCA4,2018-09-30,31258,61361,92619
5770,108,$EUCA4,2018-12-31,31258,61361,92619
5770,108,$EUCA4,2019-03-31,31258,61361,92619
5770,108,$EUCA4,2019-06-30,31258,61361,92619
5770,108,$EUCA4,2019-09-30,31258,61361,92619
5770,108,$EUCA4,2019-12-31,31258,61361,92619
5770,108,$EUCA4,2020-03-31,31258,61361,92619
5770,108,$EUCA4,2020-06-30,31258,61361,92619
5770,108,$EUCA4,2020-09-30,31258,61361,92619
5983,102,$SJOS,2010-12-31,4500,9000,13500
5983,102,$SJOS,2011-03-31,4500,9000,13500
5983,102,$SJOS,2011-06-30,4500,9000,13500
5983,102,$SJOS,2011-09-30,4500,9000,13500
5983,102,$SJOS,2011-12-31,4500,9000,13500
5983,102,$SJOS,2012-03-31,4500,9000,13500
5983,102,$SJOS,2012-06-30,4500,9000,13500
5983,102,$SJOS,2012-09-30,4500,9000,13500
5983,102,$SJOS,2012-12-31,4500,9000,13500
5983,102,$SJOS,2013-03-31,4500,9000,13500
5983,102,$SJOS,2013-06-30,4500,9000,13500
5983,102,$SJOS,2013-09-30,4500,9000,13500
5983,102,$SJOS,2013-12-31,4500,9000,13500
5983,102,$SJOS,2014-03-31,4500,9000,13500
5983,102,$SJOS,2014-06-30,4500,9000,13500
5983,102,$SJOS,2014-09-30,4500,9000,13500
5983,102,$SJOS,2014-12-31,4500,9000,13500
5983,102,$SJOS,2015-03-31,4500,9000,13500
5983,102,$SJOS,2015-06-30,4500,9000,13500
5983,102,$SJOS,2015-09-30,4500,9000,13500
5983,102,$SJOS,2015-12-31,4500,9000,13500
5983,102,$SJOS,2016-03-31,4500,9000,13500
5983,102,$SJOS,2016-06-30,4500,9000,13500
5983,102,$SJOS,2016-09-30,4500,9000,13500
5983,102,$SJOS,2016-12-31,4500,9000,13500
5983,102,$SJOS,2017-03-31,4500,9000,13500
5983,102,$SJOS,2017-06-30,4500,9000,13500
5983,102,$SJOS,2017-09-30,4500,9000,13500
5983,102,$SJOS,2017-12-31,4500,9000,13500
5983,102,$SJOS,2018-03-31,4500,9000,13500
5983,102,$SJOS,2018-06-30,4500,9000,13500
5983,102,$SJOS,2018-09-30,4500,9000,13500
5983,102,$SJOS,2018-12-31,4500,9000,13500
5983,102,$SJOS,2019-03-31,4500,9000,13500
5983,102,$SJOS,2019-06-30,4500,9000,13500
5983,102,$SJOS,2019-09-30,4500,9000,13500
5983,102,$SJOS,2019-12-31,4500,9000,13500
5983,102,$SJOS,2020-03-31,4500,9000,13500
5983,102,$SJOS,2020-06-30,4500,9000,13500
5983,102,$SJOS,2020-09-30,4500,9000,13500
6041,98,$FIGE3,2010-12-31,792,1572,2364
6041,98,$FIGE3,2011-03-31,792,1572,2364
6041,98,$FIGE3,2011-06-30,792,1572,2364
6041,98,$FIGE3,2011-09-30,792,1572,2364
6041,98,$FIGE3,2011-12-31,792,1572,2364
6041,98,$FIGE3,2012-03-31,792,1572,2364
6041,98,$FIGE3,2012-06-30,792,1572,2364
6041,98,$FIGE3,2012-09-30,792,1572,2364
6041,98,$FIGE3,2012-12-31,792,1572,2364
6041,98,$FIGE3,2013-03-31,792,1572,2364
6041,98,$FIGE3,2013-06-30,792,1572,2364
6041,98,$FIGE3,2013-09-30,792,1572,2364
6041,98,$FIGE3,2013-12-31,792,1572,2364
6041,98,$FIGE3,2014-03-31,792,1572,2364
6041,98,$FIGE3,2014-06-30,792,1572,2364
6041,98,$FIGE3,2014-09-30,792,1572,2364
6041,98,$FIGE3,2014-12-31,792,1572,2364
6041,98,$FIGE3,2015-03-31,792,1572,2364
6041,98,$FIGE3,2015-06-30,792,1572,2364
6041,98,$FIGE3,2015-09-30,792,1572,2364
6041,98,$FIGE3,2015-12-31,792,1572,2364
6041,98,$FIGE3,2016-03-31,792,1572,2364
6041,98,$FIGE3,2016-06-30,792,1572,2364
6041,98,$FIGE3,2016-09-30,792,1572,2364
6041,98,$FIGE3,2016-12-31,792,1572,2364
6041,98,$FIGE3,2017-03-31,792,1572,2364
6041,98,$FIGE3,2017-06-30,792,1572,2364
6041,98,$FIGE3,2017-09-30,792,1572,2364
6041,98,$FIGE3,2017-12-31,792,1572,2364
6041,98,$FIGE3,2018-03-31,792,1572,2364
6041,98,$FIGE3,2018-06-30,792,1572,2364
6041,98,$FIGE3,2018-09-30,792,1572,2364
6041,98,$FIGE3,2018-12-31,792,1572,2364
6041,98,$FIGE3,2019-03-31,792,1572,2364
6041,98,$FIGE3,2019-06-30,792,1572,2364
6041,98,$FIGE3,2019-09-30,792,1572,2364
6041,98,$FIGE3,2019-12-31,792,1572,2364
6041,98,$FIGE3,2020-03-31,792,1572,2364
6041,98,$FIGE3,2020-06-30,792,1572,2364
6041,98,$FIGE3,2020-09-30,792,1572,2364
6041,99,$FIGE4,2010-12-31,792,1572,2364
6041,99,$FIGE4,2011-03-31,792,1572,2364
6041,99,$FIGE4,2011-06-30,792,1572,2364
6041,99,$FIGE4,2011-09-30,792,1572,2364
6041,99,$FIGE4,2011-12-31,792,1572,2364
6041,99,$FIGE4,2012-03-31,792,1572,2364
6041,99,$FIGE4,2012-06-30,792,1572,2364
6041,99,$FIGE4,2012-09-30,792,1572,2364
6041,99,$FIGE4,2012-12-31,792,1572,2364
6041,99,$FIGE4,2013-03-31,792,1572,2364
6041,99,$FIGE4,2013-06-30,792,1572,2364
6041,99,$FIGE4,2013-09-30,792,1572,2364
6041,99,$FIGE4,2013-12-31,792,1572,2364
6041,99,$FIGE4,2014-03-31,792,1572,2364
6041,99,$FIGE4,2014-06-30,792,1572,2364
6041,99,$FIGE4,2014-09-30,792,1572,2364
6041,99,$FIGE4,2014-12-31,792,1572,2364
6041,99,$FIGE4,2015-03-31,792,1572,2364
6041,99,$FIGE4,2015-06-30,792,1572,2364
6041,99,$FIGE4,2015-09-30,792,1572,2364
6041,99,$FIGE4,2015-12-31,792,1572,2364
6041,99,$FIGE4,2016-03-31,792,1572,2364
6041,99,$FIGE4,2016-06-30,792,1572,2364
6041,99,$FIGE4,2016-09-30,792,1572,2364
6041,99,$FIGE4,2016-12-31,792,1572,2364
6041,99,$FIGE4,2017-03-31,792,1572,2364
6041,99,$FIGE4,2017-06-30,792,1572,2364
6041,99,$FIGE4,2017-09-30,792,1572,2364
6041,99,$FIGE4,2017-12-31,792,1572,2364
6041,99,$FIGE4,2018-03-31,792,1572,2364
6041,99,$FIGE4,2018-06-30,792,1572,2364
6041,99,$FIGE4,2018-09-30,792,1572,2364
6041,99,$FIGE4,2018-12-31,792,1572,2364
6041,99,$FIGE4,2019-03-31,792,1572,2364
6041,99,$FIGE4,2019-06-30,792,1572,2364
6041,99,$FIGE4,2019-09-30,792,1572,2364
6041,99,$FIGE4,2019-12-31,792,1572,2364
6041,99,$FIGE4,2020-03-31,792,1572,2364
6041,99,$FIGE4,2020-06-30,792,1572,2364
6041,99,$FIGE4,2020-09-30,792,1572,2364
6076,101,$FNCN3,2010-12-31,913,0,913
6076,101,$FNCN3,2011-03-31,913,0,913
6076,101,$FNCN3,2011-06-30,913,0,913
6076,101,$FNCN3,2011-09-30,913,0,913
6076,101,$FNCN3,2011-12-31,913,0,913
6076,101,$FNCN3,2012-03-31,913,0,913
6076,101,$FNCN3,2012-06-30,913,0,913
6076,101,$FNCN3,2012-09-30,913,0,913
6076,101,$FNCN3,2012-12-31,913,0,913
6076,101,$FNCN3,2013-03-31,913,0,913
6076,101,$FNCN3,2013-06-30,913,0,913
6076,101,$FNCN3,2013-09-30,913,0,913
6076,101,$FNCN3,2013-12-31,913,0,913
6076,101,$FNCN3,2014-03-31,913,0,913
6076,101,$FNCN3,2014-06-30,913,0,913
6076,101,$FNCN3,2014-09-30,913,0,913
6076,101,$FNCN3,2014-12-31,913,0,913
6076,101,$FNCN3,2015-03-31,913,0,913
6076,101,$FNCN3,2015-06-30,913,0,913
6076,101,$FNCN3,2015-09-30,913,0,913
6076,101,$FNCN3,2015-12-31,913,0,913
6076,101,$FNCN3,2016-03-31,913,0,913
6076,101,$FNCN3,2016-06-30,913,0,913
6076,101,$FNCN3,2016-09-30,913,0,913
6076,101,$FNCN3,2016-12-31,913,0,913
6076,101,$FNCN3,2017-03-31,913,0,913
6076,101,$FNCN3,2017-06-30,913,0,913
6076,101,$FNCN3,2017-09-30,913,0,913
6076,101,$FNCN3,2017-12-31,913,0,913
6076,101,$FNCN3,2018-03-31,913,0,913
6076,101,$FNCN3,2018-06-30,913,0,913
6076,101,$FNCN3,2018-09-30,913,0,913
6076,101,$FNCN3,2018-12-31,913,0,913
6076,101,$FNCN3,2019-03-31,913,0,913
6076,101,$FNCN3,2019-06-30,913,0,913
6076,101,$FNCN3,2019-09-30,913,0,913
6076,101,$FNCN3,2019-12-31,913,0,913
6076,101,$FNCN3,2020-03-31,913,0,913
6076,101,$FNCN3,2020-06-30,913,0,913
6076,101,$FNCN3,2020-09-30,913,0,913
6173,119,$FJTA3,2010-12-31,42745,85489,128234
6173,119,$FJTA3,2011-03-31,42745,85489,128234
6173,119,$FJTA3,2011-06-30,47019,94038,141057
6173,119,$FJTA3,2011-09-30,47137539,94275078,141412617
6173,119,$FJTA3,2011-12-31,47137539,94275078,141412617
6173,119,$FJTA3,2012-03-31,47137539,94275078,141412617
6173,119,$FJTA3,2012-06-30,47137539,94275078,141412617
6173,119,$FJTA3,2012-09-30,47137539,94275078,141412617
6173,119,$FJTA3,2012-12-31,47137539,94275078,141412617
6173,119,$FJTA3,2013-03-31,47137539,94275078,141412617
6173,119,$FJTA3,2013-06-30,47137539,94275078,141412617
6173,119,$FJTA3,2013-09-30,47137539,94275078,141412617
6173,119,$FJTA3,2013-12-31,47137539,94275078,141412617
6173,119,$FJTA3,2014-03-31,47137539,94275078,141412617
6173,119,$FJTA3,2014-06-30,47137539,94275078,141412617
6173,119,$FJTA3,2014-09-30,92832547,84751880,177584427
6173,119,$FJTA3,2014-12-31,92832547,84751880,177584427
6173,119,$FJTA3,2015-03-31,8439322,7704716,16144038
6173,119,$FJTA3,2015-06-30,8439322,7704716,16144038
6173,119,$FJTA3,2015-09-30,27446627,13001621,40448248
6173,119,$FJTA3,2015-12-31,27446627,13001621,40448248
6173,119,$FJTA3,2016-03-31,34581630,13001621,47583251
6173,119,$FJTA3,2016-06-30,44642459,13636110,58278569
6173,119,$FJTA3,2016-09-30,44642459,13636110,58278569
6173,119,$FJTA3,2016-12-31,44642459,13636110,58278569
6173,119,$FJTA3,2017-03-31,46445314,18242898,64688212
6173,119,$FJTA3,2017-06-30,46445314,18242898,64688212
6173,119,$FJTA3,2017-09-30,46445314,18242898,64688212
6173,119,$FJTA3,2017-12-31,46445314,18242898,64688212
6173,119,$FJTA3,2018-03-31,46445314,18242898,64688212
6173,119,$FJTA3,2018-06-30,46445314,18242898,64688212
6173,119,$FJTA3,2018-09-30,46445314,18242898,64688212
6173,119,$FJTA3,2018-12-31,46445314,28417312,74862626
6173,119,$FJTA3,2019-03-31,46445314,38823733,85269047
6173,119,$FJTA3,2019-06-30,46445314,42014484,88459798
6173,119,$FJTA3,2019-09-30,46445314,42015334,88460648
6173,119,$FJTA3,2019-12-31,46445314,42019019,88464333
6173,119,$FJTA3,2020-03-31,46445314,42042380,88487694
6173,119,$FJTA3,2020-06-30,46445314,42043312,88488626
6173,119,$FJTA3,2020-09-30,46445314,42609796,89055110
6173,119,$FJTA3,2020-09-30,46445314,42609796,89055110
6173,120,$FJTA4,2010-12-31,42745,85489,128234
6173,120,$FJTA4,2011-03-31,42745,85489,128234
6173,120,$FJTA4,2011-06-30,47019,94038,141057
6173,120,$FJTA4,2011-09-30,47137539,94275078,141412617
6173,120,$FJTA4,2011-12-31,47137539,94275078,141412617
6173,120,$FJTA4,2012-03-31,47137539,94275078,141412617
6173,120,$FJTA4,2012-06-30,47137539,94275078,141412617
6173,120,$FJTA4,2012-09-30,47137539,94275078,141412617
6173,120,$FJTA4,2012-12-31,47137539,94275078,141412617
6173,120,$FJTA4,2013-03-31,47137539,94275078,141412617
6173,120,$FJTA4,2013-06-30,47137539,94275078,141412617
6173,120,$FJTA4,2013-09-30,47137539,94275078,141412617
6173,120,$FJTA4,2013-12-31,47137539,94275078,141412617
6173,120,$FJTA4,2014-03-31,47137539,94275078,141412617
6173,120,$FJTA4,2014-06-30,47137539,94275078,141412617
6173,120,$FJTA4,2014-09-30,92832547,84751880,177584427
6173,120,$FJTA4,2014-12-31,92832547,84751880,177584427
6173,120,$FJTA4,2015-03-31,8439322,7704716,16144038
6173,120,$FJTA4,2015-06-30,8439322,7704716,16144038
6173,120,$FJTA4,2015-09-30,27446627,13001621,40448248
6173,120,$FJTA4,2015-12-31,27446627,13001621,40448248
6173,120,$FJTA4,2016-03-31,34581630,13001621,47583251
6173,120,$FJTA4,2016-06-30,44642459,13636110,58278569
6173,120,$FJTA4,2016-09-30,44642459,13636110,58278569
6173,120,$FJTA4,2016-12-31,44642459,13636110,58278569
6173,120,$FJTA4,2017-03-31,46445314,18242898,64688212
6173,120,$FJTA4,2017-06-30,46445314,18242898,64688212
6173,120,$FJTA4,2017-09-30,46445314,18242898,64688212
6173,120,$FJTA4,2017-12-31,46445314,18242898,64688212
6173,120,$FJTA4,2018-03-31,46445314,18242898,64688212
6173,120,$FJTA4,2018-06-30,46445314,18242898,64688212
6173,120,$FJTA4,2018-09-30,46445314,18242898,64688212
6173,120,$FJTA4,2018-12-31,46445314,28417312,74862626
6173,120,$FJTA4,2019-03-31,46445314,38823733,85269047
6173,120,$FJTA4,2019-06-30,46445314,42014484,88459798
6173,120,$FJTA4,2019-09-30,46445314,42015334,88460648
6173,120,$FJTA4,2019-12-31,46445314,42019019,88464333
6173,120,$FJTA4,2020-03-31,46445314,42042380,88487694
6173,120,$FJTA4,2020-06-30,46445314,42043312,88488626
6173,120,$FJTA4,2020-09-30,46445314,42609796,89055110
6173,120,$FJTA4,2020-09-30,46445314,42609796,89055110
6173,123,$TASA3,2010-12-31,42745,85489,128234
6173,123,$TASA3,2011-03-31,42745,85489,128234
6173,123,$TASA3,2011-06-30,47019,94038,141057
6173,123,$TASA3,2011-09-30,47137539,94275078,141412617
6173,123,$TASA3,2011-12-31,47137539,94275078,141412617
6173,123,$TASA3,2012-03-31,47137539,94275078,141412617
6173,123,$TASA3,2012-06-30,47137539,94275078,141412617
6173,123,$TASA3,2012-09-30,47137539,94275078,141412617
6173,123,$TASA3,2012-12-31,47137539,94275078,141412617
6173,123,$TASA3,2013-03-31,47137539,94275078,141412617
6173,123,$TASA3,2013-06-30,47137539,94275078,141412617
6173,123,$TASA3,2013-09-30,47137539,94275078,141412617
6173,123,$TASA3,2013-12-31,47137539,94275078,141412617
6173,123,$TASA3,2014-03-31,47137539,94275078,141412617
6173,123,$TASA3,2014-06-30,47137539,94275078,141412617
6173,123,$TASA3,2014-09-30,92832547,84751880,177584427
6173,123,$TASA3,2014-12-31,92832547,84751880,177584427
6173,123,$TASA3,2015-03-31,8439322,7704716,16144038
6173,123,$TASA3,2015-06-30,8439322,7704716,16144038
6173,123,$TASA3,2015-09-30,27446627,13001621,40448248
6173,123,$TASA3,2015-12-31,27446627,13001621,40448248
6173,123,$TASA3,2016-03-31,34581630,13001621,47583251
6173,123,$TASA3,2016-06-30,44642459,13636110,58278569
6173,123,$TASA3,2016-09-30,44642459,13636110,58278569
6173,123,$TASA3,2016-12-31,44642459,13636110,58278569
6173,123,$TASA3,2017-03-31,46445314,18242898,64688212
6173,123,$TASA3,2017-06-30,46445314,18242898,64688212
6173,123,$TASA3,2017-09-30,46445314,18242898,64688212
6173,123,$TASA3,2017-12-31,46445314,18242898,64688212
6173,123,$TASA3,2018-03-31,46445314,18242898,64688212
6173,123,$TASA3,2018-06-30,46445314,18242898,64688212
6173,123,$TASA3,2018-09-30,46445314,18242898,64688212
6173,123,$TASA3,2018-12-31,46445314,28417312,74862626
6173,123,$TASA3,2019-03-31,46445314,38823733,85269047
6173,123,$TASA3,2019-06-30,46445314,42014484,88459798
6173,123,$TASA3,2019-09-30,46445314,42015334,88460648
6173,123,$TASA3,2019-12-31,46445314,42019019,88464333
6173,123,$TASA3,2020-03-31,46445314,42042380,88487694
6173,123,$TASA3,2020-06-30,46445314,42043312,88488626
6173,123,$TASA3,2020-09-30,46445314,42609796,89055110
6173,123,$TASA3,2020-09-30,46445314,42609796,89055110
6173,124,$TASA4,2010-12-31,42745,85489,128234
6173,124,$TASA4,2011-03-31,42745,85489,128234
6173,124,$TASA4,2011-06-30,47019,94038,141057
6173,124,$TASA4,2011-09-30,47137539,94275078,141412617
6173,124,$TASA4,2011-12-31,47137539,94275078,141412617
6173,124,$TASA4,2012-03-31,47137539,94275078,141412617
6173,124,$TASA4,2012-06-30,47137539,94275078,141412617
6173,124,$TASA4,2012-09-30,47137539,94275078,141412617
6173,124,$TASA4,2012-12-31,47137539,94275078,141412617
6173,124,$TASA4,2013-03-31,47137539,94275078,141412617
6173,124,$TASA4,2013-06-30,47137539,94275078,141412617
6173,124,$TASA4,2013-09-30,47137539,94275078,141412617
6173,124,$TASA4,2013-12-31,47137539,94275078,141412617
6173,124,$TASA4,2014-03-31,47137539,94275078,141412617
6173,124,$TASA4,2014-06-30,47137539,94275078,141412617
6173,124,$TASA4,2014-09-30,92832547,84751880,177584427
6173,124,$TASA4,2014-12-31,92832547,84751880,177584427
6173,124,$TASA4,2015-03-31,8439322,7704716,16144038
6173,124,$TASA4,2015-06-30,8439322,7704716,16144038
6173,124,$TASA4,2015-09-30,27446627,13001621,40448248
6173,124,$TASA4,2015-12-31,27446627,13001621,40448248
6173,124,$TASA4,2016-03-31,34581630,13001621,47583251
6173,124,$TASA4,2016-06-30,44642459,13636110,58278569
6173,124,$TASA4,2016-09-30,44642459,13636110,58278569
6173,124,$TASA4,2016-12-31,44642459,13636110,58278569
6173,124,$TASA4,2017-03-31,46445314,18242898,64688212
6173,124,$TASA4,2017-06-30,46445314,18242898,64688212
6173,124,$TASA4,2017-09-30,46445314,18242898,64688212
6173,124,$TASA4,2017-12-31,46445314,18242898,64688212
6173,124,$TASA4,2018-03-31,46445314,18242898,64688212
6173,124,$TASA4,2018-06-30,46445314,18242898,64688212
6173,124,$TASA4,2018-09-30,46445314,18242898,64688212
6173,124,$TASA4,2018-12-31,46445314,28417312,74862626
6173,124,$TASA4,2019-03-31,46445314,38823733,85269047
6173,124,$TASA4,2019-06-30,46445314,42014484,88459798
6173,124,$TASA4,2019-09-30,46445314,42015334,88460648
6173,124,$TASA4,2019-12-31,46445314,42019019,88464333
6173,124,$TASA4,2020-03-31,46445314,42042380,88487694
6173,124,$TASA4,2020-06-30,46445314,42043312,88488626
6173,124,$TASA4,2020-09-30,46445314,42609796,89055110
6173,124,$TASA4,2020-09-30,46445314,42609796,89055110
6211,110,$FRAS3,2010-12-31,66174,36207,102381
6211,110,$FRAS3,2011-03-31,66175,36206,102381
6211,110,$FRAS3,2011-06-30,66174,36207,102381
6211,110,$FRAS3,2011-09-30,66174,36207,102381
6211,110,$FRAS3,2011-12-31,66174,36207,102381
6211,110,$FRAS3,2012-03-31,66174,36207,102381
6211,110,$FRAS3,2012-06-30,66174,36207,102381
6211,110,$FRAS3,2012-09-30,66174,36207,102381
6211,110,$FRAS3,2012-12-31,66174,36207,102381
6211,110,$FRAS3,2013-03-31,66174,36207,102381
6211,110,$FRAS3,2013-06-30,66174,36207,102381
6211,110,$FRAS3,2013-09-30,66174,36207,102381
6211,110,$FRAS3,2013-12-31,99981,0,99981
6211,110,$FRAS3,2014-03-31,124974,0,124974
6211,110,$FRAS3,2014-06-30,124973,0,124973
6211,110,$FRAS3,2014-09-30,124973,0,124973
6211,110,$FRAS3,2014-12-31,124974,0,124974
6211,110,$FRAS3,2015-03-31,121974,0,121974
6211,110,$FRAS3,2015-06-30,121974,0,121974
6211,110,$FRAS3,2015-09-30,121974,0,121974
6211,110,$FRAS3,2015-12-31,124974,0,124974
6211,110,$FRAS3,2016-03-31,121974,0,121974
6211,110,$FRAS3,2016-06-30,217566,0,217566
6211,110,$FRAS3,2016-09-30,217566,0,217566
6211,110,$FRAS3,2016-12-31,217566,0,217566
6211,110,$FRAS3,2017-03-31,217566,0,217566
6211,110,$FRAS3,2017-06-30,217566,0,217566
6211,110,$FRAS3,2017-09-30,217566,0,217566
6211,110,$FRAS3,2017-12-31,217566,0,217566
6211,110,$FRAS3,2018-03-31,217566,0,217566
6211,110,$FRAS3,2018-06-30,217566,0,217566
6211,110,$FRAS3,2018-09-30,217566,0,217566
6211,110,$FRAS3,2018-12-31,217566,0,217566
6211,110,$FRAS3,2019-03-31,217566,0,217566
6211,110,$FRAS3,2019-06-30,217566,0,217566
6211,110,$FRAS3,2019-09-30,217566,0,217566
6211,110,$FRAS3,2019-12-31,217566,0,217566
6211,110,$FRAS3,2020-03-31,217566,0,217566
6211,110,$FRAS3,2020-06-30,217566,0,217566
6211,110,$FRAS3,2020-09-30,217566,0,217566
6343,111,$TUPY3,2010-12-31,56820,319,57139
6343,111,$TUPY3,2011-03-31,56820,319,57139
6343,111,$TUPY3,2011-06-30,56820,319,57139
6343,111,$TUPY3,2011-09-30,56820,319,57139
6343,111,$TUPY3,2011-12-31,56820,319,57139
6343,111,$TUPY3,2012-03-31,56820,319,57139
6343,111,$TUPY3,2012-06-30,56820,319,57139
6343,111,$TUPY3,2012-09-30,56820,319,57139
6343,111,$TUPY3,2012-12-31,114278,0,114278
6343,111,$TUPY3,2013-03-31,114278,0,114278
6343,111,$TUPY3,2013-06-30,114278,0,114278
6343,111,$TUPY3,2013-09-30,114278,0,114278
6343,111,$TUPY3,2013-12-31,144178,0,144178
6343,111,$TUPY3,2014-03-31,144178,0,144178
6343,111,$TUPY3,2014-06-30,144178,0,144178
6343,111,$TUPY3,2014-09-30,144178,0,144178
6343,111,$TUPY3,2014-12-31,144178,0,144178
6343,111,$TUPY3,2015-03-31,144178,0,144178
6343,111,$TUPY3,2015-06-30,144178,0,144178
6343,111,$TUPY3,2015-09-30,144178,0,144178
6343,111,$TUPY3,2015-12-31,144178,0,144178
6343,111,$TUPY3,2016-03-31,144178,0,144178
6343,111,$TUPY3,2016-06-30,144178,0,144178
6343,111,$TUPY3,2016-09-30,144178,0,144178
6343,111,$TUPY3,2016-12-31,144178,0,144178
6343,111,$TUPY3,2017-03-31,144178,0,144178
6343,111,$TUPY3,2017-06-30,144178,0,144178
6343,111,$TUPY3,2017-09-30,144178,0,144178
6343,111,$TUPY3,2017-12-31,144178,0,144178
6343,111,$TUPY3,2018-03-31,144178,0,144178
6343,111,$TUPY3,2018-06-30,144178,0,144178
6343,111,$TUPY3,2018-09-30,144178,0,144178
6343,111,$TUPY3,2018-12-31,144178,0,144178
6343,111,$TUPY3,2019-03-31,144178,0,144178
6343,111,$TUPY3,2019-06-30,144178,0,144178
6343,111,$TUPY3,2019-09-30,144178,0,144178
6343,111,$TUPY3,2019-12-31,144178,0,144178
6343,111,$TUPY3,2020-03-31,144178,0,144178
6343,111,$TUPY3,2020-06-30,144178,0,144178
6343,111,$TUPY3,2020-09-30,144178,0,144178
6505,116,$VVAR3,2010-12-31,322688,0,322688
6505,116,$VVAR3,2011-03-31,322688,0,322688
6505,116,$VVAR3,2011-06-30,322688,0,322688
6505,116,$VVAR3,2011-09-30,322688,0,322688
6505,116,$VVAR3,2011-12-31,322688,0,322688
6505,116,$VVAR3,2012-03-31,322688,0,322688
6505,116,$VVAR3,2012-06-30,322688,0,322688
6505,116,$VVAR3,2012-09-30,322688,0,322688
6505,116,$VVAR3,2012-12-31,322688,0,322688
6505,116,$VVAR3,2013-03-31,322688,0,322688
6505,116,$VVAR3,2013-06-30,322688,0,322688
6505,116,$VVAR3,2013-09-30,322688,0,322688
6505,116,$VVAR3,2013-12-31,659165,631587,1290752
6505,116,$VVAR3,2014-03-31,659164,631587,1290751
6505,116,$VVAR3,2014-06-30,659164,631587,1290751
6505,116,$VVAR3,2014-09-30,659164,631587,1290751
6505,116,$VVAR3,2014-12-31,655825,634926,1290751
6505,116,$VVAR3,2015-03-31,655825,634926,1290751
6505,116,$VVAR3,2015-06-30,655825,634926,1290751
6505,116,$VVAR3,2015-09-30,655841,634958,1290799
6505,116,$VVAR3,2015-12-31,655870,635016,1290886
6505,116,$VVAR3,2016-03-31,655871,635019,1290890
6505,116,$VVAR3,2016-06-30,655882,635040,1290922
6505,116,$VVAR3,2016-09-30,655882,635040,1290922
6505,116,$VVAR3,2016-12-31,655939,635154,1291093
6505,116,$VVAR3,2017-03-31,655964,635204,1291168
6505,116,$VVAR3,2017-06-30,655973,635222,1291195
6505,116,$VVAR3,2017-09-30,656169,635614,1291783
6505,116,$VVAR3,2017-12-31,656230,635738,1291968
6505,116,$VVAR3,2018-03-31,656230,635738,1291968
6505,116,$VVAR3,2018-06-30,656262,635801,1292063
6505,116,$VVAR3,2018-09-30,656974,637226,1294200
6505,116,$VVAR3,2018-12-31,1294003,0,1294003
6505,116,$VVAR3,2019-03-31,1294050,0,1294050
6505,116,$VVAR3,2019-06-30,1294125,0,1294125
6505,116,$VVAR3,2019-09-30,1298864,0,1298864
6505,116,$VVAR3,2019-12-31,1299353,0,1299353
6505,116,$VVAR3,2020-03-31,1299715,0,1299715
6505,116,$VVAR3,2020-06-30,1596717,0,1596717
6505,116,$VVAR3,2020-09-30,1597017,0,1597017
6505,117,$VVAR4,2010-12-31,322688,0,322688
6505,117,$VVAR4,2011-03-31,322688,0,322688
6505,117,$VVAR4,2011-06-30,322688,0,322688
6505,117,$VVAR4,2011-09-30,322688,0,322688
6505,117,$VVAR4,2011-12-31,322688,0,322688
6505,117,$VVAR4,2012-03-31,322688,0,322688
6505,117,$VVAR4,2012-06-30,322688,0,322688
6505,117,$VVAR4,2012-09-30,322688,0,322688
6505,117,$VVAR4,2012-12-31,322688,0,322688
6505,117,$VVAR4,2013-03-31,322688,0,322688
6505,117,$VVAR4,2013-06-30,322688,0,322688
6505,117,$VVAR4,2013-09-30,322688,0,322688
6505,117,$VVAR4,2013-12-31,659165,631587,1290752
6505,117,$VVAR4,2014-03-31,659164,631587,1290751
6505,117,$VVAR4,2014-06-30,659164,631587,1290751
6505,117,$VVAR4,2014-09-30,659164,631587,1290751
6505,117,$VVAR4,2014-12-31,655825,634926,1290751
6505,117,$VVAR4,2015-03-31,655825,634926,1290751
6505,117,$VVAR4,2015-06-30,655825,634926,1290751
6505,117,$VVAR4,2015-09-30,655841,634958,1290799
6505,117,$VVAR4,2015-12-31,655870,635016,1290886
6505,117,$VVAR4,2016-03-31,655871,635019,1290890
6505,117,$VVAR4,2016-06-30,655882,635040,1290922
6505,117,$VVAR4,2016-09-30,655882,635040,1290922
6505,117,$VVAR4,2016-12-31,655939,635154,1291093
6505,117,$VVAR4,2017-03-31,655964,635204,1291168
6505,117,$VVAR4,2017-06-30,655973,635222,1291195
6505,117,$VVAR4,2017-09-30,656169,635614,1291783
6505,117,$VVAR4,2017-12-31,656230,635738,1291968
6505,117,$VVAR4,2018-03-31,656230,635738,1291968
6505,117,$VVAR4,2018-06-30,656262,635801,1292063
6505,117,$VVAR4,2018-09-30,656974,637226,1294200
6505,117,$VVAR4,2018-12-31,1294003,0,1294003
6505,117,$VVAR4,2019-03-31,1294050,0,1294050
6505,117,$VVAR4,2019-06-30,1294125,0,1294125
6505,117,$VVAR4,2019-09-30,1298864,0,1298864
6505,117,$VVAR4,2019-12-31,1299353,0,1299353
6505,117,$VVAR4,2020-03-31,1299715,0,1299715
6505,117,$VVAR4,2020-06-30,1596717,0,1596717
6505,117,$VVAR4,2020-09-30,1597017,0,1597017
6629,432,$HETA3,2010-12-31,5136,10164,15300
6629,432,$HETA3,2011-03-31,5136,10164,15300
6629,432,$HETA3,2011-06-30,5136,10164,15300
6629,432,$HETA3,2011-09-30,5136,10164,15300
6629,432,$HETA3,2011-12-31,5135950,10164050,15300000
6629,432,$HETA3,2012-03-31,5135950,10164050,15300000
6629,432,$HETA3,2012-06-30,5135950,10164050,15300000
6629,432,$HETA3,2012-09-30,5135950,10164050,15300000
6629,432,$HETA3,2012-12-31,5135950,10164050,15300000
6629,432,$HETA3,2013-03-31,5135950,10164050,15300000
6629,432,$HETA3,2013-06-30,5135950,10164050,15300000
6629,432,$HETA3,2013-09-30,5135950,10164050,15300000
6629,432,$HETA3,2013-12-31,5135950,10164050,15300000
6629,432,$HETA3,2014-03-31,5135950,10164050,15300000
6629,432,$HETA3,2014-06-30,5135950,10164050,15300000
6629,432,$HETA3,2014-09-30,5135950,10164050,15300000
6629,432,$HETA3,2014-12-31,5135950,10164050,15300000
6629,432,$HETA3,2015-03-31,5135950,10164050,15300000
6629,432,$HETA3,2015-06-30,5135950,10164050,15300000
6629,432,$HETA3,2015-09-30,5135950,10164050,15300000
6629,432,$HETA3,2015-12-31,171198,338801,509999
6629,432,$HETA3,2016-03-31,171198,338801,509999
6629,432,$HETA3,2016-06-30,171198,338801,509999
6629,432,$HETA3,2016-09-30,171198,338801,509999
6629,432,$HETA3,2016-12-31,171198,338801,509999
6629,432,$HETA3,2017-03-31,171198,338801,509999
6629,432,$HETA3,2017-06-30,171198,338801,509999
6629,432,$HETA3,2017-09-30,171198,338801,509999
6629,432,$HETA3,2017-12-31,171198,338801,509999
6629,432,$HETA3,2018-03-31,171198,338801,509999
6629,432,$HETA3,2018-06-30,171198,338801,509999
6629,432,$HETA3,2018-09-30,171198,338801,509999
6629,432,$HETA3,2018-12-31,171198,338801,509999
6629,432,$HETA3,2019-03-31,171198,338801,509999
6629,432,$HETA3,2019-06-30,171198,338801,509999
6629,432,$HETA3,2019-09-30,171198,338801,509999
6629,432,$HETA3,2019-12-31,171198,338801,509999
6629,432,$HETA3,2020-03-31,171198,338801,509999
6629,432,$HETA3,2020-06-30,171198,338801,509999
6629,432,$HETA3,2020-09-30,171198,338801,509999
6629,433,$HETA4,2010-12-31,5136,10164,15300
6629,433,$HETA4,2011-03-31,5136,10164,15300
6629,433,$HETA4,2011-06-30,5136,10164,15300
6629,433,$HETA4,2011-09-30,5136,10164,15300
6629,433,$HETA4,2011-12-31,5135950,10164050,15300000
6629,433,$HETA4,2012-03-31,5135950,10164050,15300000
6629,433,$HETA4,2012-06-30,5135950,10164050,15300000
6629,433,$HETA4,2012-09-30,5135950,10164050,15300000
6629,433,$HETA4,2012-12-31,5135950,10164050,15300000
6629,433,$HETA4,2013-03-31,5135950,10164050,15300000
6629,433,$HETA4,2013-06-30,5135950,10164050,15300000
6629,433,$HETA4,2013-09-30,5135950,10164050,15300000
6629,433,$HETA4,2013-12-31,5135950,10164050,15300000
6629,433,$HETA4,2014-03-31,5135950,10164050,15300000
6629,433,$HETA4,2014-06-30,5135950,10164050,15300000
6629,433,$HETA4,2014-09-30,5135950,10164050,15300000
6629,433,$HETA4,2014-12-31,5135950,10164050,15300000
6629,433,$HETA4,2015-03-31,5135950,10164050,15300000
6629,433,$HETA4,2015-06-30,5135950,10164050,15300000
6629,433,$HETA4,2015-09-30,5135950,10164050,15300000
6629,433,$HETA4,2015-12-31,171198,338801,509999
6629,433,$HETA4,2016-03-31,171198,338801,509999
6629,433,$HETA4,2016-06-30,171198,338801,509999
6629,433,$HETA4,2016-09-30,171198,338801,509999
6629,433,$HETA4,2016-12-31,171198,338801,509999
6629,433,$HETA4,2017-03-31,171198,338801,509999
6629,433,$HETA4,2017-06-30,171198,338801,509999
6629,433,$HETA4,2017-09-30,171198,338801,509999
6629,433,$HETA4,2017-12-31,171198,338801,509999
6629,433,$HETA4,2018-03-31,171198,338801,509999
6629,433,$HETA4,2018-06-30,171198,338801,509999
6629,433,$HETA4,2018-09-30,171198,338801,509999
6629,433,$HETA4,2018-12-31,171198,338801,509999
6629,433,$HETA4,2019-03-31,171198,338801,509999
6629,433,$HETA4,2019-06-30,171198,338801,509999
6629,433,$HETA4,2019-09-30,171198,338801,509999
6629,433,$HETA4,2019-12-31,171198,338801,509999
6629,433,$HETA4,2020-03-31,171198,338801,509999
6629,433,$HETA4,2020-06-30,171198,338801,509999
6629,433,$HETA4,2020-09-30,171198,338801,509999
6700,109,$HOOT4,2010-12-31,104779,78945,183724
6700,109,$HOOT4,2011-03-31,104779,78945,183724
6700,109,$HOOT4,2011-06-30,104779,78945,183724
6700,109,$HOOT4,2011-09-30,104779,78945,183724
6700,109,$HOOT4,2011-12-31,104779,78945,183724
6700,109,$HOOT4,2012-03-31,104779,78945,183724
6700,109,$HOOT4,2012-06-30,104779,78945,183724
6700,109,$HOOT4,2012-09-30,104779,78945,183724
6700,109,$HOOT4,2012-12-31,104779,78945,183724
6700,109,$HOOT4,2013-03-31,104779,78945,183724
6700,109,$HOOT4,2013-06-30,104779,78945,183724
6700,109,$HOOT4,2013-09-30,104779,78945,183724
6700,109,$HOOT4,2013-12-31,104779,78945,183724
6700,109,$HOOT4,2014-03-31,104779,78945,183724
6700,109,$HOOT4,2014-06-30,104779,78945,183724
6700,109,$HOOT4,2014-09-30,104779,78945,183724
6700,109,$HOOT4,2014-12-31,104779,78945,183724
6700,109,$HOOT4,2015-03-31,104779,78945,183724
6700,109,$HOOT4,2015-06-30,104779,78945,183724
6700,109,$HOOT4,2015-09-30,10478,7894,18372
6700,109,$HOOT4,2015-12-31,10478,7894,18372
6700,109,$HOOT4,2016-03-31,10478,7894,18372
6700,109,$HOOT4,2016-06-30,10478,7894,18372
6700,109,$HOOT4,2016-09-30,10478,7894,18372
6700,109,$HOOT4,2016-12-31,10478,7894,18372
6700,109,$HOOT4,2017-03-31,10478,7894,18372
6700,109,$HOOT4,2017-06-30,10478,7894,18372
6700,109,$HOOT4,2017-09-30,10478,7894,18372
6700,109,$HOOT4,2017-12-31,10478,7894,18372
6700,109,$HOOT4,2018-03-31,10478,7894,18372
6700,109,$HOOT4,2018-06-30,10478,7894,18372
6700,109,$HOOT4,2018-09-30,10478,7894,18372
6700,109,$HOOT4,2018-12-31,10478,7894,18372
6700,109,$HOOT4,2019-03-31,10478,7894,18372
6700,109,$HOOT4,2019-06-30,10478,7894,18372
6700,109,$HOOT4,2019-09-30,10478,7894,18372
6700,109,$HOOT4,2019-12-31,10478,7894,18372
6700,109,$HOOT4,2020-03-31,10478,7894,18372
6700,109,$HOOT4,2020-06-30,10478,7894,18372
6700,109,$HOOT4,2020-09-30,10478,7894,18372
6815,113,$IGBR3,2010-12-31,12504967,0,12504967
6815,113,$IGBR3,2011-03-31,12504967,0,12504967
6815,113,$IGBR3,2011-06-30,12504967,0,12504967
6815,113,$IGBR3,2011-09-30,12504967,0,12504967
6815,113,$IGBR3,2011-12-31,12504967,0,12504967
6815,113,$IGBR3,2012-03-31,12504967,0,12504967
6815,113,$IGBR3,2012-06-30,12504967,0,12504967
6815,113,$IGBR3,2012-09-30,12504967,0,12504967
6815,113,$IGBR3,2012-12-31,12504967,0,12504967
6815,113,$IGBR3,2013-03-31,12504967,0,12504967
6815,113,$IGBR3,2013-06-30,12504967,0,12504967
6815,113,$IGBR3,2013-09-30,12504967,0,12504967
6815,113,$IGBR3,2013-12-31,12504967,0,12504967
6815,113,$IGBR3,2014-03-31,12504967,0,12504967
6815,113,$IGBR3,2014-06-30,12504967,0,12504967
6815,113,$IGBR3,2014-09-30,12504967,0,12504967
6815,113,$IGBR3,2014-12-31,12504967,0,12504967
6815,113,$IGBR3,2015-03-31,12504967,0,12504967
6815,113,$IGBR3,2015-06-30,12504967,0,12504967
6815,113,$IGBR3,2015-09-30,12504967,0,12504967
6815,113,$IGBR3,2015-12-31,12504967,0,12504967
6815,113,$IGBR3,2016-03-31,12504967,0,12504967
6815,113,$IGBR3,2016-06-30,12504967,0,12504967
6815,113,$IGBR3,2016-09-30,12504967,0,12504967
6815,113,$IGBR3,2016-12-31,12504967,0,12504967
6815,113,$IGBR3,2017-03-31,12504967,0,12504967
6815,113,$IGBR3,2017-06-30,12504967,0,12504967
6815,113,$IGBR3,2017-09-30,12504967,0,12504967
6815,113,$IGBR3,2017-12-31,12504967,0,12504967
6815,113,$IGBR3,2018-03-31,12504967,0,12504967
6815,113,$IGBR3,2018-06-30,12504967,0,12504967
6815,113,$IGBR3,2018-09-30,12504967,0,12504967
6815,113,$IGBR3,2018-12-31,12504967,0,12504967
6815,113,$IGBR3,2019-03-31,12504967,0,12504967
6815,113,$IGBR3,2019-06-30,12504967,0,12504967
6815,113,$IGBR3,2019-09-30,12504967,0,12504967
6815,113,$IGBR3,2019-12-31,12504967,0,12504967
6815,113,$IGBR3,2020-03-31,12504967,0,12504967
6815,113,$IGBR3,2020-06-30,12504967,0,12504967
6815,113,$IGBR3,2020-09-30,12504967,0,12504967
7510,121,$ROMI3,2010-12-31,74758,0,74758
7510,121,$ROMI3,2011-03-31,74757547,0,74757547
7510,121,$ROMI3,2011-06-30,74757547,0,74757547
7510,121,$ROMI3,2011-09-30,74757547,0,74757547
7510,121,$ROMI3,2011-12-31,74757547,0,74757547
7510,121,$ROMI3,2012-03-31,74757547,0,74757547
7510,121,$ROMI3,2012-06-30,74757547,0,74757547
7510,121,$ROMI3,2012-09-30,74757547,0,74757547
7510,121,$ROMI3,2012-12-31,74757547,0,74757547
7510,121,$ROMI3,2013-03-31,71757647,0,71757647
7510,121,$ROMI3,2013-06-30,71757647,0,71757647
7510,121,$ROMI3,2013-09-30,71757647,0,71757647
7510,121,$ROMI3,2013-12-31,71757647,0,71757647
7510,121,$ROMI3,2014-03-31,71757647,0,71757647
7510,121,$ROMI3,2014-06-30,71757647,0,71757647
7510,121,$ROMI3,2014-09-30,71757647,0,71757647
7510,121,$ROMI3,2014-12-31,71757647,0,71757647
7510,121,$ROMI3,2015-03-31,68757647,0,68757647
7510,121,$ROMI3,2015-06-30,68757647,0,68757647
7510,121,$ROMI3,2015-09-30,68757647,0,68757647
7510,121,$ROMI3,2015-12-31,68757647,0,68757647
7510,121,$ROMI3,2016-03-31,68757647,0,68757647
7510,121,$ROMI3,2016-06-30,65657647,0,65657647
7510,121,$ROMI3,2016-09-30,62857647,0,62857647
7510,121,$ROMI3,2016-12-31,62857647,0,62857647
7510,121,$ROMI3,2017-03-31,62857647,0,62857647
7510,121,$ROMI3,2017-06-30,62857647,0,62857647
7510,121,$ROMI3,2017-09-30,62857647,0,62857647
7510,121,$ROMI3,2017-12-31,62857647,0,62857647
7510,121,$ROMI3,2018-03-31,62857647,0,62857647
7510,121,$ROMI3,2018-06-30,62857647,0,62857647
7510,121,$ROMI3,2018-09-30,62857647,0,62857647
7510,121,$ROMI3,2018-12-31,62857647,0,62857647
7510,121,$ROMI3,2019-03-31,62857647,0,62857647
7510,121,$ROMI3,2019-06-30,62857647,0,62857647
7510,121,$ROMI3,2019-09-30,62857647,0,62857647
7510,121,$ROMI3,2019-12-31,62857647,0,62857647
7510,121,$ROMI3,2020-03-31,62857647,0,62857647
7510,121,$ROMI3,2020-06-30,62857647,0,62857647
7510,121,$ROMI3,2020-09-30,62857647,0,62857647
7544,419,$TRXR3,2010-12-31,14566031,28026779,42592810
7544,419,$TRXR3,2011-03-31,14566031,28026779,42592810
7544,419,$TRXR3,2011-06-30,14566031,28026779,42592810
7544,419,$TRXR3,2011-09-30,14566,28027,42593
7544,419,$TRXR3,2011-12-31,14566,28027,42593
7544,419,$TRXR3,2012-03-31,14566,28026,42592
7544,419,$TRXR3,2012-06-30,14566,28026,42592
7544,419,$TRXR3,2012-09-30,14566,28026,42592
7544,419,$TRXR3,2012-12-31,14566,28026,42592
7544,419,$TRXR3,2013-03-31,14566,28026,42592
7544,419,$TRXR3,2013-06-30,14566,28027,42593
7544,419,$TRXR3,2013-09-30,14566,28027,42593
7544,419,$TRXR3,2013-12-31,14566,28026,42592
7544,419,$TRXR3,2014-03-31,14566,28027,42593
7544,419,$TRXR3,2014-06-30,14566,28027,42593
7544,419,$TRXR3,2014-09-30,14566,28027,42593
7544,419,$TRXR3,2014-12-31,14556,28026,42582
7544,419,$TRXR3,2015-03-31,14566,28027,42593
7544,419,$TRXR3,2015-06-30,14566,28027,42593
7544,419,$TRXR3,2015-09-30,14566,28027,42593
7544,419,$TRXR3,2015-12-31,14556,28026,42582
7544,419,$TRXR3,2016-03-31,14566,28027,42593
7544,419,$TRXR3,2016-06-30,1456,2803,4259
7544,419,$TRXR3,2016-09-30,1456,2803,4259
7544,419,$TRXR3,2016-12-31,1456,2803,4259
7544,419,$TRXR3,2017-03-31,1456,2803,4259
7544,419,$TRXR3,2017-06-30,1456,2803,4259
7544,419,$TRXR3,2017-09-30,1456,2803,4259
7544,419,$TRXR3,2017-12-31,1456,2803,4259
7544,419,$TRXR3,2018-03-31,1456,2803,4259
7544,419,$TRXR3,2018-06-30,1456,2803,4259
7544,419,$TRXR3,2018-09-30,1456,2803,4259
7544,419,$TRXR3,2018-12-31,1456,2803,4259
7544,419,$TRXR3,2019-03-31,1456,2803,4259
7544,419,$TRXR3,2019-06-30,1456,2803,4259
7544,419,$TRXR3,2019-09-30,1456,2803,4259
7544,419,$TRXR3,2019-12-31,1456,2803,4259
7544,419,$TRXR3,2020-03-31,1456,2803,4259
7544,419,$TRXR3,2020-06-30,1456,2803,4259
7544,419,$TRXR3,2020-09-30,1456,2803,4259
7544,420,$TXRX4,2010-12-31,14566031,28026779,42592810
7544,420,$TXRX4,2011-03-31,14566031,28026779,42592810
7544,420,$TXRX4,2011-06-30,14566031,28026779,42592810
7544,420,$TXRX4,2011-09-30,14566,28027,42593
7544,420,$TXRX4,2011-12-31,14566,28027,42593
7544,420,$TXRX4,2012-03-31,14566,28026,42592
7544,420,$TXRX4,2012-06-30,14566,28026,42592
7544,420,$TXRX4,2012-09-30,14566,28026,42592
7544,420,$TXRX4,2012-12-31,14566,28026,42592
7544,420,$TXRX4,2013-03-31,14566,28026,42592
7544,420,$TXRX4,2013-06-30,14566,28027,42593
7544,420,$TXRX4,2013-09-30,14566,28027,42593
7544,420,$TXRX4,2013-12-31,14566,28026,42592
7544,420,$TXRX4,2014-03-31,14566,28027,42593
7544,420,$TXRX4,2014-06-30,14566,28027,42593
7544,420,$TXRX4,2014-09-30,14566,28027,42593
7544,420,$TXRX4,2014-12-31,14556,28026,42582
7544,420,$TXRX4,2015-03-31,14566,28027,42593
7544,420,$TXRX4,2015-06-30,14566,28027,42593
7544,420,$TXRX4,2015-09-30,14566,28027,42593
7544,420,$TXRX4,2015-12-31,14556,28026,42582
7544,420,$TXRX4,2016-03-31,14566,28027,42593
7544,420,$TXRX4,2016-06-30,1456,2803,4259
7544,420,$TXRX4,2016-09-30,1456,2803,4259
7544,420,$TXRX4,2016-12-31,1456,2803,4259
7544,420,$TXRX4,2017-03-31,1456,2803,4259
7544,420,$TXRX4,2017-06-30,1456,2803,4259
7544,420,$TXRX4,2017-09-30,1456,2803,4259
7544,420,$TXRX4,2017-12-31,1456,2803,4259
7544,420,$TXRX4,2018-03-31,1456,2803,4259
7544,420,$TXRX4,2018-06-30,1456,2803,4259
7544,420,$TXRX4,2018-09-30,1456,2803,4259
7544,420,$TXRX4,2018-12-31,1456,2803,4259
7544,420,$TXRX4,2019-03-31,1456,2803,4259
7544,420,$TXRX4,2019-06-30,1456,2803,4259
7544,420,$TXRX4,2019-09-30,1456,2803,4259
7544,420,$TXRX4,2019-12-31,1456,2803,4259
7544,420,$TXRX4,2020-03-31,1456,2803,4259
7544,420,$TXRX4,2020-06-30,1456,2803,4259
7544,420,$TXRX4,2020-09-30,1456,2803,4259
7595,112,$INEP3,2010-12-31,37165,58495,95660
7595,112,$INEP3,2011-03-31,37165,58495,95660
7595,112,$INEP3,2011-06-30,37165,58495,95660
7595,112,$INEP3,2011-09-30,37165,58495,95660
7595,112,$INEP3,2011-12-31,37165,58495,95660
7595,112,$INEP3,2012-03-31,37165,58495,95660
7595,112,$INEP3,2012-06-30,39892,63136,103028
7595,112,$INEP3,2012-09-30,39892,63136,103028
7595,112,$INEP3,2012-12-31,37165,58495,95660
7595,112,$INEP3,2013-03-31,37165,58495,95660
7595,112,$INEP3,2013-06-30,39892,63136,103028
7595,112,$INEP3,2013-09-30,39892,63136,103028
7595,112,$INEP3,2013-12-31,39892,63136,103028
7595,112,$INEP3,2014-03-31,39892,63136,103028
7595,112,$INEP3,2014-06-30,39892,63136,103028
7595,112,$INEP3,2014-09-30,39892,63136,103028
7595,112,$INEP3,2014-12-31,39892,63136,103028
7595,112,$INEP3,2015-03-31,39892,63136,103028
7595,112,$INEP3,2015-06-30,39892,63136,103028
7595,112,$INEP3,2015-09-30,39892,63136,103028
7595,112,$INEP3,2015-12-31,86124,63136,149260
7595,112,$INEP3,2016-03-31,86124,63136,149260
7595,112,$INEP3,2016-06-30,86124,63136,149260
7595,112,$INEP3,2016-09-30,86124,63136,149260
7595,112,$INEP3,2016-12-31,86124,63136,149260
7595,112,$INEP3,2017-03-31,86124,63136,149260
7595,112,$INEP3,2017-06-30,86124,63136,149260
7595,112,$INEP3,2017-09-30,86124,63136,149260
7595,112,$INEP3,2017-12-31,3181,3157,6338
7595,112,$INEP3,2018-03-31,3181,3157,6338
7595,112,$INEP3,2018-06-30,3181,3157,6338
7595,112,$INEP3,2018-09-30,3181,3157,6338
7595,112,$INEP3,2018-12-31,4320,3157,7477
7595,112,$INEP3,2019-03-31,4414,3157,7571
7595,112,$INEP3,2019-06-30,4414,3157,7571
7595,112,$INEP3,2019-09-30,4812,3157,7969
7595,112,$INEP3,2019-12-31,4812,3157,7969
7595,112,$INEP3,2020-03-31,4812,3157,7969
7595,112,$INEP3,2020-06-30,5047,3157,8204
7617,114,$ITSA3,2010-12-31,1680796,2693485,4374281
7617,114,$ITSA3,2011-03-31,1680796,2693485,4374281
7617,114,$ITSA3,2011-06-30,1696627,2718855,4415482
7617,114,$ITSA3,2011-09-30,1696627,2718855,4415482
7617,114,$ITSA3,2011-12-31,1696627,2718855,4415482
7617,114,$ITSA3,2012-03-31,1696627,2718855,4415482
7617,114,$ITSA3,2012-06-30,1866290,2981170,4847460
7617,114,$ITSA3,2012-09-30,1866290,2981170,4847460
7617,114,$ITSA3,2012-12-31,1866290,2981170,4847460
7617,114,$ITSA3,2013-03-31,1866290,2981170,4847460
7617,114,$ITSA3,2013-06-30,2106227,3364440,5470667
7617,114,$ITSA3,2013-09-30,2106227,3364440,5470667
7617,114,$ITSA3,2013-12-31,2106227,3364440,5470667
7617,114,$ITSA3,2014-03-31,2106227,3364440,5470667
7617,114,$ITSA3,2014-03-31,2106227,3364440,5470667
7617,114,$ITSA3,2014-06-30,2352424,3757710,6110134
7617,114,$ITSA3,2014-09-30,2352424,3757710,6110134
7617,114,$ITSA3,2014-12-31,2352424,3757710,6110134
7617,114,$ITSA3,2015-03-31,2352424,3757710,6110134
7617,114,$ITSA3,2015-06-30,2597547,4161252,6758799
7617,114,$ITSA3,2015-06-30,2597547,4161252,6758799
7617,114,$ITSA3,2015-09-30,2597547,4161252,6758799
7617,114,$ITSA3,2015-12-31,2597547,4161252,6758799
7617,114,$ITSA3,2016-03-31,2597547,4161252,6758799
7617,114,$ITSA3,2016-06-30,2854931,4575177,7430108
7617,114,$ITSA3,2016-09-30,2854931,4575177,7430108
7617,114,$ITSA3,2016-12-31,2854931,4575177,7430108
7617,114,$ITSA3,2017-03-31,2828112,4575177,7403289
7617,114,$ITSA3,2017-06-30,2874454,4650146,7524600
7617,114,$ITSA3,2017-06-30,2874454,4650146,7524600
7617,114,$ITSA3,2017-09-30,2823484,4650146,7473630
7617,114,$ITSA3,2017-12-31,2823484,4650146,7473630
7617,114,$ITSA3,2018-03-31,2823484,4650146,7473630
7617,114,$ITSA3,2018-06-30,2889840,5524358,8414198
7617,114,$ITSA3,2018-09-30,2889840,5524358,8414198
7617,114,$ITSA3,2018-12-31,2889840,5520858,8410698
7617,114,$ITSA3,2019-03-31,2889840,5520858,8410698
7617,114,$ITSA3,2019-06-30,2889840,5520977,8410817
7617,114,$ITSA3,2019-09-30,2889838,5520977,8410815
7617,114,$ITSA3,2019-12-31,2889838,5520977,8410815
7617,114,$ITSA3,2020-03-31,2889838,5520977,8410815
7617,114,$ITSA3,2020-06-30,2889838,5520977,8410815
7617,114,$ITSA3,2020-09-30,2889838,5520977,8410815
7617,115,$ITSA4,2010-12-31,1680796,2693485,4374281
7617,115,$ITSA4,2011-03-31,1680796,2693485,4374281
7617,115,$ITSA4,2011-06-30,1696627,2718855,4415482
7617,115,$ITSA4,2011-09-30,1696627,2718855,4415482
7617,115,$ITSA4,2011-12-31,1696627,2718855,4415482
7617,115,$ITSA4,2012-03-31,1696627,2718855,4415482
7617,115,$ITSA4,2012-06-30,1866290,2981170,4847460
7617,115,$ITSA4,2012-09-30,1866290,2981170,4847460
7617,115,$ITSA4,2012-12-31,1866290,2981170,4847460
7617,115,$ITSA4,2013-03-31,1866290,2981170,4847460
7617,115,$ITSA4,2013-06-30,2106227,3364440,5470667
7617,115,$ITSA4,2013-09-30,2106227,3364440,5470667
7617,115,$ITSA4,2013-12-31,2106227,3364440,5470667
7617,115,$ITSA4,2014-03-31,2106227,3364440,5470667
7617,115,$ITSA4,2014-03-31,2106227,3364440,5470667
7617,115,$ITSA4,2014-06-30,2352424,3757710,6110134
7617,115,$ITSA4,2014-09-30,2352424,3757710,6110134
7617,115,$ITSA4,2014-12-31,2352424,3757710,6110134
7617,115,$ITSA4,2015-03-31,2352424,3757710,6110134
7617,115,$ITSA4,2015-06-30,2597547,4161252,6758799
7617,115,$ITSA4,2015-06-30,2597547,4161252,6758799
7617,115,$ITSA4,2015-09-30,2597547,4161252,6758799
7617,115,$ITSA4,2015-12-31,2597547,4161252,6758799
7617,115,$ITSA4,2016-03-31,2597547,4161252,6758799
7617,115,$ITSA4,2016-06-30,2854931,4575177,7430108
7617,115,$ITSA4,2016-09-30,2854931,4575177,7430108
7617,115,$ITSA4,2016-12-31,2854931,4575177,7430108
7617,115,$ITSA4,2017-03-31,2828112,4575177,7403289
7617,115,$ITSA4,2017-06-30,2874454,4650146,7524600
7617,115,$ITSA4,2017-06-30,2874454,4650146,7524600
7617,115,$ITSA4,2017-09-30,2823484,4650146,7473630
7617,115,$ITSA4,2017-12-31,2823484,4650146,7473630
7617,115,$ITSA4,2018-03-31,2823484,4650146,7473630
7617,115,$ITSA4,2018-06-30,2889840,5524358,8414198
7617,115,$ITSA4,2018-09-30,2889840,5524358,8414198
7617,115,$ITSA4,2018-12-31,2889840,5520858,8410698
7617,115,$ITSA4,2019-03-31,2889840,5520858,8410698
7617,115,$ITSA4,2019-06-30,2889840,5520977,8410817
7617,115,$ITSA4,2019-09-30,2889838,5520977,8410815
7617,115,$ITSA4,2019-12-31,2889838,5520977,8410815
7617,115,$ITSA4,2020-03-31,2889838,5520977,8410815
7617,115,$ITSA4,2020-06-30,2889838,5520977,8410815
7617,115,$ITSA4,2020-09-30,2889838,5520977,8410815
7811,421,$JFEN3,2019-03-31,105203815,0,105203815
7811,421,$JFEN3,2019-06-30,105203815,0,105203815
7811,421,$JFEN3,2019-09-30,105203815,0,105203815
7870,122,$KEPL3,2010-12-31,1308211,1021,1309232
7870,122,$KEPL3,2010-12-31,1308211,1061,1309272
7870,122,$KEPL3,2011-03-31,1308213508,1060410,1309273918
7870,122,$KEPL3,2011-03-31,1308213508,1060410,1309273918
7870,122,$KEPL3,2011-06-30,1308319,954,1309273
7870,122,$KEPL3,2011-09-30,1308321,951,1309272
7870,122,$KEPL3,2011-09-30,1308321,951,1309272
7870,122,$KEPL3,2011-12-31,1308320,951,1309271
7870,122,$KEPL3,2012-03-31,1309235,0,1309235
7870,122,$KEPL3,2012-03-31,1309235,0,1309235
7870,122,$KEPL3,2012-06-30,1309235,0,1309235
7870,122,$KEPL3,2012-06-30,1309235,0,1309235
7870,122,$KEPL3,2012-09-30,26185,0,26185
7870,122,$KEPL3,2012-12-31,26185,0,26185
7870,122,$KEPL3,2013-03-31,26185,0,26185
7870,122,$KEPL3,2013-06-30,26185,0,26185
7870,122,$KEPL3,2013-09-30,26185,0,26185
7870,122,$KEPL3,2013-12-31,26185,0,26185
7870,122,$KEPL3,2014-03-31,26185,0,26185
7870,122,$KEPL3,2014-06-30,26186,0,26186
7870,122,$KEPL3,2014-09-30,26309,0,26309
7870,122,$KEPL3,2014-12-31,26309,0,26309
7870,122,$KEPL3,2015-03-31,26309,0,26309
7870,122,$KEPL3,2015-06-30,26312,0,26312
7870,122,$KEPL3,2015-09-30,26312,0,26312
7870,122,$KEPL3,2015-12-31,26312,0,26312
7870,122,$KEPL3,2016-03-31,26312,0,26312
7870,122,$KEPL3,2016-06-30,26312,0,26312
7870,122,$KEPL3,2016-09-30,26312,0,26312
7870,122,$KEPL3,2016-12-31,26312,0,26312
7870,122,$KEPL3,2017-03-31,26312,0,26312
7870,122,$KEPL3,2017-06-30,26312,0,26312
7870,122,$KEPL3,2017-09-30,26312,0,26312
7870,122,$KEPL3,2017-12-31,26312,0,26312
7870,122,$KEPL3,2018-03-31,26312,0,26312
7870,122,$KEPL3,2018-06-30,26312,0,26312
7870,122,$KEPL3,2018-09-30,26312,0,26312
7870,122,$KEPL3,2018-12-31,26312,0,26312
7870,122,$KEPL3,2019-03-31,26312,0,26312
7870,122,$KEPL3,2019-06-30,26312,0,26312
7870,122,$KEPL3,2019-09-30,26312,0,26312
7870,122,$KEPL3,2019-12-31,26312,0,26312
7870,122,$KEPL3,2020-03-31,26312,0,26312
7870,122,$KEPL3,2020-06-30,26312,0,26312
7870,122,$KEPL3,2020-09-30,26312,0,26312
8087,130,$LAME3,2010-12-31,281689106,476613879,758302985
8087,130,$LAME3,2011-03-31,287098878,485767134,772866012
8087,130,$LAME3,2011-06-30,287098878,486700787,773799665
8087,130,$LAME3,2011-09-30,287098878,487872832,774971710
8087,130,$LAME3,2011-12-31,287098878,487872832,774971710
8087,130,$LAME3,2012-03-31,287098878,487872832,774971710
8087,130,$LAME3,2012-06-30,367025080,625057273,992082353
8087,130,$LAME3,2012-09-30,367025080,625068830,992093910
8087,130,$LAME3,2012-12-31,367025080,625068830,992093910
8087,130,$LAME3,2013-03-31,367025080,625068830,992093910
8087,130,$LAME3,2013-06-30,367025080,625068830,992093910
8087,130,$LAME3,2013-09-30,367025080,626638720,993663800
8087,130,$LAME3,2013-12-31,367025080,626706258,993731338
8087,130,$LAME3,2014-03-31,361671082,608448687,970119769
8087,130,$LAME3,2014-06-30,452088853,763052048,1215140901
8087,130,$LAME3,2014-09-30,452088853,763095114,1215183967
8087,130,$LAME3,2014-12-31,452088853,763128273,1215217126
8087,130,$LAME3,2015-03-31,448742605,749700733,1198443338
8087,130,$LAME3,2015-06-30,448742605,751593250,1200335855
8087,130,$LAME3,2015-09-30,448742605,751732507,1200475112
8087,130,$LAME3,2015-12-31,448742605,751749258,1200491863
8087,130,$LAME3,2016-03-31,530640068,879901018,1410541086
8087,130,$LAME3,2016-06-30,530640068,880161234,1410801302
8087,130,$LAME3,2016-09-30,530640068,882695739,1413335807
8087,130,$LAME3,2016-12-31,530640068,897393456,1428033524
8087,130,$LAME3,2017-03-31,539943630,1040318790,1580262420
8087,130,$LAME3,2017-06-30,539943630,1042625666,1582569296
8087,130,$LAME3,2017-09-30,539943630,1057250774,1597194404
8087,130,$LAME3,2017-12-31,539943630,1057488141,1597431771
8087,130,$LAME3,2018-03-31,539943630,1057488141,1597431771
8087,130,$LAME3,2018-06-30,539943630,1057488141,1597431771
8087,130,$LAME3,2018-09-30,539943630,1060710334,1600653964
8087,130,$LAME3,2018-12-31,539943630,1060710334,1600653964
8087,130,$LAME3,2019-03-31,539943630,1060710334,1600653964
8087,130,$LAME3,2019-06-30,539943630,1060710334,1600653964
8087,130,$LAME3,2019-09-30,539943630,1065402464,1605346094
8087,130,$LAME3,2019-12-31,539943630,1065434334,1605377964
8087,130,$LAME3,2020-03-31,545154656,1075694696,1620849352
8087,130,$LAME3,2020-06-30,545154656,1078406137,1623560793
8087,130,$LAME3,2020-09-30,653154656,1214196917,1867351573
8087,133,$LAME4,2010-12-31,281689106,476613879,758302985
8087,133,$LAME4,2011-03-31,287098878,485767134,772866012
8087,133,$LAME4,2011-06-30,287098878,486700787,773799665
8087,133,$LAME4,2011-09-30,287098878,487872832,774971710
8087,133,$LAME4,2011-12-31,287098878,487872832,774971710
8087,133,$LAME4,2012-03-31,287098878,487872832,774971710
8087,133,$LAME4,2012-06-30,367025080,625057273,992082353
8087,133,$LAME4,2012-09-30,367025080,625068830,992093910
8087,133,$LAME4,2012-12-31,367025080,625068830,992093910
8087,133,$LAME4,2013-03-31,367025080,625068830,992093910
8087,133,$LAME4,2013-06-30,367025080,625068830,992093910
8087,133,$LAME4,2013-09-30,367025080,626638720,993663800
8087,133,$LAME4,2013-12-31,367025080,626706258,993731338
8087,133,$LAME4,2014-03-31,361671082,608448687,970119769
8087,133,$LAME4,2014-06-30,452088853,763052048,1215140901
8087,133,$LAME4,2014-09-30,452088853,763095114,1215183967
8087,133,$LAME4,2014-12-31,452088853,763128273,1215217126
8087,133,$LAME4,2015-03-31,448742605,749700733,1198443338
8087,133,$LAME4,2015-06-30,448742605,751593250,1200335855
8087,133,$LAME4,2015-09-30,448742605,751732507,1200475112
8087,133,$LAME4,2015-12-31,448742605,751749258,1200491863
8087,133,$LAME4,2016-03-31,530640068,879901018,1410541086
8087,133,$LAME4,2016-06-30,530640068,880161234,1410801302
8087,133,$LAME4,2016-09-30,530640068,882695739,1413335807
8087,133,$LAME4,2016-12-31,530640068,897393456,1428033524
8087,133,$LAME4,2017-03-31,539943630,1040318790,1580262420
8087,133,$LAME4,2017-06-30,539943630,1042625666,1582569296
8087,133,$LAME4,2017-09-30,539943630,1057250774,1597194404
8087,133,$LAME4,2017-12-31,539943630,1057488141,1597431771
8087,133,$LAME4,2018-03-31,539943630,1057488141,1597431771
8087,133,$LAME4,2018-06-30,539943630,1057488141,1597431771
8087,133,$LAME4,2018-09-30,539943630,1060710334,1600653964
8087,133,$LAME4,2018-12-31,539943630,1060710334,1600653964
8087,133,$LAME4,2019-03-31,539943630,1060710334,1600653964
8087,133,$LAME4,2019-06-30,539943630,1060710334,1600653964
8087,133,$LAME4,2019-09-30,539943630,1065402464,1605346094
8087,133,$LAME4,2019-12-31,539943630,1065434334,1605377964
8087,133,$LAME4,2020-03-31,545154656,1075694696,1620849352
8087,133,$LAME4,2020-06-30,545154656,1078406137,1623560793
8087,133,$LAME4,2020-09-30,653154656,1214196917,1867351573
8133,126,$LREN3,2010-12-31,122349,0,122349
8133,126,$LREN3,2011-03-31,122349,0,122349
8133,126,$LREN3,2011-06-30,122537,0,122537
8133,126,$LREN3,2011-09-30,122551,0,122551
8133,126,$LREN3,2011-12-31,122821,0,122821
8133,126,$LREN3,2012-03-31,122821,0,122821
8133,126,$LREN3,2012-06-30,123420,0,123420
8133,126,$LREN3,2012-09-30,123528,0,123528
8133,126,$LREN3,2012-12-31,124170,0,124170
8133,126,$LREN3,2013-03-31,124184,0,124184
8133,126,$LREN3,2013-06-30,124975,0,124975
8133,126,$LREN3,2013-09-30,124975,0,124975
8133,126,$LREN3,2013-12-31,125895,0,125895
8133,126,$LREN3,2014-03-31,125895,0,125895
8133,126,$LREN3,2014-06-30,126024,0,126024
8133,126,$LREN3,2014-09-30,126156,0,126156
8133,126,$LREN3,2014-12-31,127395,0,127395
8133,126,$LREN3,2015-03-31,127395,0,127395
8133,126,$LREN3,2015-06-30,127840,0,127840
8133,126,$LREN3,2015-09-30,639375,0,639375
8133,126,$LREN3,2015-12-31,640041,0,640041
8133,126,$LREN3,2016-03-31,640041,0,640041
8133,126,$LREN3,2016-06-30,642086,0,642086
8133,126,$LREN3,2016-09-30,642853,0,642853
8133,126,$LREN3,2016-12-31,643551,0,643551
8133,126,$LREN3,2017-03-31,643551,0,643551
8133,126,$LREN3,2017-06-30,711146,0,711146
8133,126,$LREN3,2017-09-30,712986,0,712986
8133,126,$LREN3,2017-12-31,713235,0,713235
8133,126,$LREN3,2018-03-31,713235,0,713235
8133,126,$LREN3,2018-06-30,716675,0,716675
8133,126,$LREN3,2018-09-30,717966,0,717966
8133,126,$LREN3,2018-12-31,720024,0,720024
8133,126,$LREN3,2019-03-31,720024,0,720024
8133,126,$LREN3,2019-06-30,793812,0,793812
8133,126,$LREN3,2019-09-30,795247,0,795247
8133,126,$LREN3,2019-12-31,795558,0,795558
8133,126,$LREN3,2020-03-31,795558,0,795558
8133,126,$LREN3,2020-06-30,795590,0,795590
8133,126,$LREN3,2020-09-30,795648,0,795648
8192,125,$8192,2010-12-31,766,985,1751
8192,125,$8192,2011-03-31,766,985,1751
8192,125,$8192,2011-06-30,766,985,1751
8192,125,$8192,2011-09-30,766,985,1751
8192,125,$8192,2011-12-31,766,985,1751
8192,125,$8192,2012-03-31,766,985,1751
8192,125,$8192,2012-06-30,766,985,1751
8192,125,$8192,2012-09-30,766,985,1751
8192,125,$8192,2012-12-31,766,985,1751
8192,125,$8192,2013-03-31,766,985,1751
8192,125,$8192,2013-06-30,766,975,1741
8192,125,$8192,2013-09-30,766,975,1741
8192,125,$8192,2013-12-31,766,975,1741
8192,125,$8192,2014-03-31,766,975,1741
8192,125,$8192,2014-06-30,766,967,1733
8192,125,$8192,2014-09-30,766,967,1733
8192,125,$8192,2014-12-31,766,967,1733
8192,125,$8192,2015-03-31,766,967,1733
8192,125,$8192,2015-06-30,1532,1932,3464
8192,125,$8192,2015-09-30,1532,1932,3464
8192,125,$8192,2015-12-31,1532,1932,3464
8192,125,$8192,2016-03-31,1532,1932,3464
8192,125,$8192,2016-06-30,1532,1932,3464
8192,125,$8192,2016-09-30,1532,1932,3464
8192,125,$8192,2016-12-31,1532,1932,3464
8192,125,$8192,2017-03-31,1532,1932,3464
8192,125,$8192,2017-06-30,2298,2898,5196
8192,125,$8192,2017-09-30,2298,2898,5196
8192,125,$8192,2017-12-31,2298,2898,5196
8192,125,$8192,2018-03-31,2298,2898,5196
8192,125,$8192,2018-06-30,2298,2898,5196
8192,125,$8192,2018-09-30,2298,2898,5196
8192,125,$8192,2018-12-31,2298,2898,5196
8192,125,$8192,2019-03-31,2298,2898,5196
8192,125,$8192,2019-06-30,2298,2898,5196
8192,125,$8192,2019-09-30,2298,2898,5196
8192,125,$8192,2019-12-31,2298,2898,5196
8192,125,$8192,2020-03-31,2298,2898,5196
8192,125,$8192,2020-06-30,2298,2898,5196
8192,125,$8192,2020-09-30,2298,2898,5196
8397,134,$MGEL3,2010-12-31,6201730,11147908,17349638
8397,134,$MGEL3,2011-03-31,6201730,11147908,17349638
8397,134,$MGEL3,2011-06-30,6201730,11147908,17349638
8397,134,$MGEL3,2011-09-30,6201730,11147908,17349638
8397,134,$MGEL3,2011-12-31,6201730,11147908,17349638
8397,134,$MGEL3,2012-03-31,6201730,11147908,17349638
8397,134,$MGEL3,2012-06-30,6201730,11147908,17349638
8397,134,$MGEL3,2012-09-30,6201730,11147908,17349638
8397,134,$MGEL3,2012-12-31,6201730,11147908,17349638
8397,134,$MGEL3,2013-03-31,6201730,11147908,17349638
8397,134,$MGEL3,2013-06-30,6201730,11147908,17349638
8397,134,$MGEL3,2013-09-30,6201730,11147908,17349638
8397,134,$MGEL3,2013-12-31,6201730,11147908,17349638
8397,134,$MGEL3,2014-03-31,6201730,11147908,17349638
8397,134,$MGEL3,2014-06-30,6201730,11147908,17349638
8397,134,$MGEL3,2014-09-30,6201730,11147908,17349638
8397,134,$MGEL3,2014-12-31,6201730,11147908,17349638
8397,134,$MGEL3,2015-03-31,6201730,11147908,17349638
8397,134,$MGEL3,2015-06-30,6201730,11147908,17349638
8397,134,$MGEL3,2015-09-30,6201730,11147908,17349638
8397,134,$MGEL3,2015-12-31,6201730,11147908,17349638
8397,134,$MGEL3,2016-03-31,6201730,11147908,17349638
8397,134,$MGEL3,2016-06-30,2067243,3715969,5783212
8397,134,$MGEL3,2016-09-30,2067243,3715969,5783212
8397,134,$MGEL3,2016-12-31,2067243,3715969,5783212
8397,134,$MGEL3,2017-03-31,2067243,3715969,5783212
8397,134,$MGEL3,2017-06-30,2067243,3715969,5783212
8397,134,$MGEL3,2017-09-30,2067243,3715969,5783212
8397,134,$MGEL3,2017-12-31,2067243,3715969,5783212
8397,134,$MGEL3,2018-03-31,2067243,3715969,5783212
8397,134,$MGEL3,2018-06-30,2067243,3715969,5783212
8397,134,$MGEL3,2018-09-30,2067243,3715969,5783212
8397,134,$MGEL3,2018-12-31,2067243,3673869,5741112
8397,134,$MGEL3,2019-03-31,2067243,3715969,5783212
8397,134,$MGEL3,2019-06-30,2067243,3715969,5783212
8397,134,$MGEL3,2019-09-30,2067243,3715969,5783212
8397,134,$MGEL3,2019-12-31,2067243,3715969,5783212
8397,134,$MGEL3,2020-03-31,2067243,3715969,5783212
8397,134,$MGEL3,2020-06-30,2067243,3715969,5783212
8397,134,$MGEL3,2020-09-30,2067243,3715969,5783212
8397,135,$MGEL4,2010-12-31,6201730,11147908,17349638
8397,135,$MGEL4,2011-03-31,6201730,11147908,17349638
8397,135,$MGEL4,2011-06-30,6201730,11147908,17349638
8397,135,$MGEL4,2011-09-30,6201730,11147908,17349638
8397,135,$MGEL4,2011-12-31,6201730,11147908,17349638
8397,135,$MGEL4,2012-03-31,6201730,11147908,17349638
8397,135,$MGEL4,2012-06-30,6201730,11147908,17349638
8397,135,$MGEL4,2012-09-30,6201730,11147908,17349638
8397,135,$MGEL4,2012-12-31,6201730,11147908,17349638
8397,135,$MGEL4,2013-03-31,6201730,11147908,17349638
8397,135,$MGEL4,2013-06-30,6201730,11147908,17349638
8397,135,$MGEL4,2013-09-30,6201730,11147908,17349638
8397,135,$MGEL4,2013-12-31,6201730,11147908,17349638
8397,135,$MGEL4,2014-03-31,6201730,11147908,17349638
8397,135,$MGEL4,2014-06-30,6201730,11147908,17349638
8397,135,$MGEL4,2014-09-30,6201730,11147908,17349638
8397,135,$MGEL4,2014-12-31,6201730,11147908,17349638
8397,135,$MGEL4,2015-03-31,6201730,11147908,17349638
8397,135,$MGEL4,2015-06-30,6201730,11147908,17349638
8397,135,$MGEL4,2015-09-30,6201730,11147908,17349638
8397,135,$MGEL4,2015-12-31,6201730,11147908,17349638
8397,135,$MGEL4,2016-03-31,6201730,11147908,17349638
8397,135,$MGEL4,2016-06-30,2067243,3715969,5783212
8397,135,$MGEL4,2016-09-30,2067243,3715969,5783212
8397,135,$MGEL4,2016-12-31,2067243,3715969,5783212
8397,135,$MGEL4,2017-03-31,2067243,3715969,5783212
8397,135,$MGEL4,2017-06-30,2067243,3715969,5783212
8397,135,$MGEL4,2017-09-30,2067243,3715969,5783212
8397,135,$MGEL4,2017-12-31,2067243,3715969,5783212
8397,135,$MGEL4,2018-03-31,2067243,3715969,5783212
8397,135,$MGEL4,2018-06-30,2067243,3715969,5783212
8397,135,$MGEL4,2018-09-30,2067243,3715969,5783212
8397,135,$MGEL4,2018-12-31,2067243,3673869,5741112
8397,135,$MGEL4,2019-03-31,2067243,3715969,5783212
8397,135,$MGEL4,2019-06-30,2067243,3715969,5783212
8397,135,$MGEL4,2019-09-30,2067243,3715969,5783212
8397,135,$MGEL4,2019-12-31,2067243,3715969,5783212
8397,135,$MGEL4,2020-03-31,2067243,3715969,5783212
8397,135,$MGEL4,2020-06-30,2067243,3715969,5783212
8397,135,$MGEL4,2020-09-30,2067243,3715969,5783212
8427,138,$ESTR4,2010-12-31,5389,10778,16167
8427,138,$ESTR4,2011-03-31,5389,10778,16167
8427,138,$ESTR4,2011-03-31,5389,10778,16167
8427,138,$ESTR4,2011-06-30,5389,10778,16167
8427,138,$ESTR4,2011-09-30,5389,10778,16167
8427,138,$ESTR4,2011-12-31,5389,10778,16167
8427,138,$ESTR4,2012-03-31,5389,10778,16167
8427,138,$ESTR4,2012-06-30,5389,10778,16167
8427,138,$ESTR4,2012-09-30,5389,10778,16167
8427,138,$ESTR4,2012-12-31,5389,10778,16167
8427,138,$ESTR4,2013-03-31,5389,10778,16167
8427,138,$ESTR4,2013-06-30,5389,10778,16167
8427,138,$ESTR4,2013-09-30,5389,10778,16167
8427,138,$ESTR4,2013-12-31,5389,10778,16167
8427,138,$ESTR4,2014-03-31,5389,10778,16167
8427,138,$ESTR4,2014-06-30,5389,10778,16167
8427,138,$ESTR4,2014-09-30,5389,10778,16167
8427,138,$ESTR4,2014-12-31,5389,10778,16167
8427,138,$ESTR4,2015-03-31,5389,10778,16167
8427,138,$ESTR4,2015-06-30,5389,10778,16167
8427,138,$ESTR4,2015-09-30,5389,10778,16167
8427,138,$ESTR4,2015-12-31,5389,10778,16167
8427,138,$ESTR4,2016-03-31,5389,10778,16167
8427,138,$ESTR4,2016-06-30,5389,10778,16167
8427,138,$ESTR4,2016-09-30,10778,5389,16167
8427,138,$ESTR4,2016-12-31,5389,10778,16167
8427,138,$ESTR4,2017-03-31,5389,10778,16167
8427,138,$ESTR4,2017-06-30,269,539,808
8427,138,$ESTR4,2017-09-30,269,539,808
8427,138,$ESTR4,2017-12-31,269,539,808
8427,138,$ESTR4,2018-03-31,269,539,808
8427,138,$ESTR4,2018-06-30,269,539,808
8427,138,$ESTR4,2018-09-30,269,539,808
8427,138,$ESTR4,2018-12-31,269,539,808
8427,138,$ESTR4,2019-03-31,269,539,808
8427,138,$ESTR4,2019-06-30,269,539,808
8427,138,$ESTR4,2019-09-30,269,539,808
8427,138,$ESTR4,2019-12-31,269,539,808
8427,138,$ESTR4,2020-03-31,269,539,808
8427,138,$ESTR4,2020-06-30,269,539,808
8427,138,$ESTR4,2020-09-30,269,539,808
8451,144,$POMO3,2010-12-31,170812872,277637170,448450042
8451,144,$POMO3,2011-03-31,170812872,277637170,448450042
8451,144,$POMO3,2011-06-30,170812872,277637170,448450042
8451,144,$POMO3,2011-09-30,170812872,277637170,448450042
8451,144,$POMO3,2011-12-31,170812872,277637170,448450042
8451,144,$POMO3,2012-03-31,170812872,277637170,448450042
8451,144,$POMO3,2012-06-30,170812872,277637170,448450042
8451,144,$POMO3,2012-09-30,170812872,277637170,448450042
8451,144,$POMO3,2012-12-31,170812872,277637170,448450042
8451,144,$POMO3,2013-03-31,170812872,277637170,448450042
8451,144,$POMO3,2013-06-30,170812872,277637170,448450042
8451,144,$POMO3,2013-09-30,341625744,555274340,896900084
8451,144,$POMO3,2013-12-31,341625744,555274340,896900084
8451,144,$POMO3,2014-03-31,341625744,555274340,896900084
8451,144,$POMO3,2014-06-30,341625744,555274340,896900084
8451,144,$POMO3,2014-09-30,341625744,555274340,896900084
8451,144,$POMO3,2014-12-31,341625744,555274340,896900084
8451,144,$POMO3,2015-03-31,341625744,555274340,896900084
8451,144,$POMO3,2015-06-30,341625744,555274340,896900084
8451,144,$POMO3,2015-09-30,341625744,555274340,896900084
8451,144,$POMO3,2015-12-31,341625744,555274340,896900084
8451,144,$POMO3,2016-03-31,341625744,555274340,896900084
8451,144,$POMO3,2016-06-30,341625744,555274340,896900084
8451,144,$POMO3,2016-09-30,341625744,567382491,909008235
8451,144,$POMO3,2016-12-31,341625744,583570265,925196009
8451,144,$POMO3,2017-03-31,341625744,583570265,925196009
8451,144,$POMO3,2017-06-30,341625744,583570265,925196009
8451,144,$POMO3,2017-09-30,341625744,583570265,925196009
8451,144,$POMO3,2017-12-31,341625744,583570265,925196009
8451,144,$POMO3,2018-03-31,341625744,583570265,925196009
8451,144,$POMO3,2018-06-30,341625744,583570265,925196009
8451,144,$POMO3,2018-09-30,341625744,583570265,925196009
8451,144,$POMO3,2018-12-31,341625744,583570265,925196009
8451,144,$POMO3,2019-03-31,341625744,605267138,946892882
8451,144,$POMO3,2019-06-30,341625744,605267138,946892882
8451,144,$POMO3,2019-09-30,341625744,605267138,946892882
8451,144,$POMO3,2019-12-31,341625744,605267138,946892882
8451,144,$POMO3,2020-03-31,341625744,605267138,946892882
8451,144,$POMO3,2020-06-30,341625744,605267138,946892882
8451,144,$POMO3,2020-09-30,341625744,605267138,946892882
8451,145,$POMO4,2010-12-31,170812872,277637170,448450042
8451,145,$POMO4,2011-03-31,170812872,277637170,448450042
8451,145,$POMO4,2011-06-30,170812872,277637170,448450042
8451,145,$POMO4,2011-09-30,170812872,277637170,448450042
8451,145,$POMO4,2011-12-31,170812872,277637170,448450042
8451,145,$POMO4,2012-03-31,170812872,277637170,448450042
8451,145,$POMO4,2012-06-30,170812872,277637170,448450042
8451,145,$POMO4,2012-09-30,170812872,277637170,448450042
8451,145,$POMO4,2012-12-31,170812872,277637170,448450042
8451,145,$POMO4,2013-03-31,170812872,277637170,448450042
8451,145,$POMO4,2013-06-30,170812872,277637170,448450042
8451,145,$POMO4,2013-09-30,341625744,555274340,896900084
8451,145,$POMO4,2013-12-31,341625744,555274340,896900084
8451,145,$POMO4,2014-03-31,341625744,555274340,896900084
8451,145,$POMO4,2014-06-30,341625744,555274340,896900084
8451,145,$POMO4,2014-09-30,341625744,555274340,896900084
8451,145,$POMO4,2014-12-31,341625744,555274340,896900084
8451,145,$POMO4,2015-03-31,341625744,555274340,896900084
8451,145,$POMO4,2015-06-30,341625744,555274340,896900084
8451,145,$POMO4,2015-09-30,341625744,555274340,896900084
8451,145,$POMO4,2015-12-31,341625744,555274340,896900084
8451,145,$POMO4,2016-03-31,341625744,555274340,896900084
8451,145,$POMO4,2016-06-30,341625744,555274340,896900084
8451,145,$POMO4,2016-09-30,341625744,567382491,909008235
8451,145,$POMO4,2016-12-31,341625744,583570265,925196009
8451,145,$POMO4,2017-03-31,341625744,583570265,925196009
8451,145,$POMO4,2017-06-30,341625744,583570265,925196009
8451,145,$POMO4,2017-09-30,341625744,583570265,925196009
8451,145,$POMO4,2017-12-31,341625744,583570265,925196009
8451,145,$POMO4,2018-03-31,341625744,583570265,925196009
8451,145,$POMO4,2018-06-30,341625744,583570265,925196009
8451,145,$POMO4,2018-09-30,341625744,583570265,925196009
8451,145,$POMO4,2018-12-31,341625744,583570265,925196009
8451,145,$POMO4,2019-03-31,341625744,605267138,946892882
8451,145,$POMO4,2019-06-30,341625744,605267138,946892882
8451,145,$POMO4,2019-09-30,341625744,605267138,946892882
8451,145,$POMO4,2019-12-31,341625744,605267138,946892882
8451,145,$POMO4,2020-03-31,341625744,605267138,946892882
8451,145,$POMO4,2020-06-30,341625744,605267138,946892882
8451,145,$POMO4,2020-09-30,341625744,605267138,946892882
8540,128,$MERC3,2010-12-31,6647,5113,11760
8540,128,$MERC3,2011-03-31,6647,5113,11760
8540,128,$MERC3,2011-06-30,6647,5113,11760
8540,128,$MERC3,2011-09-30,6647,5113,11760
8540,128,$MERC3,2011-12-31,6647,5113,11760
8540,128,$MERC3,2012-03-31,6647,5113,11760
8540,128,$MERC3,2012-06-30,6647,5113,11760
8540,128,$MERC3,2012-09-30,6647,5113,11760
8540,128,$MERC3,2012-12-31,6647,5113,11760
8540,128,$MERC3,2013-03-31,6647,5113,11760
8540,128,$MERC3,2013-06-30,6647,5113,11760
8540,128,$MERC3,2013-09-30,6647,5113,11760
8540,128,$MERC3,2013-12-31,6647,5113,11760
8540,128,$MERC3,2014-03-31,6647,5113,11760
8540,128,$MERC3,2014-06-30,10180,7830,18010
8540,128,$MERC3,2014-09-30,10180,7830,18010
8540,128,$MERC3,2014-12-31,10180,7830,18010
8540,128,$MERC3,2015-03-31,10180,7830,18010
8540,128,$MERC3,2015-06-30,10180,7830,18010
8540,128,$MERC3,2015-09-30,10180,7830,18010
8540,128,$MERC3,2015-12-31,10180,7830,18010
8540,128,$MERC3,2016-03-31,10180,7830,18010
8540,128,$MERC3,2016-06-30,10180,7830,18010
8540,128,$MERC3,2016-09-30,10180,7830,18010
8540,128,$MERC3,2016-12-31,10180,7830,18010
8540,128,$MERC3,2017-03-31,10180,7830,18010
8540,128,$MERC3,2017-06-30,10180,7830,18010
8540,128,$MERC3,2017-09-30,10180,7830,18010
8540,128,$MERC3,2017-12-31,10180,7830,18010
8540,128,$MERC3,2018-03-31,10180,7830,18010
8540,128,$MERC3,2018-06-30,10180,7830,18010
8540,128,$MERC3,2018-09-30,10180,7830,18010
8540,128,$MERC3,2018-12-31,10180,7830,18010
8540,128,$MERC3,2019-03-31,10180,7830,18010
8540,128,$MERC3,2019-06-30,10180,7830,18010
8540,128,$MERC3,2019-09-30,10180,7830,18010
8540,128,$MERC3,2019-12-31,10180,7830,18010
8540,128,$MERC3,2020-03-31,10180,7830,18010
8540,128,$MERC3,2020-06-30,10180,7830,18010
8540,128,$MERC3,2020-09-30,10180,7830,18010
8540,129,$MERC4,2010-12-31,6647,5113,11760
8540,129,$MERC4,2011-03-31,6647,5113,11760
8540,129,$MERC4,2011-06-30,6647,5113,11760
8540,129,$MERC4,2011-09-30,6647,5113,11760
8540,129,$MERC4,2011-12-31,6647,5113,11760
8540,129,$MERC4,2012-03-31,6647,5113,11760
8540,129,$MERC4,2012-06-30,6647,5113,11760
8540,129,$MERC4,2012-09-30,6647,5113,11760
8540,129,$MERC4,2012-12-31,6647,5113,11760
8540,129,$MERC4,2013-03-31,6647,5113,11760
8540,129,$MERC4,2013-06-30,6647,5113,11760
8540,129,$MERC4,2013-09-30,6647,5113,11760
8540,129,$MERC4,2013-12-31,6647,5113,11760
8540,129,$MERC4,2014-03-31,6647,5113,11760
8540,129,$MERC4,2014-06-30,10180,7830,18010
8540,129,$MERC4,2014-09-30,10180,7830,18010
8540,129,$MERC4,2014-12-31,10180,7830,18010
8540,129,$MERC4,2015-03-31,10180,7830,18010
8540,129,$MERC4,2015-06-30,10180,7830,18010
8540,129,$MERC4,2015-09-30,10180,7830,18010
8540,129,$MERC4,2015-12-31,10180,7830,18010
8540,129,$MERC4,2016-03-31,10180,7830,18010
8540,129,$MERC4,2016-06-30,10180,7830,18010
8540,129,$MERC4,2016-09-30,10180,7830,18010
8540,129,$MERC4,2016-12-31,10180,7830,18010
8540,129,$MERC4,2017-03-31,10180,7830,18010
8540,129,$MERC4,2017-06-30,10180,7830,18010
8540,129,$MERC4,2017-09-30,10180,7830,18010
8540,129,$MERC4,2017-12-31,10180,7830,18010
8540,129,$MERC4,2018-03-31,10180,7830,18010
8540,129,$MERC4,2018-06-30,10180,7830,18010
8540,129,$MERC4,2018-09-30,10180,7830,18010
8540,129,$MERC4,2018-12-31,10180,7830,18010
8540,129,$MERC4,2019-03-31,10180,7830,18010
8540,129,$MERC4,2019-06-30,10180,7830,18010
8540,129,$MERC4,2019-09-30,10180,7830,18010
8540,129,$MERC4,2019-12-31,10180,7830,18010
8540,129,$MERC4,2020-03-31,10180,7830,18010
8540,129,$MERC4,2020-06-30,10180,7830,18010
8540,129,$MERC4,2020-09-30,10180,7830,18010
8575,141,$LEVE3,2010-12-31,42769500,0,42769500
8575,141,$LEVE3,2011-03-31,42769500,0,42769500
8575,141,$LEVE3,2011-06-30,42769500,0,42769500
8575,141,$LEVE3,2011-09-30,42769500,0,42769500
8575,141,$LEVE3,2011-12-31,42769500,0,42769500
8575,141,$LEVE3,2012-03-31,42769500,0,42769500
8575,141,$LEVE3,2012-06-30,128308500,0,128308500
8575,141,$LEVE3,2012-09-30,128308500,0,128308500
8575,141,$LEVE3,2012-12-31,128308500,0,128308500
8575,141,$LEVE3,2013-03-31,128308500,0,128308500
8575,141,$LEVE3,2013-06-30,128308500,0,128308500
8575,141,$LEVE3,2013-09-30,128308500,0,128308500
8575,141,$LEVE3,2013-12-31,128308500,0,128308500
8575,141,$LEVE3,2014-03-31,128308500,0,128308500
8575,141,$LEVE3,2014-06-30,128308500,0,128308500
8575,141,$LEVE3,2014-09-30,128308500,0,128308500
8575,141,$LEVE3,2014-12-31,128308500,0,128308500
8575,141,$LEVE3,2015-03-31,128308500,0,128308500
8575,141,$LEVE3,2015-06-30,128308500,0,128308500
8575,141,$LEVE3,2015-09-30,128308500,0,128308500
8575,141,$LEVE3,2015-12-31,128308500,0,128308500
8575,141,$LEVE3,2016-03-31,128308500,0,128308500
8575,141,$LEVE3,2016-06-30,128308500,0,128308500
8575,141,$LEVE3,2016-09-30,128308500,0,128308500
8575,141,$LEVE3,2016-12-31,128308500,0,128308500
8575,141,$LEVE3,2017-03-31,128308500,0,128308500
8575,141,$LEVE3,2017-06-30,128308500,0,128308500
8575,141,$LEVE3,2017-09-30,128308500,0,128308500
8575,141,$LEVE3,2017-12-31,128308500,0,128308500
8575,141,$LEVE3,2018-03-31,128308500,0,128308500
8575,141,$LEVE3,2018-06-30,128308500,0,128308500
8575,141,$LEVE3,2018-09-30,128308500,0,128308500
8575,141,$LEVE3,2018-12-31,128308500,0,128308500
8575,141,$LEVE3,2019-03-31,128308500,0,128308500
8575,141,$LEVE3,2019-06-30,128308500,0,128308500
8575,141,$LEVE3,2019-09-30,128308500,0,128308500
8575,141,$LEVE3,2019-12-31,128308500,0,128308500
8575,141,$LEVE3,2020-03-31,128308500,0,128308500
8575,141,$LEVE3,2020-06-30,128308500,0,128308500
8575,141,$LEVE3,2020-09-30,128308500,0,128308500
8605,136,$MITG03,2010-12-31,104172000,208344000,312516000
8605,136,$MITG03,2011-03-31,104172,208344,312516
8605,136,$MITG03,2011-06-30,104172,208344,312516
8605,136,$MITG03,2011-09-30,104172,208344,312516
8605,136,$MITG03,2011-12-31,104172000,208344000,312516000
8605,136,$MITG03,2012-03-31,104172,208344,312516
8605,136,$MITG03,2012-06-30,104172,208344,312516
8605,136,$MITG03,2012-09-30,104172,208344,312516
8605,136,$MITG03,2012-12-31,104172000,208344000,312516000
8605,136,$MITG03,2013-03-31,104172,208344,312516
8605,136,$MITG03,2013-06-30,104172,208344,312516
8605,136,$MITG03,2013-09-30,104172,208344,312516
8605,136,$MITG03,2013-12-31,104172000,208344000,312516000
8605,136,$MITG03,2014-03-31,104172,208344,312516
8605,136,$MITG03,2014-06-30,104172,208344,312516
8605,136,$MITG03,2014-09-30,104172,208344,312516
8605,136,$MITG03,2014-12-31,104172000,208344000,312516000
8605,136,$MITG03,2015-03-31,104172,208344,312516
8605,136,$MITG03,2015-06-30,2083,4167,6250
8605,136,$MITG03,2015-09-30,2083,4167,6250
8605,136,$MITG03,2015-12-31,2083440,4166880,6250320
8605,136,$MITG03,2016-03-31,2083440,4166880,6250320
8605,136,$MITG03,2016-06-30,69448,138896,208344
8605,136,$MITG03,2016-09-30,69448,138896,208344
8605,136,$MITG03,2016-12-31,80448,160896,241344
8605,136,$MITG03,2017-03-31,80448,160896,241344
8605,136,$MITG03,2017-06-30,80448,160896,241344
8605,136,$MITG03,2017-09-30,80448,160896,241344
8605,136,$MITG03,2017-12-31,80448,160896,241344
8605,136,$MITG03,2018-03-31,80448,160896,241344
8605,136,$MITG03,2018-06-30,80448,160896,241344
8605,136,$MITG03,2018-09-30,80448,160896,241344
8605,136,$MITG03,2018-12-31,80448,160896,241344
8605,136,$MITG03,2019-03-31,80448,160896,241344
8605,136,$MITG03,2019-06-30,80448,160896,241344
8605,136,$MITG03,2019-09-30,80448,160896,241344
8605,136,$MITG03,2019-12-31,80448,160896,241344
8605,136,$MITG03,2020-03-31,80448,160896,241344
8605,136,$MITG03,2020-06-30,80448,160896,241344
8605,136,$MITG03,2020-09-30,80448,160896,241344
8605,137,$MITG04,2010-12-31,104172000,208344000,312516000
8605,137,$MITG04,2011-03-31,104172,208344,312516
8605,137,$MITG04,2011-06-30,104172,208344,312516
8605,137,$MITG04,2011-09-30,104172,208344,312516
8605,137,$MITG04,2011-12-31,104172000,208344000,312516000
8605,137,$MITG04,2012-03-31,104172,208344,312516
8605,137,$MITG04,2012-06-30,104172,208344,312516
8605,137,$MITG04,2012-09-30,104172,208344,312516
8605,137,$MITG04,2012-12-31,104172000,208344000,312516000
8605,137,$MITG04,2013-03-31,104172,208344,312516
8605,137,$MITG04,2013-06-30,104172,208344,312516
8605,137,$MITG04,2013-09-30,104172,208344,312516
8605,137,$MITG04,2013-12-31,104172000,208344000,312516000
8605,137,$MITG04,2014-03-31,104172,208344,312516
8605,137,$MITG04,2014-06-30,104172,208344,312516
8605,137,$MITG04,2014-09-30,104172,208344,312516
8605,137,$MITG04,2014-12-31,104172000,208344000,312516000
8605,137,$MITG04,2015-03-31,104172,208344,312516
8605,137,$MITG04,2015-06-30,2083,4167,6250
8605,137,$MITG04,2015-09-30,2083,4167,6250
8605,137,$MITG04,2015-12-31,2083440,4166880,6250320
8605,137,$MITG04,2016-03-31,2083440,4166880,6250320
8605,137,$MITG04,2016-06-30,69448,138896,208344
8605,137,$MITG04,2016-09-30,69448,138896,208344
8605,137,$MITG04,2016-12-31,80448,160896,241344
8605,137,$MITG04,2017-03-31,80448,160896,241344
8605,137,$MITG04,2017-06-30,80448,160896,241344
8605,137,$MITG04,2017-09-30,80448,160896,241344
8605,137,$MITG04,2017-12-31,80448,160896,241344
8605,137,$MITG04,2018-03-31,80448,160896,241344
8605,137,$MITG04,2018-06-30,80448,160896,241344
8605,137,$MITG04,2018-09-30,80448,160896,241344
8605,137,$MITG04,2018-12-31,80448,160896,241344
8605,137,$MITG04,2019-03-31,80448,160896,241344
8605,137,$MITG04,2019-06-30,80448,160896,241344
8605,137,$MITG04,2019-09-30,80448,160896,241344
8605,137,$MITG04,2019-12-31,80448,160896,241344
8605,137,$MITG04,2020-03-31,80448,160896,241344
8605,137,$MITG04,2020-06-30,80448,160896,241344
8605,137,$MITG04,2020-09-30,80448,160896,241344
8656,147,$GOAU3,2010-12-31,137619,275063,412682
8656,147,$GOAU3,2011-03-31,137618994,275062544,412681538
8656,147,$GOAU3,2011-06-30,137618994,275062544,412681538
8656,147,$GOAU3,2011-09-30,137618994,275062544,412681538
8656,147,$GOAU3,2011-12-31,137619,275062,412681
8656,147,$GOAU3,2012-03-31,137618994,275062544,412681538
8656,147,$GOAU3,2012-06-30,137618994,275062544,412681538
8656,147,$GOAU3,2012-09-30,137618994,275062544,412681538
8656,147,$GOAU3,2012-12-31,137618994,275062544,412681538
8656,147,$GOAU3,2013-03-31,137618994,275062544,412681538
8656,147,$GOAU3,2013-06-30,137618994,275062544,412681538
8656,147,$GOAU3,2013-09-30,137618994,275062544,412681538
8656,147,$GOAU3,2013-12-31,137618994,275062544,412681538
8656,147,$GOAU3,2014-03-31,137618994,275062544,412681538
8656,147,$GOAU3,2014-06-30,137618994,275062544,412681538
8656,147,$GOAU3,2014-09-30,137618994,275062544,412681538
8656,147,$GOAU3,2014-12-31,137618994,275062544,412681538
8656,147,$GOAU3,2015-03-31,137618994,275062544,412681538
8656,147,$GOAU3,2015-06-30,137618994,275062544,412681538
8656,147,$GOAU3,2015-09-30,137618994,275062544,412681538
8656,147,$GOAU3,2015-12-31,306923979,605757559,912681538
8656,147,$GOAU3,2016-03-31,306923979,605757559,912681538
8656,147,$GOAU3,2016-06-30,306923979,605757559,912681538
8656,147,$GOAU3,2016-09-30,307666387,607242375,914908762
8656,147,$GOAU3,2016-12-31,323987702,639885005,963872707
8656,147,$GOAU3,2017-03-31,329467079,650843759,980310838
8656,147,$GOAU3,2017-06-30,329957462,651824525,981781987
8656,147,$GOAU3,2017-09-30,330021614,651952829,981974443
8656,147,$GOAU3,2017-12-31,330071442,652052485,982123927
8656,147,$GOAU3,2018-03-31,330460178,652829957,983290135
8656,147,$GOAU3,2018-06-30,330521314,652952229,983473543
8656,147,$GOAU3,2018-09-30,330698131,653305863,984003994
8656,147,$GOAU3,2018-12-31,331256682,654422965,985679647
8656,147,$GOAU3,2019-03-31,331640474,655190549,986831023
8656,147,$GOAU3,2019-06-30,331870871,655651343,987522214
8656,147,$GOAU3,2019-09-30,365111201,722132003,1087243204
8656,147,$GOAU3,2019-12-31,365111201,722132003,1087243204
8656,147,$GOAU3,2020-03-31,365111201,722132003,1087243204
8656,147,$GOAU3,2020-06-30,365111201,722132003,1087243204
8656,147,$GOAU3,2020-09-30,365111201,722132003,1087243204
8656,148,$GOAU4,2010-12-31,137619,275063,412682
8656,148,$GOAU4,2011-03-31,137618994,275062544,412681538
8656,148,$GOAU4,2011-06-30,137618994,275062544,412681538
8656,148,$GOAU4,2011-09-30,137618994,275062544,412681538
8656,148,$GOAU4,2011-12-31,137619,275062,412681
8656,148,$GOAU4,2012-03-31,137618994,275062544,412681538
8656,148,$GOAU4,2012-06-30,137618994,275062544,412681538
8656,148,$GOAU4,2012-09-30,137618994,275062544,412681538
8656,148,$GOAU4,2012-12-31,137618994,275062544,412681538
8656,148,$GOAU4,2013-03-31,137618994,275062544,412681538
8656,148,$GOAU4,2013-06-30,137618994,275062544,412681538
8656,148,$GOAU4,2013-09-30,137618994,275062544,412681538
8656,148,$GOAU4,2013-12-31,137618994,275062544,412681538
8656,148,$GOAU4,2014-03-31,137618994,275062544,412681538
8656,148,$GOAU4,2014-06-30,137618994,275062544,412681538
8656,148,$GOAU4,2014-09-30,137618994,275062544,412681538
8656,148,$GOAU4,2014-12-31,137618994,275062544,412681538
8656,148,$GOAU4,2015-03-31,137618994,275062544,412681538
8656,148,$GOAU4,2015-06-30,137618994,275062544,412681538
8656,148,$GOAU4,2015-09-30,137618994,275062544,412681538
8656,148,$GOAU4,2015-12-31,306923979,605757559,912681538
8656,148,$GOAU4,2016-03-31,306923979,605757559,912681538
8656,148,$GOAU4,2016-06-30,306923979,605757559,912681538
8656,148,$GOAU4,2016-09-30,307666387,607242375,914908762
8656,148,$GOAU4,2016-12-31,323987702,639885005,963872707
8656,148,$GOAU4,2017-03-31,329467079,650843759,980310838
8656,148,$GOAU4,2017-06-30,329957462,651824525,981781987
8656,148,$GOAU4,2017-09-30,330021614,651952829,981974443
8656,148,$GOAU4,2017-12-31,330071442,652052485,982123927
8656,148,$GOAU4,2018-03-31,330460178,652829957,983290135
8656,148,$GOAU4,2018-06-30,330521314,652952229,983473543
8656,148,$GOAU4,2018-09-30,330698131,653305863,984003994
8656,148,$GOAU4,2018-12-31,331256682,654422965,985679647
8656,148,$GOAU4,2019-03-31,331640474,655190549,986831023
8656,148,$GOAU4,2019-06-30,331870871,655651343,987522214
8656,148,$GOAU4,2019-09-30,365111201,722132003,1087243204
8656,148,$GOAU4,2019-12-31,365111201,722132003,1087243204
8656,148,$GOAU4,2020-03-31,365111201,722132003,1087243204
8656,148,$GOAU4,2020-06-30,365111201,722132003,1087243204
8656,148,$GOAU4,2020-09-30,365111201,722132003,1087243204
8672,149,$MLFT3,2010-12-31,385823,578116,963939
8672,149,$MLFT3,2011-03-31,385823,578116,963939
8672,149,$MLFT3,2011-06-30,385823,578116,963939
8672,149,$MLFT3,2011-09-30,385823,578116,963939
8672,149,$MLFT3,2011-12-31,385823,578116,963939
8672,149,$MLFT3,2012-03-31,385823,578116,963939
8672,149,$MLFT3,2012-06-30,385823,578116,963939
8672,149,$MLFT3,2012-09-30,385823,578116,963939
8672,149,$MLFT3,2012-12-31,385823,578116,963939
8672,149,$MLFT3,2013-03-31,385823,578116,963939
8672,149,$MLFT3,2013-06-30,385823,578116,963939
8672,149,$MLFT3,2013-09-30,385823,578116,963939
8672,149,$MLFT3,2013-12-31,385823,578116,963939
8672,149,$MLFT3,2014-03-31,385823,578116,963939
8672,149,$MLFT3,2014-06-30,385823,578116,963939
8672,149,$MLFT3,2014-09-30,385823,578116,963939
8672,149,$MLFT3,2014-12-31,385823,578116,963939
8672,149,$MLFT3,2015-03-31,385823,578116,963939
8672,149,$MLFT3,2015-06-30,385823,578116,963939
8672,149,$MLFT3,2015-09-30,385823,578116,963939
8672,149,$MLFT3,2015-12-31,385823,578116,963939
8672,149,$MLFT3,2016-03-31,385823,578116,963939
8672,149,$MLFT3,2016-06-30,38582,57812,96394
8672,149,$MLFT3,2016-09-30,38582,57812,96394
8672,149,$MLFT3,2016-12-31,38578,55487,94065
8672,149,$MLFT3,2017-03-31,38577,54794,93371
8672,149,$MLFT3,2017-06-30,38577,54794,93371
8672,149,$MLFT3,2017-09-30,38577,54794,93371
8672,149,$MLFT3,2017-12-31,87892,0,87892
8672,149,$MLFT3,2018-03-31,87889,0,87889
8672,149,$MLFT3,2018-06-30,87889,0,87889
8672,149,$MLFT3,2018-09-30,87889,0,87889
8672,149,$MLFT3,2018-12-31,87889,0,87889
8672,149,$MLFT3,2019-03-31,87889,0,87889
8672,149,$MLFT3,2019-06-30,87889,0,87889
8672,149,$MLFT3,2019-09-30,87889,0,87889
8672,149,$MLFT3,2019-12-31,87889,0,87889
8672,149,$MLFT3,2020-03-31,87889,0,87889
8672,149,$MLFT3,2020-06-30,87889,0,87889
8672,149,$MLFT3,2020-09-30,87889,0,87889
8672,150,$MLFT4,2010-12-31,385823,578116,963939
8672,150,$MLFT4,2011-03-31,385823,578116,963939
8672,150,$MLFT4,2011-06-30,385823,578116,963939
8672,150,$MLFT4,2011-09-30,385823,578116,963939
8672,150,$MLFT4,2011-12-31,385823,578116,963939
8672,150,$MLFT4,2012-03-31,385823,578116,963939
8672,150,$MLFT4,2012-06-30,385823,578116,963939
8672,150,$MLFT4,2012-09-30,385823,578116,963939
8672,150,$MLFT4,2012-12-31,385823,578116,963939
8672,150,$MLFT4,2013-03-31,385823,578116,963939
8672,150,$MLFT4,2013-06-30,385823,578116,963939
8672,150,$MLFT4,2013-09-30,385823,578116,963939
8672,150,$MLFT4,2013-12-31,385823,578116,963939
8672,150,$MLFT4,2014-03-31,385823,578116,963939
8672,150,$MLFT4,2014-06-30,385823,578116,963939
8672,150,$MLFT4,2014-09-30,385823,578116,963939
8672,150,$MLFT4,2014-12-31,385823,578116,963939
8672,150,$MLFT4,2015-03-31,385823,578116,963939
8672,150,$MLFT4,2015-06-30,385823,578116,963939
8672,150,$MLFT4,2015-09-30,385823,578116,963939
8672,150,$MLFT4,2015-12-31,385823,578116,963939
8672,150,$MLFT4,2016-03-31,385823,578116,963939
8672,150,$MLFT4,2016-06-30,38582,57812,96394
8672,150,$MLFT4,2016-09-30,38582,57812,96394
8672,150,$MLFT4,2016-12-31,38578,55487,94065
8672,150,$MLFT4,2017-03-31,38577,54794,93371
8672,150,$MLFT4,2017-06-30,38577,54794,93371
8672,150,$MLFT4,2017-09-30,38577,54794,93371
8672,150,$MLFT4,2017-12-31,87892,0,87892
8672,150,$MLFT4,2018-03-31,87889,0,87889
8672,150,$MLFT4,2018-06-30,87889,0,87889
8672,150,$MLFT4,2018-09-30,87889,0,87889
8672,150,$MLFT4,2018-12-31,87889,0,87889
8672,150,$MLFT4,2019-03-31,87889,0,87889
8672,150,$MLFT4,2019-06-30,87889,0,87889
8672,150,$MLFT4,2019-09-30,87889,0,87889
8672,150,$MLFT4,2019-12-31,87889,0,87889
8672,150,$MLFT4,2020-03-31,87889,0,87889
8672,150,$MLFT4,2020-06-30,87889,0,87889
8672,150,$MLFT4,2020-09-30,87889,0,87889
8672,151,$JPSA3,2010-12-31,385823,578116,963939
8672,151,$JPSA3,2011-03-31,385823,578116,963939
8672,151,$JPSA3,2011-06-30,385823,578116,963939
8672,151,$JPSA3,2011-09-30,385823,578116,963939
8672,151,$JPSA3,2011-12-31,385823,578116,963939
8672,151,$JPSA3,2012-03-31,385823,578116,963939
8672,151,$JPSA3,2012-06-30,385823,578116,963939
8672,151,$JPSA3,2012-09-30,385823,578116,963939
8672,151,$JPSA3,2012-12-31,385823,578116,963939
8672,151,$JPSA3,2013-03-31,385823,578116,963939
8672,151,$JPSA3,2013-06-30,385823,578116,963939
8672,151,$JPSA3,2013-09-30,385823,578116,963939
8672,151,$JPSA3,2013-12-31,385823,578116,963939
8672,151,$JPSA3,2014-03-31,385823,578116,963939
8672,151,$JPSA3,2014-06-30,385823,578116,963939
8672,151,$JPSA3,2014-09-30,385823,578116,963939
8672,151,$JPSA3,2014-12-31,385823,578116,963939
8672,151,$JPSA3,2015-03-31,385823,578116,963939
8672,151,$JPSA3,2015-06-30,385823,578116,963939
8672,151,$JPSA3,2015-09-30,385823,578116,963939
8672,151,$JPSA3,2015-12-31,385823,578116,963939
8672,151,$JPSA3,2016-03-31,385823,578116,963939
8672,151,$JPSA3,2016-06-30,38582,57812,96394
8672,151,$JPSA3,2016-09-30,38582,57812,96394
8672,151,$JPSA3,2016-12-31,38578,55487,94065
8672,151,$JPSA3,2017-03-31,38577,54794,93371
8672,151,$JPSA3,2017-06-30,38577,54794,93371
8672,151,$JPSA3,2017-09-30,38577,54794,93371
8672,151,$JPSA3,2017-12-31,87892,0,87892
8672,151,$JPSA3,2018-03-31,87889,0,87889
8672,151,$JPSA3,2018-06-30,87889,0,87889
8672,151,$JPSA3,2018-09-30,87889,0,87889
8672,151,$JPSA3,2018-12-31,87889,0,87889
8672,151,$JPSA3,2019-03-31,87889,0,87889
8672,151,$JPSA3,2019-06-30,87889,0,87889
8672,151,$JPSA3,2019-09-30,87889,0,87889
8672,151,$JPSA3,2019-12-31,87889,0,87889
8672,151,$JPSA3,2020-03-31,87889,0,87889
8672,151,$JPSA3,2020-06-30,87889,0,87889
8672,151,$JPSA3,2020-09-30,87889,0,87889
8753,142,$MTSA3,2010-12-31,4212530,5551953,9764483
8753,142,$MTSA3,2011-03-31,4212530,5551953,9764483
8753,142,$MTSA3,2011-06-30,4212530,5551953,9764483
8753,142,$MTSA3,2011-09-30,4212530,5551953,9764483
8753,142,$MTSA3,2011-12-31,4212530,5551953,9764483
8753,142,$MTSA3,2012-03-31,4212530,5551953,9764483
8753,142,$MTSA3,2012-06-30,4212530,5551953,9764483
8753,142,$MTSA3,2012-09-30,4212530,5551953,9764483
8753,142,$MTSA3,2012-12-31,4212530,5551953,9764483
8753,142,$MTSA3,2013-03-31,4212530,5551953,9764483
8753,142,$MTSA3,2013-06-30,4212530,5551953,9764483
8753,142,$MTSA3,2013-09-30,4212530,5551953,9764483
8753,142,$MTSA3,2013-12-31,4212530,5551953,9764483
8753,142,$MTSA3,2014-03-31,4212530,5551953,9764483
8753,142,$MTSA3,2014-06-30,4212530,5551953,9764483
8753,142,$MTSA3,2014-09-30,4212530,5551953,9764483
8753,142,$MTSA3,2014-12-31,4212530,5551953,9764483
8753,142,$MTSA3,2015-03-31,4212530,5551953,9764483
8753,142,$MTSA3,2015-06-30,4212530,4924733,9137263
8753,142,$MTSA3,2015-09-30,4212530,4924733,9137263
8753,142,$MTSA3,2015-12-31,4212530,4924733,9137263
8753,142,$MTSA3,2016-03-31,4212530,4924733,9137263
8753,142,$MTSA3,2016-06-30,4212530,4924733,9137263
8753,142,$MTSA3,2016-09-30,4212530,4924733,9137263
8753,142,$MTSA3,2016-12-31,4212530,4924733,9137263
8753,142,$MTSA3,2017-03-31,4212530,4924733,9137263
8753,142,$MTSA3,2017-06-30,4212530,4924733,9137263
8753,142,$MTSA3,2017-09-30,4212530,4924733,9137263
8753,142,$MTSA3,2017-12-31,4212530,4924733,9137263
8753,142,$MTSA3,2018-03-31,4212530,4924733,9137263
8753,142,$MTSA3,2018-06-30,4212530,4924733,9137263
8753,142,$MTSA3,2018-09-30,4212530,4924733,9137263
8753,142,$MTSA3,2018-12-31,4212530,4924733,9137263
8753,142,$MTSA3,2019-03-31,4212530,4924733,9137263
8753,142,$MTSA3,2019-06-30,4212530,4924733,9137263
8753,142,$MTSA3,2019-09-30,4212530,4924733,9137263
8753,142,$MTSA3,2019-12-31,4212530,4924733,9137263
8753,142,$MTSA3,2020-03-31,4212530,4924733,9137263
8753,142,$MTSA3,2020-06-30,4212530,4924733,9137263
8753,142,$MTSA3,2020-09-30,4212530,4924733,9137263
8753,143,$MTSA4,2010-12-31,4212530,5551953,9764483
8753,143,$MTSA4,2011-03-31,4212530,5551953,9764483
8753,143,$MTSA4,2011-06-30,4212530,5551953,9764483
8753,143,$MTSA4,2011-09-30,4212530,5551953,9764483
8753,143,$MTSA4,2011-12-31,4212530,5551953,9764483
8753,143,$MTSA4,2012-03-31,4212530,5551953,9764483
8753,143,$MTSA4,2012-06-30,4212530,5551953,9764483
8753,143,$MTSA4,2012-09-30,4212530,5551953,9764483
8753,143,$MTSA4,2012-12-31,4212530,5551953,9764483
8753,143,$MTSA4,2013-03-31,4212530,5551953,9764483
8753,143,$MTSA4,2013-06-30,4212530,5551953,9764483
8753,143,$MTSA4,2013-09-30,4212530,5551953,9764483
8753,143,$MTSA4,2013-12-31,4212530,5551953,9764483
8753,143,$MTSA4,2014-03-31,4212530,5551953,9764483
8753,143,$MTSA4,2014-06-30,4212530,5551953,9764483
8753,143,$MTSA4,2014-09-30,4212530,5551953,9764483
8753,143,$MTSA4,2014-12-31,4212530,5551953,9764483
8753,143,$MTSA4,2015-03-31,4212530,5551953,9764483
8753,143,$MTSA4,2015-06-30,4212530,4924733,9137263
8753,143,$MTSA4,2015-09-30,4212530,4924733,9137263
8753,143,$MTSA4,2015-12-31,4212530,4924733,9137263
8753,143,$MTSA4,2016-03-31,4212530,4924733,9137263
8753,143,$MTSA4,2016-06-30,4212530,4924733,9137263
8753,143,$MTSA4,2016-09-30,4212530,4924733,9137263
8753,143,$MTSA4,2016-12-31,4212530,4924733,9137263
8753,143,$MTSA4,2017-03-31,4212530,4924733,9137263
8753,143,$MTSA4,2017-06-30,4212530,4924733,9137263
8753,143,$MTSA4,2017-09-30,4212530,4924733,9137263
8753,143,$MTSA4,2017-12-31,4212530,4924733,9137263
8753,143,$MTSA4,2018-03-31,4212530,4924733,9137263
8753,143,$MTSA4,2018-06-30,4212530,4924733,9137263
8753,143,$MTSA4,2018-09-30,4212530,4924733,9137263
8753,143,$MTSA4,2018-12-31,4212530,4924733,9137263
8753,143,$MTSA4,2019-03-31,4212530,4924733,9137263
8753,143,$MTSA4,2019-06-30,4212530,4924733,9137263
8753,143,$MTSA4,2019-09-30,4212530,4924733,9137263
8753,143,$MTSA4,2019-12-31,4212530,4924733,9137263
8753,143,$MTSA4,2020-03-31,4212530,4924733,9137263
8753,143,$MTSA4,2020-06-30,4212530,4924733,9137263
8753,143,$MTSA4,2020-09-30,4212530,4924733,9137263
8818,139,$MMAQ3,2010-12-31,22,22,44
8818,139,$MMAQ3,2011-03-31,22,22,44
8818,139,$MMAQ3,2011-06-30,22,22,44
8818,139,$MMAQ3,2011-09-30,22,22,44
8818,139,$MMAQ3,2011-12-31,22,22,44
8818,139,$MMAQ3,2012-03-31,22,22,44
8818,139,$MMAQ3,2012-06-30,22,22,44
8818,139,$MMAQ3,2012-09-30,22,22,44
8818,139,$MMAQ3,2012-12-31,22,22,44
8818,139,$MMAQ3,2013-03-31,22,22,44
8818,139,$MMAQ3,2013-06-30,22,22,44
8818,139,$MMAQ3,2013-09-30,22,22,44
8818,139,$MMAQ3,2013-12-31,22,22,44
8818,139,$MMAQ3,2014-03-31,22,22,44
8818,139,$MMAQ3,2014-06-30,22,22,44
8818,139,$MMAQ3,2014-09-30,22,22,44
8818,139,$MMAQ3,2014-12-31,22,22,44
8818,139,$MMAQ3,2015-03-31,22,22,44
8818,139,$MMAQ3,2015-06-30,22,22,44
8818,139,$MMAQ3,2015-09-30,22,22,44
8818,139,$MMAQ3,2015-12-31,22,22,44
8818,139,$MMAQ3,2016-03-31,22,22,44
8818,139,$MMAQ3,2016-06-30,22,22,44
8818,139,$MMAQ3,2016-09-30,22,22,44
8818,139,$MMAQ3,2016-12-31,22,22,44
8818,139,$MMAQ3,2017-03-31,22,22,44
8818,139,$MMAQ3,2017-06-30,22,22,44
8818,139,$MMAQ3,2017-09-30,22,22,44
8818,139,$MMAQ3,2017-12-31,22,22,44
8818,139,$MMAQ3,2018-03-31,22,22,44
8818,139,$MMAQ3,2018-06-30,22,22,44
8818,139,$MMAQ3,2018-09-30,22,22,44
8818,139,$MMAQ3,2018-12-31,22,22,44
8818,139,$MMAQ3,2019-03-31,22,22,44
8818,139,$MMAQ3,2019-06-30,22,22,44
8818,139,$MMAQ3,2019-09-30,22,22,44
8818,139,$MMAQ3,2019-12-31,22,22,44
8818,139,$MMAQ3,2020-03-31,22,22,44
8818,139,$MMAQ3,2020-06-30,22,22,44
8818,139,$MMAQ3,2020-09-30,22,22,44
8818,140,$MMAQ4,2010-12-31,22,22,44
8818,140,$MMAQ4,2011-03-31,22,22,44
8818,140,$MMAQ4,2011-06-30,22,22,44
8818,140,$MMAQ4,2011-09-30,22,22,44
8818,140,$MMAQ4,2011-12-31,22,22,44
8818,140,$MMAQ4,2012-03-31,22,22,44
8818,140,$MMAQ4,2012-06-30,22,22,44
8818,140,$MMAQ4,2012-09-30,22,22,44
8818,140,$MMAQ4,2012-12-31,22,22,44
8818,140,$MMAQ4,2013-03-31,22,22,44
8818,140,$MMAQ4,2013-06-30,22,22,44
8818,140,$MMAQ4,2013-09-30,22,22,44
8818,140,$MMAQ4,2013-12-31,22,22,44
8818,140,$MMAQ4,2014-03-31,22,22,44
8818,140,$MMAQ4,2014-06-30,22,22,44
8818,140,$MMAQ4,2014-09-30,22,22,44
8818,140,$MMAQ4,2014-12-31,22,22,44
8818,140,$MMAQ4,2015-03-31,22,22,44
8818,140,$MMAQ4,2015-06-30,22,22,44
8818,140,$MMAQ4,2015-09-30,22,22,44
8818,140,$MMAQ4,2015-12-31,22,22,44
8818,140,$MMAQ4,2016-03-31,22,22,44
8818,140,$MMAQ4,2016-06-30,22,22,44
8818,140,$MMAQ4,2016-09-30,22,22,44
8818,140,$MMAQ4,2016-12-31,22,22,44
8818,140,$MMAQ4,2017-03-31,22,22,44
8818,140,$MMAQ4,2017-06-30,22,22,44
8818,140,$MMAQ4,2017-09-30,22,22,44
8818,140,$MMAQ4,2017-12-31,22,22,44
8818,140,$MMAQ4,2018-03-31,22,22,44
8818,140,$MMAQ4,2018-06-30,22,22,44
8818,140,$MMAQ4,2018-09-30,22,22,44
8818,140,$MMAQ4,2018-12-31,22,22,44
8818,140,$MMAQ4,2019-03-31,22,22,44
8818,140,$MMAQ4,2019-06-30,22,22,44
8818,140,$MMAQ4,2019-09-30,22,22,44
8818,140,$MMAQ4,2019-12-31,22,22,44
8818,140,$MMAQ4,2020-03-31,22,22,44
8818,140,$MMAQ4,2020-06-30,22,22,44
8818,140,$MMAQ4,2020-09-30,22,22,44
8893,155,$MOAR3,2010-12-31,11298,0,11298
8893,155,$MOAR3,2011-03-31,11298,0,11298
8893,155,$MOAR3,2011-06-30,11298,0,11298
8893,155,$MOAR3,2011-09-30,11298,0,11298
8893,155,$MOAR3,2011-12-31,11298,0,11298
8893,155,$MOAR3,2012-03-31,11298,0,11298
8893,155,$MOAR3,2012-06-30,11298,0,11298
8893,155,$MOAR3,2012-09-30,11298,0,11298
8893,155,$MOAR3,2012-12-31,11298,0,11298
8893,155,$MOAR3,2013-03-31,12251,0,12251
8893,155,$MOAR3,2013-06-30,12251,0,12251
8893,155,$MOAR3,2013-09-30,12251,0,12251
8893,155,$MOAR3,2013-12-31,12251,0,12251
8893,155,$MOAR3,2014-03-31,12251,0,12251
8893,155,$MOAR3,2014-06-30,12251,0,12251
8893,155,$MOAR3,2014-09-30,12251,0,12251
8893,155,$MOAR3,2014-12-31,12251,0,12251
8893,155,$MOAR3,2015-03-31,12251,0,12251
8893,155,$MOAR3,2015-06-30,12251,0,12251
8893,155,$MOAR3,2015-09-30,12251,0,12251
8893,155,$MOAR3,2015-12-31,12251,0,12251
8893,155,$MOAR3,2016-03-31,12251,0,12251
8893,155,$MOAR3,2016-06-30,12251,0,12251
8893,155,$MOAR3,2016-09-30,12251,0,12251
8893,155,$MOAR3,2016-12-31,12251,0,12251
8893,155,$MOAR3,2017-03-31,12251,0,12251
8893,155,$MOAR3,2017-06-30,12251,0,12251
8893,155,$MOAR3,2017-09-30,12251,0,12251
8893,155,$MOAR3,2017-12-31,12251,0,12251
8893,155,$MOAR3,2018-03-31,12251,0,12251
8893,155,$MOAR3,2018-06-30,12251,0,12251
8893,155,$MOAR3,2018-09-30,12251,0,12251
8893,155,$MOAR3,2018-12-31,12251221,0,12251221
8893,155,$MOAR3,2019-03-31,12251221,0,12251221
8893,155,$MOAR3,2019-06-30,12251221,0,12251221
8893,155,$MOAR3,2019-09-30,12251221,0,12251221
8893,155,$MOAR3,2019-12-31,12251221,0,12251221
8893,155,$MOAR3,2020-03-31,12251221,0,12251221
8893,155,$MOAR3,2020-06-30,12251221,0,12251221
8893,155,$MOAR3,2020-09-30,12251221,0,12251221
9067,156,$NEMO3,2010-12-31,53200,73553,126753
9067,156,$NEMO3,2011-03-31,53200,73553,126753
9067,156,$NEMO3,2011-06-30,53200,73553,126753
9067,156,$NEMO3,2011-09-30,53200,73553,126753
9067,156,$NEMO3,2011-12-31,53200,73553,126753
9067,156,$NEMO3,2012-03-31,53200,73553,126753
9067,156,$NEMO3,2012-06-30,53200,73553,126753
9067,156,$NEMO3,2012-09-30,53200,73553,126753
9067,156,$NEMO3,2012-12-31,53200,73553,126753
9067,156,$NEMO3,2013-03-31,53200,73553,126753
9067,156,$NEMO3,2013-06-30,70805,97893,168698
9067,156,$NEMO3,2013-09-30,70805,97893,168698
9067,156,$NEMO3,2013-12-31,70805,97893,168698
9067,156,$NEMO3,2014-03-31,70805,97893,168698
9067,156,$NEMO3,2014-06-30,70805,97893,168698
9067,156,$NEMO3,2014-09-30,70805,97893,168698
9067,156,$NEMO3,2014-12-31,70805,97893,168698
9067,156,$NEMO3,2015-03-31,70805,97893,168698
9067,156,$NEMO3,2015-06-30,70805,97893,168698
9067,156,$NEMO3,2015-09-30,70805,97893,168698
9067,156,$NEMO3,2015-12-31,70805,97893,168698
9067,156,$NEMO3,2016-03-31,70805,97893,168698
9067,156,$NEMO3,2016-06-30,70805,97893,168698
9067,156,$NEMO3,2016-09-30,75034,97893,172927
9067,156,$NEMO3,2016-12-31,75034,97893,172927
9067,156,$NEMO3,2017-03-31,75034,97893,172927
9067,156,$NEMO3,2017-06-30,75034,97893,172927
9067,156,$NEMO3,2017-09-30,75034,97893,172927
9067,156,$NEMO3,2017-12-31,75034,97893,172927
9067,156,$NEMO3,2018-03-31,75034,97893,172927
9067,156,$NEMO3,2018-06-30,75034,97893,172927
9067,156,$NEMO3,2018-09-30,75034,97893,172927
9067,156,$NEMO3,2018-12-31,75034,97893,172927
9067,156,$NEMO3,2019-03-31,75034,97893,172927
9067,156,$NEMO3,2019-06-30,75034,97893,172927
9067,156,$NEMO3,2019-09-30,75034,97893,172927
9067,156,$NEMO3,2019-12-31,75034,97893,172927
9067,156,$NEMO3,2020-03-31,75034,97893,172927
9067,156,$NEMO3,2020-06-30,75034,97893,172927
9067,156,$NEMO3,2020-09-30,75034,97893,172927
9067,157,$NEMO5,2010-12-31,53200,73553,126753
9067,157,$NEMO5,2011-03-31,53200,73553,126753
9067,157,$NEMO5,2011-06-30,53200,73553,126753
9067,157,$NEMO5,2011-09-30,53200,73553,126753
9067,157,$NEMO5,2011-12-31,53200,73553,126753
9067,157,$NEMO5,2012-03-31,53200,73553,126753
9067,157,$NEMO5,2012-06-30,53200,73553,126753
9067,157,$NEMO5,2012-09-30,53200,73553,126753
9067,157,$NEMO5,2012-12-31,53200,73553,126753
9067,157,$NEMO5,2013-03-31,53200,73553,126753
9067,157,$NEMO5,2013-06-30,70805,97893,168698
9067,157,$NEMO5,2013-09-30,70805,97893,168698
9067,157,$NEMO5,2013-12-31,70805,97893,168698
9067,157,$NEMO5,2014-03-31,70805,97893,168698
9067,157,$NEMO5,2014-06-30,70805,97893,168698
9067,157,$NEMO5,2014-09-30,70805,97893,168698
9067,157,$NEMO5,2014-12-31,70805,97893,168698
9067,157,$NEMO5,2015-03-31,70805,97893,168698
9067,157,$NEMO5,2015-06-30,70805,97893,168698
9067,157,$NEMO5,2015-09-30,70805,97893,168698
9067,157,$NEMO5,2015-12-31,70805,97893,168698
9067,157,$NEMO5,2016-03-31,70805,97893,168698
9067,157,$NEMO5,2016-06-30,70805,97893,168698
9067,157,$NEMO5,2016-09-30,75034,97893,172927
9067,157,$NEMO5,2016-12-31,75034,97893,172927
9067,157,$NEMO5,2017-03-31,75034,97893,172927
9067,157,$NEMO5,2017-06-30,75034,97893,172927
9067,157,$NEMO5,2017-09-30,75034,97893,172927
9067,157,$NEMO5,2017-12-31,75034,97893,172927
9067,157,$NEMO5,2018-03-31,75034,97893,172927
9067,157,$NEMO5,2018-06-30,75034,97893,172927
9067,157,$NEMO5,2018-09-30,75034,97893,172927
9067,157,$NEMO5,2018-12-31,75034,97893,172927
9067,157,$NEMO5,2019-03-31,75034,97893,172927
9067,157,$NEMO5,2019-06-30,75034,97893,172927
9067,157,$NEMO5,2019-09-30,75034,97893,172927
9067,157,$NEMO5,2019-12-31,75034,97893,172927
9067,157,$NEMO5,2020-03-31,75034,97893,172927
9067,157,$NEMO5,2020-06-30,75034,97893,172927
9067,157,$NEMO5,2020-09-30,75034,97893,172927
9067,158,$NEMO6,2010-12-31,53200,73553,126753
9067,158,$NEMO6,2011-03-31,53200,73553,126753
9067,158,$NEMO6,2011-06-30,53200,73553,126753
9067,158,$NEMO6,2011-09-30,53200,73553,126753
9067,158,$NEMO6,2011-12-31,53200,73553,126753
9067,158,$NEMO6,2012-03-31,53200,73553,126753
9067,158,$NEMO6,2012-06-30,53200,73553,126753
9067,158,$NEMO6,2012-09-30,53200,73553,126753
9067,158,$NEMO6,2012-12-31,53200,73553,126753
9067,158,$NEMO6,2013-03-31,53200,73553,126753
9067,158,$NEMO6,2013-06-30,70805,97893,168698
9067,158,$NEMO6,2013-09-30,70805,97893,168698
9067,158,$NEMO6,2013-12-31,70805,97893,168698
9067,158,$NEMO6,2014-03-31,70805,97893,168698
9067,158,$NEMO6,2014-06-30,70805,97893,168698
9067,158,$NEMO6,2014-09-30,70805,97893,168698
9067,158,$NEMO6,2014-12-31,70805,97893,168698
9067,158,$NEMO6,2015-03-31,70805,97893,168698
9067,158,$NEMO6,2015-06-30,70805,97893,168698
9067,158,$NEMO6,2015-09-30,70805,97893,168698
9067,158,$NEMO6,2015-12-31,70805,97893,168698
9067,158,$NEMO6,2016-03-31,70805,97893,168698
9067,158,$NEMO6,2016-06-30,70805,97893,168698
9067,158,$NEMO6,2016-09-30,75034,97893,172927
9067,158,$NEMO6,2016-12-31,75034,97893,172927
9067,158,$NEMO6,2017-03-31,75034,97893,172927
9067,158,$NEMO6,2017-06-30,75034,97893,172927
9067,158,$NEMO6,2017-09-30,75034,97893,172927
9067,158,$NEMO6,2017-12-31,75034,97893,172927
9067,158,$NEMO6,2018-03-31,75034,97893,172927
9067,158,$NEMO6,2018-06-30,75034,97893,172927
9067,158,$NEMO6,2018-09-30,75034,97893,172927
9067,158,$NEMO6,2018-12-31,75034,97893,172927
9067,158,$NEMO6,2019-03-31,75034,97893,172927
9067,158,$NEMO6,2019-06-30,75034,97893,172927
9067,158,$NEMO6,2019-09-30,75034,97893,172927
9067,158,$NEMO6,2019-12-31,75034,97893,172927
9067,158,$NEMO6,2020-03-31,75034,97893,172927
9067,158,$NEMO6,2020-06-30,75034,97893,172927
9067,158,$NEMO6,2020-09-30,75034,97893,172927
9083,146,$1,2010-12-31,6621487,0,6621487
9083,146,$1,2011-03-31,6621487,0,6621487
9083,146,$1,2011-06-30,6621487,0,6621487
9083,146,$1,2011-09-30,6621487,0,6621487
9083,146,$1,2011-12-31,6621487,0,6621487
9083,146,$1,2012-03-31,6621487,0,6621487
9083,146,$1,2012-06-30,6621487,0,6621487
9083,146,$1,2012-09-30,6621487,0,6621487
9083,146,$1,2012-12-31,6621487,0,6621487
9083,146,$1,2013-03-31,6621487,0,6621487
9083,146,$1,2013-06-30,6621487,0,6621487
9083,146,$1,2013-09-30,6621487,0,6621487
9083,146,$1,2013-12-31,6621487,0,6621487
9083,146,$1,2014-03-31,6621487,0,6621487
9083,146,$1,2014-06-30,6621487,0,6621487
9083,146,$1,2014-09-30,6621487,0,6621487
9083,146,$1,2014-12-31,6621487,0,6621487
9083,146,$1,2015-03-31,6621487,0,6621487
9083,146,$1,2015-06-30,6621487,0,6621487
9083,146,$1,2015-09-30,6621487,0,6621487
9083,146,$1,2015-12-31,6621487,0,6621487
9083,146,$1,2016-03-31,6621487,0,6621487
9083,146,$1,2016-06-30,6621,0,6621
9083,146,$1,2016-09-30,6621,0,6621
9083,146,$1,2016-12-31,6621,0,6621
9083,146,$1,2017-03-31,6621,0,6621
9083,146,$1,2017-06-30,6621,0,6621
9083,146,$1,2017-09-30,6621,0,6621
9083,146,$1,2017-12-31,6621,0,6621
9083,146,$1,2018-03-31,6621,0,6621
9083,146,$1,2018-06-30,6621,0,6621
9083,146,$1,2018-09-30,6621,0,6621
9083,146,$1,2018-12-31,6621,0,6621
9083,146,$1,2019-03-31,6621,0,6621
9083,146,$1,2019-06-30,6621,0,6621
9083,146,$1,2019-09-30,6621,0,6621
9083,146,$1,2019-12-31,6621,0,6621
9083,146,$1,2020-03-31,6621,0,6621
9083,146,$1,2020-06-30,6621,0,6621
9083,146,$1,2020-09-30,6621,0,6621
9342,159,$PNVL3,2010-12-31,4142194,450003,4592197
9342,159,$PNVL3,2011-03-31,4142194,450003,4592197
9342,159,$PNVL3,2011-06-30,4128059,450003,4578062
9342,159,$PNVL3,2011-09-30,4128059,450003,4578062
9342,159,$PNVL3,2011-12-31,4128059,450003,4578062
9342,159,$PNVL3,2012-03-31,4128059,450003,4578062
9342,159,$PNVL3,2012-06-30,4121059,449523,4570582
9342,159,$PNVL3,2012-09-30,4121059,449523,4570582
9342,159,$PNVL3,2012-12-31,4121059,449523,4570582
9342,159,$PNVL3,2013-03-31,4121059,449523,4570582
9342,159,$PNVL3,2013-06-30,4119052,449523,4568575
9342,159,$PNVL3,2013-09-30,4119052,449523,4568575
9342,159,$PNVL3,2013-12-31,4119052,449523,4568575
9342,159,$PNVL3,2014-03-31,4119052,449523,4568575
9342,159,$PNVL3,2014-06-30,4116052,449523,4565575
9342,159,$PNVL3,2014-09-30,4116052,449523,4565575
9342,159,$PNVL3,2014-12-31,4116052,449523,4565575
9342,159,$PNVL3,2015-03-31,4116052,449523,4565575
9342,159,$PNVL3,2015-06-30,4116052,449523,4565575
9342,159,$PNVL3,2015-09-30,4116052,449523,4565575
9342,159,$PNVL3,2015-12-31,4116052,449523,4565575
9342,159,$PNVL3,2016-03-31,4116052,449523,4565575
9342,159,$PNVL3,2016-06-30,4109790,449523,4559313
9342,159,$PNVL3,2016-09-30,4109790,449523,4559313
9342,159,$PNVL3,2016-12-31,4109790,449523,4559313
9342,159,$PNVL3,2017-03-31,4109790,449523,4559313
9342,159,$PNVL3,2017-06-30,4109790,449523,4559313
9342,159,$PNVL3,2017-09-30,4109790,449523,4559313
9342,159,$PNVL3,2017-12-31,4109790,449523,4559313
9342,159,$PNVL3,2018-03-31,4109790,449523,4559313
9342,159,$PNVL3,2018-06-30,4094790,449523,4544313
9342,159,$PNVL3,2018-09-30,4092790,449523,4542313
9342,159,$PNVL3,2018-12-31,4092790,449523,4542313
9342,159,$PNVL3,2019-03-31,4092790,449523,4542313
9342,159,$PNVL3,2019-06-30,4066490,449523,4516013
9342,159,$PNVL3,2019-09-30,4066490,449523,4516013
9342,159,$PNVL3,2019-12-31,4066490,449523,4516013
9342,159,$PNVL3,2020-03-31,121994700,13485690,135480390
9342,159,$PNVL3,2020-06-30,121994700,13485690,135480390
9342,159,$PNVL3,2020-09-30,137994700,13485690,151480390
9342,160,$PNVL4,2010-12-31,4142194,450003,4592197
9342,160,$PNVL4,2011-03-31,4142194,450003,4592197
9342,160,$PNVL4,2011-06-30,4128059,450003,4578062
9342,160,$PNVL4,2011-09-30,4128059,450003,4578062
9342,160,$PNVL4,2011-12-31,4128059,450003,4578062
9342,160,$PNVL4,2012-03-31,4128059,450003,4578062
9342,160,$PNVL4,2012-06-30,4121059,449523,4570582
9342,160,$PNVL4,2012-09-30,4121059,449523,4570582
9342,160,$PNVL4,2012-12-31,4121059,449523,4570582
9342,160,$PNVL4,2013-03-31,4121059,449523,4570582
9342,160,$PNVL4,2013-06-30,4119052,449523,4568575
9342,160,$PNVL4,2013-09-30,4119052,449523,4568575
9342,160,$PNVL4,2013-12-31,4119052,449523,4568575
9342,160,$PNVL4,2014-03-31,4119052,449523,4568575
9342,160,$PNVL4,2014-06-30,4116052,449523,4565575
9342,160,$PNVL4,2014-09-30,4116052,449523,4565575
9342,160,$PNVL4,2014-12-31,4116052,449523,4565575
9342,160,$PNVL4,2015-03-31,4116052,449523,4565575
9342,160,$PNVL4,2015-06-30,4116052,449523,4565575
9342,160,$PNVL4,2015-09-30,4116052,449523,4565575
9342,160,$PNVL4,2015-12-31,4116052,449523,4565575
9342,160,$PNVL4,2016-03-31,4116052,449523,4565575
9342,160,$PNVL4,2016-06-30,4109790,449523,4559313
9342,160,$PNVL4,2016-09-30,4109790,449523,4559313
9342,160,$PNVL4,2016-12-31,4109790,449523,4559313
9342,160,$PNVL4,2017-03-31,4109790,449523,4559313
9342,160,$PNVL4,2017-06-30,4109790,449523,4559313
9342,160,$PNVL4,2017-09-30,4109790,449523,4559313
9342,160,$PNVL4,2017-12-31,4109790,449523,4559313
9342,160,$PNVL4,2018-03-31,4109790,449523,4559313
9342,160,$PNVL4,2018-06-30,4094790,449523,4544313
9342,160,$PNVL4,2018-09-30,4092790,449523,4542313
9342,160,$PNVL4,2018-12-31,4092790,449523,4542313
9342,160,$PNVL4,2019-03-31,4092790,449523,4542313
9342,160,$PNVL4,2019-06-30,4066490,449523,4516013
9342,160,$PNVL4,2019-09-30,4066490,449523,4516013
9342,160,$PNVL4,2019-12-31,4066490,449523,4516013
9342,160,$PNVL4,2020-03-31,121994700,13485690,135480390
9342,160,$PNVL4,2020-06-30,121994700,13485690,135480390
9342,160,$PNVL4,2020-09-30,137994700,13485690,151480390
9393,169,$PMAM3,2010-12-31,319176942,0,319176942
9393,169,$PMAM3,2011-03-31,319176942,0,319176942
9393,169,$PMAM3,2011-06-30,319176942,0,319176942
9393,169,$PMAM3,2011-09-30,319176942,0,319176942
9393,169,$PMAM3,2011-12-31,319176942,0,319176942
9393,169,$PMAM3,2012-03-31,319176942,0,319176942
9393,169,$PMAM3,2012-06-30,319176942,0,319176942
9393,169,$PMAM3,2012-09-30,319176942,0,319176942
9393,169,$PMAM3,2012-12-31,319176942,0,319176942
9393,169,$PMAM3,2013-03-31,319176942,0,319176942
9393,169,$PMAM3,2013-06-30,319176942,0,319176942
9393,169,$PMAM3,2013-09-30,319176942,0,319176942
9393,169,$PMAM3,2013-12-31,319176942,0,319176942
9393,169,$PMAM3,2014-03-31,319176942,0,319176942
9393,169,$PMAM3,2014-06-30,319176942,0,319176942
9393,169,$PMAM3,2014-09-30,319176942,0,319176942
9393,169,$PMAM3,2014-12-31,319176942,0,319176942
9393,169,$PMAM3,2015-03-31,319176942,0,319176942
9393,169,$PMAM3,2015-06-30,319176942,0,319176942
9393,169,$PMAM3,2015-09-30,319176942,0,319176942
9393,169,$PMAM3,2015-12-31,319176942,0,319176942
9393,169,$PMAM3,2016-03-31,319176942,0,319176942
9393,169,$PMAM3,2016-06-30,319176942,0,319176942
9393,169,$PMAM3,2016-09-30,319176942,0,319176942
9393,169,$PMAM3,2016-12-31,319176942,0,319176942
9393,169,$PMAM3,2017-03-31,319176942,0,319176942
9393,169,$PMAM3,2017-06-30,319176942,0,319176942
9393,169,$PMAM3,2017-09-30,545047960,0,545047960
9393,169,$PMAM3,2017-12-31,688933769,0,688933769
9393,169,$PMAM3,2018-03-31,692370186,0,692370186
9393,169,$PMAM3,2018-06-30,692370186,0,692370186
9393,169,$PMAM3,2018-09-30,692370186,0,692370186
9393,169,$PMAM3,2018-12-31,692370186,0,692370186
9393,169,$PMAM3,2019-03-31,692370186,0,692370186
9393,169,$PMAM3,2019-06-30,41350802,0,41350802
9393,169,$PMAM3,2019-09-30,43403849,0,43403849
9393,169,$PMAM3,2019-12-31,43403849,0,43403849
9393,169,$PMAM3,2020-03-31,43403849,0,43403849
9393,169,$PMAM3,2020-06-30,43403849,0,43403849
9393,169,$PMAM3,2020-09-30,43403849,0,43403849
9415,152,$AHEB3,2010-12-31,4080,114,4194
9415,152,$AHEB3,2011-03-31,4080,114,4194
9415,152,$AHEB3,2011-06-30,4080,114,4194
9415,152,$AHEB3,2011-09-30,4080,114,4194
9415,152,$AHEB3,2011-12-31,4080,114,4194
9415,152,$AHEB3,2012-03-31,4455,98,4553
9415,152,$AHEB3,2012-06-30,4455,98,4553
9415,152,$AHEB3,2012-09-30,4460,114,4574
9415,152,$AHEB3,2012-12-31,4460,113,4573
9415,152,$AHEB3,2013-03-31,4460,113,4573
9415,152,$AHEB3,2013-06-30,4460,113,4573
9415,152,$AHEB3,2013-09-30,4460,113,4573
9415,152,$AHEB3,2013-12-31,4460,113,4573
9415,152,$AHEB3,2014-03-31,4460,113,4573
9415,152,$AHEB3,2014-06-30,5064,113,5177
9415,152,$AHEB3,2014-09-30,5064,113,5177
9415,152,$AHEB3,2014-12-31,5064,113,5177
9415,152,$AHEB3,2015-03-31,5064,113,5177
9415,152,$AHEB3,2015-06-30,5064,113,5177
9415,152,$AHEB3,2015-09-30,5064,113,5177
9415,152,$AHEB3,2015-12-31,5064,113,5177
9415,152,$AHEB3,2016-03-31,5064,113,5177
9415,152,$AHEB3,2016-06-30,5064,113,5177
9415,152,$AHEB3,2016-09-30,5064,113,5177
9415,152,$AHEB3,2016-12-31,5064,113,5177
9415,152,$AHEB3,2017-03-31,5064,113,5177
9415,152,$AHEB3,2017-06-30,5064,113,5177
9415,152,$AHEB3,2017-09-30,5064,113,5177
9415,152,$AHEB3,2017-12-31,5064,113,5177
9415,152,$AHEB3,2018-03-31,5064,113,5177
9415,152,$AHEB3,2018-06-30,5064,113,5177
9415,152,$AHEB3,2018-09-30,7390,132,7522
9415,152,$AHEB3,2018-12-31,7390,132,7522
9415,152,$AHEB3,2019-03-31,7390,131,7521
9415,152,$AHEB3,2019-06-30,7390,131,7521
9415,152,$AHEB3,2019-09-30,7390,131,7521
9415,152,$AHEB3,2019-12-31,7390,131,7521
9415,152,$AHEB3,2020-03-31,7390,131,7521
9415,152,$AHEB3,2020-06-30,8407,135,8542
9415,152,$AHEB3,2020-09-30,8407,136,8543
9415,153,$AHEB5,2010-12-31,4080,114,4194
9415,153,$AHEB5,2011-03-31,4080,114,4194
9415,153,$AHEB5,2011-06-30,4080,114,4194
9415,153,$AHEB5,2011-09-30,4080,114,4194
9415,153,$AHEB5,2011-12-31,4080,114,4194
9415,153,$AHEB5,2012-03-31,4455,98,4553
9415,153,$AHEB5,2012-06-30,4455,98,4553
9415,153,$AHEB5,2012-09-30,4460,114,4574
9415,153,$AHEB5,2012-12-31,4460,113,4573
9415,153,$AHEB5,2013-03-31,4460,113,4573
9415,153,$AHEB5,2013-06-30,4460,113,4573
9415,153,$AHEB5,2013-09-30,4460,113,4573
9415,153,$AHEB5,2013-12-31,4460,113,4573
9415,153,$AHEB5,2014-03-31,4460,113,4573
9415,153,$AHEB5,2014-06-30,5064,113,5177
9415,153,$AHEB5,2014-09-30,5064,113,5177
9415,153,$AHEB5,2014-12-31,5064,113,5177
9415,153,$AHEB5,2015-03-31,5064,113,5177
9415,153,$AHEB5,2015-06-30,5064,113,5177
9415,153,$AHEB5,2015-09-30,5064,113,5177
9415,153,$AHEB5,2015-12-31,5064,113,5177
9415,153,$AHEB5,2016-03-31,5064,113,5177
9415,153,$AHEB5,2016-06-30,5064,113,5177
9415,153,$AHEB5,2016-09-30,5064,113,5177
9415,153,$AHEB5,2016-12-31,5064,113,5177
9415,153,$AHEB5,2017-03-31,5064,113,5177
9415,153,$AHEB5,2017-06-30,5064,113,5177
9415,153,$AHEB5,2017-09-30,5064,113,5177
9415,153,$AHEB5,2017-12-31,5064,113,5177
9415,153,$AHEB5,2018-03-31,5064,113,5177
9415,153,$AHEB5,2018-06-30,5064,113,5177
9415,153,$AHEB5,2018-09-30,7390,132,7522
9415,153,$AHEB5,2018-12-31,7390,132,7522
9415,153,$AHEB5,2019-03-31,7390,131,7521
9415,153,$AHEB5,2019-06-30,7390,131,7521
9415,153,$AHEB5,2019-09-30,7390,131,7521
9415,153,$AHEB5,2019-12-31,7390,131,7521
9415,153,$AHEB5,2020-03-31,7390,131,7521
9415,153,$AHEB5,2020-06-30,8407,135,8542
9415,153,$AHEB5,2020-09-30,8407,136,8543
9415,154,$AHEB6,2010-12-31,4080,114,4194
9415,154,$AHEB6,2011-03-31,4080,114,4194
9415,154,$AHEB6,2011-06-30,4080,114,4194
9415,154,$AHEB6,2011-09-30,4080,114,4194
9415,154,$AHEB6,2011-12-31,4080,114,4194
9415,154,$AHEB6,2012-03-31,4455,98,4553
9415,154,$AHEB6,2012-06-30,4455,98,4553
9415,154,$AHEB6,2012-09-30,4460,114,4574
9415,154,$AHEB6,2012-12-31,4460,113,4573
9415,154,$AHEB6,2013-03-31,4460,113,4573
9415,154,$AHEB6,2013-06-30,4460,113,4573
9415,154,$AHEB6,2013-09-30,4460,113,4573
9415,154,$AHEB6,2013-12-31,4460,113,4573
9415,154,$AHEB6,2014-03-31,4460,113,4573
9415,154,$AHEB6,2014-06-30,5064,113,5177
9415,154,$AHEB6,2014-09-30,5064,113,5177
9415,154,$AHEB6,2014-12-31,5064,113,5177
9415,154,$AHEB6,2015-03-31,5064,113,5177
9415,154,$AHEB6,2015-06-30,5064,113,5177
9415,154,$AHEB6,2015-09-30,5064,113,5177
9415,154,$AHEB6,2015-12-31,5064,113,5177
9415,154,$AHEB6,2016-03-31,5064,113,5177
9415,154,$AHEB6,2016-06-30,5064,113,5177
9415,154,$AHEB6,2016-09-30,5064,113,5177
9415,154,$AHEB6,2016-12-31,5064,113,5177
9415,154,$AHEB6,2017-03-31,5064,113,5177
9415,154,$AHEB6,2017-06-30,5064,113,5177
9415,154,$AHEB6,2017-09-30,5064,113,5177
9415,154,$AHEB6,2017-12-31,5064,113,5177
9415,154,$AHEB6,2018-03-31,5064,113,5177
9415,154,$AHEB6,2018-06-30,5064,113,5177
9415,154,$AHEB6,2018-09-30,7390,132,7522
9415,154,$AHEB6,2018-12-31,7390,132,7522
9415,154,$AHEB6,2019-03-31,7390,131,7521
9415,154,$AHEB6,2019-06-30,7390,131,7521
9415,154,$AHEB6,2019-09-30,7390,131,7521
9415,154,$AHEB6,2019-12-31,7390,131,7521
9415,154,$AHEB6,2020-03-31,7390,131,7521
9415,154,$AHEB6,2020-06-30,8407,135,8542
9415,154,$AHEB6,2020-09-30,8407,136,8543
9512,176,$PETR3,2010-12-31,7442454,5602043,13044497
9512,176,$PETR3,2011-03-31,7442454,5602043,13044497
9512,176,$PETR3,2011-06-30,7442454,5602043,13044497
9512,176,$PETR3,2011-09-30,7442454,5602043,13044497
9512,176,$PETR3,2011-09-30,7442454,5602043,13044497
9512,176,$PETR3,2011-12-31,7442454,5602043,13044497
9512,176,$PETR3,2011-12-31,7442454,5602043,13044497
9512,176,$PETR3,2012-03-31,7442454,5602043,13044497
9512,176,$PETR3,2012-06-30,7442454,5602043,13044497
9512,176,$PETR3,2012-09-30,7442454,5602043,13044497
9512,176,$PETR3,2012-12-31,7442454,5602043,13044497
9512,176,$PETR3,2013-03-31,7442454,5602043,13044497
9512,176,$PETR3,2013-06-30,7442454,5602043,13044497
9512,176,$PETR3,2013-09-30,7442454,5602043,13044497
9512,176,$PETR3,2013-12-31,7442454,5602043,13044497
9512,176,$PETR3,2014-03-31,7442454,5602043,13044497
9512,176,$PETR3,2014-06-30,7442454,5602043,13044497
9512,176,$PETR3,2014-09-30,7442454,5602043,13044497
9512,176,$PETR3,2014-12-31,7442454,5602043,13044497
9512,176,$PETR3,2014-12-31,7442454,5602043,13044497
9512,176,$PETR3,2015-03-31,7442454,5602043,13044497
9512,176,$PETR3,2015-06-30,7442454,5602043,13044497
9512,176,$PETR3,2015-09-30,7442454,5602042,13044496
9512,176,$PETR3,2015-12-31,7442454,5602043,13044497
9512,176,$PETR3,2016-03-31,7442454,5602043,13044497
9512,176,$PETR3,2016-06-30,7442454,5602043,13044497
9512,176,$PETR3,2016-09-30,7442454,5602043,13044497
9512,176,$PETR3,2016-12-31,7442454,5602043,13044497
9512,176,$PETR3,2016-12-31,7442454,5602043,13044497
9512,176,$PETR3,2017-03-31,7442454,5602043,13044497
9512,176,$PETR3,2017-03-31,7442454,5602043,13044497
9512,176,$PETR3,2017-06-30,7442454,5602043,13044497
9512,176,$PETR3,2017-09-30,7442454,5602043,13044497
9512,176,$PETR3,2017-12-31,7442454,5602043,13044497
9512,176,$PETR3,2017-12-31,7442454142,5602042788,13044496930
9512,176,$PETR3,2018-03-31,7442454,5602043,13044497
9512,176,$PETR3,2018-06-30,7442454,5602043,13044497
9512,176,$PETR3,2018-09-30,7442454,5602043,13044497
9512,176,$PETR3,2018-12-31,7442454,5602043,13044497
9512,176,$PETR3,2019-03-31,7442454,5602043,13044497
9512,176,$PETR3,2019-06-30,7442454,5602043,13044497
9512,176,$PETR3,2019-09-30,7442454,5602043,13044497
9512,176,$PETR3,2019-12-31,7442454,5602043,13044497
9512,176,$PETR3,2020-03-31,7442454,5602043,13044497
9512,176,$PETR3,2020-06-30,7442454,5602043,13044497
9512,176,$PETR3,2020-09-30,7442454,5602043,13044497
9512,178,$PETR4,2010-12-31,7442454,5602043,13044497
9512,178,$PETR4,2011-03-31,7442454,5602043,13044497
9512,178,$PETR4,2011-06-30,7442454,5602043,13044497
9512,178,$PETR4,2011-09-30,7442454,5602043,13044497
9512,178,$PETR4,2011-09-30,7442454,5602043,13044497
9512,178,$PETR4,2011-12-31,7442454,5602043,13044497
9512,178,$PETR4,2011-12-31,7442454,5602043,13044497
9512,178,$PETR4,2012-03-31,7442454,5602043,13044497
9512,178,$PETR4,2012-06-30,7442454,5602043,13044497
9512,178,$PETR4,2012-09-30,7442454,5602043,13044497
9512,178,$PETR4,2012-12-31,7442454,5602043,13044497
9512,178,$PETR4,2013-03-31,7442454,5602043,13044497
9512,178,$PETR4,2013-06-30,7442454,5602043,13044497
9512,178,$PETR4,2013-09-30,7442454,5602043,13044497
9512,178,$PETR4,2013-12-31,7442454,5602043,13044497
9512,178,$PETR4,2014-03-31,7442454,5602043,13044497
9512,178,$PETR4,2014-06-30,7442454,5602043,13044497
9512,178,$PETR4,2014-09-30,7442454,5602043,13044497
9512,178,$PETR4,2014-12-31,7442454,5602043,13044497
9512,178,$PETR4,2014-12-31,7442454,5602043,13044497
9512,178,$PETR4,2015-03-31,7442454,5602043,13044497
9512,178,$PETR4,2015-06-30,7442454,5602043,13044497
9512,178,$PETR4,2015-09-30,7442454,5602042,13044496
9512,178,$PETR4,2015-12-31,7442454,5602043,13044497
9512,178,$PETR4,2016-03-31,7442454,5602043,13044497
9512,178,$PETR4,2016-06-30,7442454,5602043,13044497
9512,178,$PETR4,2016-09-30,7442454,5602043,13044497
9512,178,$PETR4,2016-12-31,7442454,5602043,13044497
9512,178,$PETR4,2016-12-31,7442454,5602043,13044497
9512,178,$PETR4,2017-03-31,7442454,5602043,13044497
9512,178,$PETR4,2017-03-31,7442454,5602043,13044497
9512,178,$PETR4,2017-06-30,7442454,5602043,13044497
9512,178,$PETR4,2017-09-30,7442454,5602043,13044497
9512,178,$PETR4,2017-12-31,7442454142,5602042788,13044496930
9512,178,$PETR4,2017-12-31,7442454,5602043,13044497
9512,178,$PETR4,2018-03-31,7442454,5602043,13044497
9512,178,$PETR4,2018-06-30,7442454,5602043,13044497
9512,178,$PETR4,2018-09-30,7442454,5602043,13044497
9512,178,$PETR4,2018-12-31,7442454,5602043,13044497
9512,178,$PETR4,2019-03-31,7442454,5602043,13044497
9512,178,$PETR4,2019-06-30,7442454,5602043,13044497
9512,178,$PETR4,2019-09-30,7442454,5602043,13044497
9512,178,$PETR4,2019-12-31,7442454,5602043,13044497
9512,178,$PETR4,2020-03-31,7442454,5602043,13044497
9512,178,$PETR4,2020-06-30,7442454,5602043,13044497
9512,178,$PETR4,2020-09-30,7442454,5602043,13044497
9539,167,$PTNT3,2011-06-30,16016924,32029564,48046488
9539,167,$PTNT3,2011-09-30,16016924,32029564,48046488
9539,167,$PTNT3,2011-12-31,16016924,32029564,48046488
9539,167,$PTNT3,2012-03-31,16016924,32029564,48046488
9539,167,$PTNT3,2012-06-30,16016924,32029564,48046488
9539,167,$PTNT3,2012-09-30,16016924,32029564,48046488
9539,167,$PTNT3,2012-12-31,16016924,32029564,48046488
9539,167,$PTNT3,2013-03-31,16016924,32029564,48046488
9539,167,$PTNT3,2013-06-30,16016924,32029564,48046488
9539,167,$PTNT3,2013-09-30,16016924,32029564,48046488
9539,167,$PTNT3,2013-12-31,16016924,32029564,48046488
9539,167,$PTNT3,2014-03-31,16016924,32029564,48046488
9539,167,$PTNT3,2014-06-30,16016924,32029564,48046488
9539,167,$PTNT3,2014-09-30,16016924,32029564,48046488
9539,167,$PTNT3,2014-12-31,16016924,32029564,48046488
9539,167,$PTNT3,2015-03-31,16016924,32029564,48046488
9539,167,$PTNT3,2015-06-30,16016924,32029564,48046488
9539,167,$PTNT3,2015-09-30,16016924,32029564,48046488
9539,167,$PTNT3,2015-12-31,16016924,32029564,48046488
9539,167,$PTNT3,2016-03-31,16016924,32029564,48046488
9539,167,$PTNT3,2016-06-30,16016924,32029564,48046488
9539,167,$PTNT3,2016-09-30,16016924,32029564,48046488
9539,167,$PTNT3,2016-12-31,16016924,32029564,48046488
9539,167,$PTNT3,2017-03-31,16016924,32029564,48046488
9539,167,$PTNT3,2017-06-30,16016924,32029564,48046488
9539,167,$PTNT3,2017-09-30,16016924,32029564,48046488
9539,167,$PTNT3,2017-12-31,16016924,32029564,48046488
9539,167,$PTNT3,2018-03-31,16016924,32029564,48046488
9539,167,$PTNT3,2018-06-30,16016924,32029564,48046488
9539,167,$PTNT3,2018-09-30,16016924,32029564,48046488
9539,167,$PTNT3,2018-12-31,16016924,32029564,48046488
9539,167,$PTNT3,2019-03-31,16016924,32029564,48046488
9539,167,$PTNT3,2019-06-30,16016924,32029564,48046488
9539,167,$PTNT3,2019-09-30,16016924,32029564,48046488
9539,167,$PTNT3,2019-12-31,16016924,32029564,48046488
9539,167,$PTNT3,2020-03-31,16016924,32029564,48046488
9539,167,$PTNT3,2020-06-30,16016924,32029564,48046488
9539,167,$PTNT3,2020-09-30,16016924,32029564,48046488
9539,168,$PTNT4,2011-06-30,16016924,32029564,48046488
9539,168,$PTNT4,2011-09-30,16016924,32029564,48046488
9539,168,$PTNT4,2011-12-31,16016924,32029564,48046488
9539,168,$PTNT4,2012-03-31,16016924,32029564,48046488
9539,168,$PTNT4,2012-06-30,16016924,32029564,48046488
9539,168,$PTNT4,2012-09-30,16016924,32029564,48046488
9539,168,$PTNT4,2012-12-31,16016924,32029564,48046488
9539,168,$PTNT4,2013-03-31,16016924,32029564,48046488
9539,168,$PTNT4,2013-06-30,16016924,32029564,48046488
9539,168,$PTNT4,2013-09-30,16016924,32029564,48046488
9539,168,$PTNT4,2013-12-31,16016924,32029564,48046488
9539,168,$PTNT4,2014-03-31,16016924,32029564,48046488
9539,168,$PTNT4,2014-06-30,16016924,32029564,48046488
9539,168,$PTNT4,2014-09-30,16016924,32029564,48046488
9539,168,$PTNT4,2014-12-31,16016924,32029564,48046488
9539,168,$PTNT4,2015-03-31,16016924,32029564,48046488
9539,168,$PTNT4,2015-06-30,16016924,32029564,48046488
9539,168,$PTNT4,2015-09-30,16016924,32029564,48046488
9539,168,$PTNT4,2015-12-31,16016924,32029564,48046488
9539,168,$PTNT4,2016-03-31,16016924,32029564,48046488
9539,168,$PTNT4,2016-06-30,16016924,32029564,48046488
9539,168,$PTNT4,2016-09-30,16016924,32029564,48046488
9539,168,$PTNT4,2016-12-31,16016924,32029564,48046488
9539,168,$PTNT4,2017-03-31,16016924,32029564,48046488
9539,168,$PTNT4,2017-06-30,16016924,32029564,48046488
9539,168,$PTNT4,2017-09-30,16016924,32029564,48046488
9539,168,$PTNT4,2017-12-31,16016924,32029564,48046488
9539,168,$PTNT4,2018-03-31,16016924,32029564,48046488
9539,168,$PTNT4,2018-06-30,16016924,32029564,48046488
9539,168,$PTNT4,2018-09-30,16016924,32029564,48046488
9539,168,$PTNT4,2018-12-31,16016924,32029564,48046488
9539,168,$PTNT4,2019-03-31,16016924,32029564,48046488
9539,168,$PTNT4,2019-06-30,16016924,32029564,48046488
9539,168,$PTNT4,2019-09-30,16016924,32029564,48046488
9539,168,$PTNT4,2019-12-31,16016924,32029564,48046488
9539,168,$PTNT4,2020-03-31,16016924,32029564,48046488
9539,168,$PTNT4,2020-06-30,16016924,32029564,48046488
9539,168,$PTNT4,2020-09-30,16016924,32029564,48046488
9717,434,$1212,2010-12-31,24,5,29
9717,434,$1212,2011-03-31,24,5,29
9717,434,$1212,2011-06-30,24,5,29
9717,434,$1212,2011-09-30,24,5,29
9717,434,$1212,2011-12-31,24,5,29
9717,434,$1212,2012-03-31,24,5,29
9717,434,$1212,2012-06-30,24,5,29
9717,434,$1212,2012-09-30,24,5,29
9717,434,$1212,2012-12-31,24,5,29
9717,434,$1212,2013-03-31,24,5,29
9717,434,$1212,2013-06-30,24,5,29
9717,434,$1212,2013-09-30,24,5,29
9717,434,$1212,2013-12-31,24,5,29
9717,434,$1212,2014-03-31,24,5,29
9717,434,$1212,2014-06-30,24,5,29
9717,434,$1212,2014-09-30,24,5,29
9717,434,$1212,2014-12-31,24,5,29
9717,434,$1212,2015-03-31,24,5,29
9717,434,$1212,2015-06-30,24,5,29
9717,434,$1212,2015-09-30,24,5,29
9717,434,$1212,2015-12-31,24,5,29
9717,434,$1212,2016-03-31,24,5,29
9717,434,$1212,2016-06-30,24,5,29
9717,434,$1212,2016-09-30,24,5,29
9717,434,$1212,2016-12-31,24,5,29
9717,434,$1212,2017-03-31,24,5,29
9717,434,$1212,2017-06-30,24,5,29
9717,434,$1212,2017-09-30,24,5,29
9717,434,$1212,2017-12-31,24,5,29
9717,434,$1212,2018-03-31,24,5,29
9717,434,$1212,2018-06-30,24,5,29
9717,434,$1212,2018-09-30,24,5,29
9717,434,$1212,2018-12-31,24,5,29
9717,434,$1212,2019-03-31,24,5,29
9717,434,$1212,2019-06-30,24,5,29
9717,434,$1212,2019-09-30,24,5,29
9717,434,$1212,2019-12-31,24,5,29
9717,434,$1212,2020-03-31,24,5,29
9717,434,$1212,2020-06-30,24,5,29
9717,434,$1212,2020-09-30,24,5,29
9954,161,$CNOR1,2010-12-31,46011632,38670637,84682269
9954,161,$CNOR1,2011-03-31,46011632,38670637,84682269
9954,161,$CNOR1,2011-06-30,46011632,38670637,84682269
9954,161,$CNOR1,2011-09-30,46011632,38670637,84682269
9954,161,$CNOR1,2011-12-31,46011632,38670637,84682269
9954,161,$CNOR1,2012-03-31,46011632,38670637,84682269
9954,161,$CNOR1,2012-06-30,46011632,38670637,84682269
9954,161,$CNOR1,2012-09-30,46011632,38670637,84682269
9954,161,$CNOR1,2012-12-31,46011632,38670637,84682269
9954,161,$CNOR1,2013-03-31,46011632,38670637,84682269
9954,161,$CNOR1,2013-06-30,46011632,38670637,84682269
9954,161,$CNOR1,2013-09-30,46011632,38670637,84682269
9954,161,$CNOR1,2013-12-31,46011632,38670637,84682269
9954,161,$CNOR1,2014-03-31,46011632,38670637,84682269
9954,161,$CNOR1,2014-06-30,46011632,38670637,84682269
9954,161,$CNOR1,2014-09-30,46011632,38670637,84682269
9954,161,$CNOR1,2014-12-31,46011632,38670637,84682269
9954,161,$CNOR1,2015-03-31,46011632,38670637,84682269
9954,161,$CNOR1,2015-06-30,46011632,38670637,84682269
9954,161,$CNOR1,2015-09-30,46011632,38670637,84682269
9954,161,$CNOR1,2015-12-31,46011632,38670637,84682269
9954,161,$CNOR1,2016-03-31,46011632,38670637,84682269
9954,161,$CNOR1,2016-06-30,46011632,38670637,84682269
9954,161,$CNOR1,2016-09-30,46011632,38670637,84682269
9954,161,$CNOR1,2016-12-31,46011632,38670637,84682269
9954,161,$CNOR1,2017-03-31,46011632,38670637,84682269
9954,161,$CNOR1,2017-06-30,46011632,38670637,84682269
9954,161,$CNOR1,2017-09-30,46011632,38670637,84682269
9954,161,$CNOR1,2017-12-31,46011632,38670637,84682269
9954,161,$CNOR1,2018-03-31,46011632,38670637,84682269
9954,161,$CNOR1,2018-06-30,46011632,38670637,84682269
9954,161,$CNOR1,2018-09-30,46011632,38670637,84682269
9954,161,$CNOR1,2018-12-31,46011632,38670637,84682269
9954,161,$CNOR1,2019-03-31,46011632,38670637,84682269
9954,161,$CNOR1,2019-06-30,46011632,38670637,84682269
9954,161,$CNOR1,2019-09-30,46011632,38670637,84682269
9954,161,$CNOR1,2019-12-31,46011632,38670637,84682269
9954,161,$CNOR1,2020-03-31,46011632,38670637,84682269
9954,161,$CNOR1,2020-06-30,46011632,38670637,84682269
9954,161,$CNOR1,2020-09-30,46011632,38670637,84682269
9954,162,$CNPB2,2010-12-31,46011632,38670637,84682269
9954,162,$CNPB2,2011-03-31,46011632,38670637,84682269
9954,162,$CNPB2,2011-06-30,46011632,38670637,84682269
9954,162,$CNPB2,2011-09-30,46011632,38670637,84682269
9954,162,$CNPB2,2011-12-31,46011632,38670637,84682269
9954,162,$CNPB2,2012-03-31,46011632,38670637,84682269
9954,162,$CNPB2,2012-06-30,46011632,38670637,84682269
9954,162,$CNPB2,2012-09-30,46011632,38670637,84682269
9954,162,$CNPB2,2012-12-31,46011632,38670637,84682269
9954,162,$CNPB2,2013-03-31,46011632,38670637,84682269
9954,162,$CNPB2,2013-06-30,46011632,38670637,84682269
9954,162,$CNPB2,2013-09-30,46011632,38670637,84682269
9954,162,$CNPB2,2013-12-31,46011632,38670637,84682269
9954,162,$CNPB2,2014-03-31,46011632,38670637,84682269
9954,162,$CNPB2,2014-06-30,46011632,38670637,84682269
9954,162,$CNPB2,2014-09-30,46011632,38670637,84682269
9954,162,$CNPB2,2014-12-31,46011632,38670637,84682269
9954,162,$CNPB2,2015-03-31,46011632,38670637,84682269
9954,162,$CNPB2,2015-06-30,46011632,38670637,84682269
9954,162,$CNPB2,2015-09-30,46011632,38670637,84682269
9954,162,$CNPB2,2015-12-31,46011632,38670637,84682269
9954,162,$CNPB2,2016-03-31,46011632,38670637,84682269
9954,162,$CNPB2,2016-06-30,46011632,38670637,84682269
9954,162,$CNPB2,2016-09-30,46011632,38670637,84682269
9954,162,$CNPB2,2016-12-31,46011632,38670637,84682269
9954,162,$CNPB2,2017-03-31,46011632,38670637,84682269
9954,162,$CNPB2,2017-06-30,46011632,38670637,84682269
9954,162,$CNPB2,2017-09-30,46011632,38670637,84682269
9954,162,$CNPB2,2017-12-31,46011632,38670637,84682269
9954,162,$CNPB2,2018-03-31,46011632,38670637,84682269
9954,162,$CNPB2,2018-06-30,46011632,38670637,84682269
9954,162,$CNPB2,2018-09-30,46011632,38670637,84682269
9954,162,$CNPB2,2018-12-31,46011632,38670637,84682269
9954,162,$CNPB2,2019-03-31,46011632,38670637,84682269
9954,162,$CNPB2,2019-06-30,46011632,38670637,84682269
9954,162,$CNPB2,2019-09-30,46011632,38670637,84682269
9954,162,$CNPB2,2019-12-31,46011632,38670637,84682269
9954,162,$CNPB2,2020-03-31,46011632,38670637,84682269
9954,162,$CNPB2,2020-06-30,46011632,38670637,84682269
9954,162,$CNPB2,2020-09-30,46011632,38670637,84682269
9954,163,$CNPA4,2010-12-31,46011632,38670637,84682269
9954,163,$CNPA4,2011-03-31,46011632,38670637,84682269
9954,163,$CNPA4,2011-06-30,46011632,38670637,84682269
9954,163,$CNPA4,2011-09-30,46011632,38670637,84682269
9954,163,$CNPA4,2011-12-31,46011632,38670637,84682269
9954,163,$CNPA4,2012-03-31,46011632,38670637,84682269
9954,163,$CNPA4,2012-06-30,46011632,38670637,84682269
9954,163,$CNPA4,2012-09-30,46011632,38670637,84682269
9954,163,$CNPA4,2012-12-31,46011632,38670637,84682269
9954,163,$CNPA4,2013-03-31,46011632,38670637,84682269
9954,163,$CNPA4,2013-06-30,46011632,38670637,84682269
9954,163,$CNPA4,2013-09-30,46011632,38670637,84682269
9954,163,$CNPA4,2013-12-31,46011632,38670637,84682269
9954,163,$CNPA4,2014-03-31,46011632,38670637,84682269
9954,163,$CNPA4,2014-06-30,46011632,38670637,84682269
9954,163,$CNPA4,2014-09-30,46011632,38670637,84682269
9954,163,$CNPA4,2014-12-31,46011632,38670637,84682269
9954,163,$CNPA4,2015-03-31,46011632,38670637,84682269
9954,163,$CNPA4,2015-06-30,46011632,38670637,84682269
9954,163,$CNPA4,2015-09-30,46011632,38670637,84682269
9954,163,$CNPA4,2015-12-31,46011632,38670637,84682269
9954,163,$CNPA4,2016-03-31,46011632,38670637,84682269
9954,163,$CNPA4,2016-06-30,46011632,38670637,84682269
9954,163,$CNPA4,2016-09-30,46011632,38670637,84682269
9954,163,$CNPA4,2016-12-31,46011632,38670637,84682269
9954,163,$CNPA4,2017-03-31,46011632,38670637,84682269
9954,163,$CNPA4,2017-06-30,46011632,38670637,84682269
9954,163,$CNPA4,2017-09-30,46011632,38670637,84682269
9954,163,$CNPA4,2017-12-31,46011632,38670637,84682269
9954,163,$CNPA4,2018-03-31,46011632,38670637,84682269
9954,163,$CNPA4,2018-06-30,46011632,38670637,84682269
9954,163,$CNPA4,2018-09-30,46011632,38670637,84682269
9954,163,$CNPA4,2018-12-31,46011632,38670637,84682269
9954,163,$CNPA4,2019-03-31,46011632,38670637,84682269
9954,163,$CNPA4,2019-06-30,46011632,38670637,84682269
9954,163,$CNPA4,2019-09-30,46011632,38670637,84682269
9954,163,$CNPA4,2019-12-31,46011632,38670637,84682269
9954,163,$CNPA4,2020-03-31,46011632,38670637,84682269
9954,163,$CNPA4,2020-06-30,46011632,38670637,84682269
9954,163,$CNPA4,2020-09-30,46011632,38670637,84682269
9954,164,$RPAD3,2010-12-31,46011632,38670637,84682269
9954,164,$RPAD3,2011-03-31,46011632,38670637,84682269
9954,164,$RPAD3,2011-06-30,46011632,38670637,84682269
9954,164,$RPAD3,2011-09-30,46011632,38670637,84682269
9954,164,$RPAD3,2011-12-31,46011632,38670637,84682269
9954,164,$RPAD3,2012-03-31,46011632,38670637,84682269
9954,164,$RPAD3,2012-06-30,46011632,38670637,84682269
9954,164,$RPAD3,2012-09-30,46011632,38670637,84682269
9954,164,$RPAD3,2012-12-31,46011632,38670637,84682269
9954,164,$RPAD3,2013-03-31,46011632,38670637,84682269
9954,164,$RPAD3,2013-06-30,46011632,38670637,84682269
9954,164,$RPAD3,2013-09-30,46011632,38670637,84682269
9954,164,$RPAD3,2013-12-31,46011632,38670637,84682269
9954,164,$RPAD3,2014-03-31,46011632,38670637,84682269
9954,164,$RPAD3,2014-06-30,46011632,38670637,84682269
9954,164,$RPAD3,2014-09-30,46011632,38670637,84682269
9954,164,$RPAD3,2014-12-31,46011632,38670637,84682269
9954,164,$RPAD3,2015-03-31,46011632,38670637,84682269
9954,164,$RPAD3,2015-06-30,46011632,38670637,84682269
9954,164,$RPAD3,2015-09-30,46011632,38670637,84682269
9954,164,$RPAD3,2015-12-31,46011632,38670637,84682269
9954,164,$RPAD3,2016-03-31,46011632,38670637,84682269
9954,164,$RPAD3,2016-06-30,46011632,38670637,84682269
9954,164,$RPAD3,2016-09-30,46011632,38670637,84682269
9954,164,$RPAD3,2016-12-31,46011632,38670637,84682269
9954,164,$RPAD3,2017-03-31,46011632,38670637,84682269
9954,164,$RPAD3,2017-06-30,46011632,38670637,84682269
9954,164,$RPAD3,2017-09-30,46011632,38670637,84682269
9954,164,$RPAD3,2017-12-31,46011632,38670637,84682269
9954,164,$RPAD3,2018-03-31,46011632,38670637,84682269
9954,164,$RPAD3,2018-06-30,46011632,38670637,84682269
9954,164,$RPAD3,2018-09-30,46011632,38670637,84682269
9954,164,$RPAD3,2018-12-31,46011632,38670637,84682269
9954,164,$RPAD3,2019-03-31,46011632,38670637,84682269
9954,164,$RPAD3,2019-06-30,46011632,38670637,84682269
9954,164,$RPAD3,2019-09-30,46011632,38670637,84682269
9954,164,$RPAD3,2019-12-31,46011632,38670637,84682269
9954,164,$RPAD3,2020-03-31,46011632,38670637,84682269
9954,164,$RPAD3,2020-06-30,46011632,38670637,84682269
9954,164,$RPAD3,2020-09-30,46011632,38670637,84682269
9954,165,$RPAD6,2010-12-31,46011632,38670637,84682269
9954,165,$RPAD6,2011-03-31,46011632,38670637,84682269
9954,165,$RPAD6,2011-06-30,46011632,38670637,84682269
9954,165,$RPAD6,2011-09-30,46011632,38670637,84682269
9954,165,$RPAD6,2011-12-31,46011632,38670637,84682269
9954,165,$RPAD6,2012-03-31,46011632,38670637,84682269
9954,165,$RPAD6,2012-06-30,46011632,38670637,84682269
9954,165,$RPAD6,2012-09-30,46011632,38670637,84682269
9954,165,$RPAD6,2012-12-31,46011632,38670637,84682269
9954,165,$RPAD6,2013-03-31,46011632,38670637,84682269
9954,165,$RPAD6,2013-06-30,46011632,38670637,84682269
9954,165,$RPAD6,2013-09-30,46011632,38670637,84682269
9954,165,$RPAD6,2013-12-31,46011632,38670637,84682269
9954,165,$RPAD6,2014-03-31,46011632,38670637,84682269
9954,165,$RPAD6,2014-06-30,46011632,38670637,84682269
9954,165,$RPAD6,2014-09-30,46011632,38670637,84682269
9954,165,$RPAD6,2014-12-31,46011632,38670637,84682269
9954,165,$RPAD6,2015-03-31,46011632,38670637,84682269
9954,165,$RPAD6,2015-06-30,46011632,38670637,84682269
9954,165,$RPAD6,2015-09-30,46011632,38670637,84682269
9954,165,$RPAD6,2015-12-31,46011632,38670637,84682269
9954,165,$RPAD6,2016-03-31,46011632,38670637,84682269
9954,165,$RPAD6,2016-06-30,46011632,38670637,84682269
9954,165,$RPAD6,2016-09-30,46011632,38670637,84682269
9954,165,$RPAD6,2016-12-31,46011632,38670637,84682269
9954,165,$RPAD6,2017-03-31,46011632,38670637,84682269
9954,165,$RPAD6,2017-06-30,46011632,38670637,84682269
9954,165,$RPAD6,2017-09-30,46011632,38670637,84682269
9954,165,$RPAD6,2017-12-31,46011632,38670637,84682269
9954,165,$RPAD6,2018-03-31,46011632,38670637,84682269
9954,165,$RPAD6,2018-06-30,46011632,38670637,84682269
9954,165,$RPAD6,2018-09-30,46011632,38670637,84682269
9954,165,$RPAD6,2018-12-31,46011632,38670637,84682269
9954,165,$RPAD6,2019-03-31,46011632,38670637,84682269
9954,165,$RPAD6,2019-06-30,46011632,38670637,84682269
9954,165,$RPAD6,2019-09-30,46011632,38670637,84682269
9954,165,$RPAD6,2019-12-31,46011632,38670637,84682269
9954,165,$RPAD6,2020-03-31,46011632,38670637,84682269
9954,165,$RPAD6,2020-06-30,46011632,38670637,84682269
9954,165,$RPAD6,2020-09-30,46011632,38670637,84682269
9954,166,$RPAD5,2010-12-31,46011632,38670637,84682269
9954,166,$RPAD5,2011-03-31,46011632,38670637,84682269
9954,166,$RPAD5,2011-06-30,46011632,38670637,84682269
9954,166,$RPAD5,2011-09-30,46011632,38670637,84682269
9954,166,$RPAD5,2011-12-31,46011632,38670637,84682269
9954,166,$RPAD5,2012-03-31,46011632,38670637,84682269
9954,166,$RPAD5,2012-06-30,46011632,38670637,84682269
9954,166,$RPAD5,2012-09-30,46011632,38670637,84682269
9954,166,$RPAD5,2012-12-31,46011632,38670637,84682269
9954,166,$RPAD5,2013-03-31,46011632,38670637,84682269
9954,166,$RPAD5,2013-06-30,46011632,38670637,84682269
9954,166,$RPAD5,2013-09-30,46011632,38670637,84682269
9954,166,$RPAD5,2013-12-31,46011632,38670637,84682269
9954,166,$RPAD5,2014-03-31,46011632,38670637,84682269
9954,166,$RPAD5,2014-06-30,46011632,38670637,84682269
9954,166,$RPAD5,2014-09-30,46011632,38670637,84682269
9954,166,$RPAD5,2014-12-31,46011632,38670637,84682269
9954,166,$RPAD5,2015-03-31,46011632,38670637,84682269
9954,166,$RPAD5,2015-06-30,46011632,38670637,84682269
9954,166,$RPAD5,2015-09-30,46011632,38670637,84682269
9954,166,$RPAD5,2015-12-31,46011632,38670637,84682269
9954,166,$RPAD5,2016-03-31,46011632,38670637,84682269
9954,166,$RPAD5,2016-06-30,46011632,38670637,84682269
9954,166,$RPAD5,2016-09-30,46011632,38670637,84682269
9954,166,$RPAD5,2016-12-31,46011632,38670637,84682269
9954,166,$RPAD5,2017-03-31,46011632,38670637,84682269
9954,166,$RPAD5,2017-06-30,46011632,38670637,84682269
9954,166,$RPAD5,2017-09-30,46011632,38670637,84682269
9954,166,$RPAD5,2017-12-31,46011632,38670637,84682269
9954,166,$RPAD5,2018-03-31,46011632,38670637,84682269
9954,166,$RPAD5,2018-06-30,46011632,38670637,84682269
9954,166,$RPAD5,2018-09-30,46011632,38670637,84682269
9954,166,$RPAD5,2018-12-31,46011632,38670637,84682269
9954,166,$RPAD5,2019-03-31,46011632,38670637,84682269
9954,166,$RPAD5,2019-06-30,46011632,38670637,84682269
9954,166,$RPAD5,2019-09-30,46011632,38670637,84682269
9954,166,$RPAD5,2019-12-31,46011632,38670637,84682269
9954,166,$RPAD5,2020-03-31,46011632,38670637,84682269
9954,166,$RPAD5,2020-06-30,46011632,38670637,84682269
9954,166,$RPAD5,2020-09-30,46011632,38670637,84682269
9989,416,$9989,2010-12-31,757290,143802,901092
9989,416,$9989,2011-03-31,757290,143802,901092
9989,416,$9989,2011-06-30,757290,143802,901092
9989,416,$9989,2011-09-30,780863,150588,931451
9989,416,$9989,2011-12-31,780863,150588,931451
9989,416,$9989,2012-03-31,780863,150588,931451
9989,416,$9989,2012-06-30,780863,150588,931451
9989,416,$9989,2012-09-30,780863,150588,931451
9989,416,$9989,2012-12-31,780863,150588,931451
9989,416,$9989,2013-03-31,780863,150588,931451
9989,416,$9989,2013-06-30,780863,150588,931451
9989,416,$9989,2013-09-30,780863,150588,931451
9989,416,$9989,2013-12-31,780863,150588,931451
9989,416,$9989,2014-03-31,991541,150588,1142129
9989,416,$9989,2014-06-30,991541,150588,1142129
9989,416,$9989,2014-09-30,991541,150588,1142129
9989,416,$9989,2014-12-31,1353832,0,1353832
9989,416,$9989,2015-03-31,1353832,0,1353832
9989,416,$9989,2015-06-30,1353832,0,1353832
9989,416,$9989,2015-09-30,1353832,0,1353832
9989,416,$9989,2015-12-31,1353833,0,1353833
9989,416,$9989,2016-03-31,67692,0,67692
9989,416,$9989,2016-06-30,67692,0,67692
9989,416,$9989,2016-09-30,67692,0,67692
9989,416,$9989,2016-12-31,67692,0,67692
9989,416,$9989,2017-03-31,67692,0,67692
9989,416,$9989,2017-06-30,67692,0,67692
9989,416,$9989,2017-09-30,67692,0,67692
9989,416,$9989,2017-12-31,67691629,0,67691629
9989,416,$9989,2018-03-31,67691629,0,67691629
9989,416,$9989,2018-06-30,67691629,0,67691629
9989,416,$9989,2018-09-30,67691629,0,67691629
9989,416,$9989,2018-12-31,67692,0,67692
9989,416,$9989,2019-03-31,67692,0,67692
9989,416,$9989,2019-06-30,67692,0,67692
9989,416,$9989,2019-09-30,67691629,0,67691629
9989,416,$9989,2019-12-31,67692,0,67692
9989,416,$9989,2020-03-31,67692,0,67692
9989,416,$9989,2020-06-30,67692,0,67692
9989,416,$9989,2020-09-30,67692,0,67692
9989,417,$RPMG3,2010-12-31,757290,143802,901092
9989,417,$RPMG3,2011-03-31,757290,143802,901092
9989,417,$RPMG3,2011-06-30,757290,143802,901092
9989,417,$RPMG3,2011-09-30,780863,150588,931451
9989,417,$RPMG3,2011-12-31,780863,150588,931451
9989,417,$RPMG3,2012-03-31,780863,150588,931451
9989,417,$RPMG3,2012-06-30,780863,150588,931451
9989,417,$RPMG3,2012-09-30,780863,150588,931451
9989,417,$RPMG3,2012-12-31,780863,150588,931451
9989,417,$RPMG3,2013-03-31,780863,150588,931451
9989,417,$RPMG3,2013-06-30,780863,150588,931451
9989,417,$RPMG3,2013-09-30,780863,150588,931451
9989,417,$RPMG3,2013-12-31,780863,150588,931451
9989,417,$RPMG3,2014-03-31,991541,150588,1142129
9989,417,$RPMG3,2014-06-30,991541,150588,1142129
9989,417,$RPMG3,2014-09-30,991541,150588,1142129
9989,417,$RPMG3,2014-12-31,1353832,0,1353832
9989,417,$RPMG3,2015-03-31,1353832,0,1353832
9989,417,$RPMG3,2015-06-30,1353832,0,1353832
9989,417,$RPMG3,2015-09-30,1353832,0,1353832
9989,417,$RPMG3,2015-12-31,1353833,0,1353833
9989,417,$RPMG3,2016-03-31,67692,0,67692
9989,417,$RPMG3,2016-06-30,67692,0,67692
9989,417,$RPMG3,2016-09-30,67692,0,67692
9989,417,$RPMG3,2016-12-31,67692,0,67692
9989,417,$RPMG3,2017-03-31,67692,0,67692
9989,417,$RPMG3,2017-06-30,67692,0,67692
9989,417,$RPMG3,2017-09-30,67692,0,67692
9989,417,$RPMG3,2017-12-31,67691629,0,67691629
9989,417,$RPMG3,2018-03-31,67691629,0,67691629
9989,417,$RPMG3,2018-06-30,67691629,0,67691629
9989,417,$RPMG3,2018-09-30,67691629,0,67691629
9989,417,$RPMG3,2018-12-31,67692,0,67692
9989,417,$RPMG3,2019-03-31,67692,0,67692
9989,417,$RPMG3,2019-06-30,67692,0,67692
9989,417,$RPMG3,2019-09-30,67691629,0,67691629
9989,417,$RPMG3,2019-12-31,67692,0,67692
9989,417,$RPMG3,2020-03-31,67692,0,67692
9989,417,$RPMG3,2020-06-30,67692,0,67692
9989,417,$RPMG3,2020-09-30,67692,0,67692
10456,179,$ALPA3,2010-12-31,181524,171932,353456
10456,179,$ALPA3,2011-03-31,181524,171932,353456
10456,179,$ALPA3,2011-06-30,181524,171932,353456
10456,179,$ALPA3,2011-09-30,181524,171932,353456
10456,179,$ALPA3,2011-12-31,181524,171932,353456
10456,179,$ALPA3,2012-03-31,181524,171932,353456
10456,179,$ALPA3,2012-06-30,199676,189125,388801
10456,179,$ALPA3,2012-09-30,199676,189125,388801
10456,179,$ALPA3,2012-12-31,199676,189125,388801
10456,179,$ALPA3,2013-03-31,199676,189125,388801
10456,179,$ALPA3,2013-06-30,219644,208038,427682
10456,179,$ALPA3,2013-09-30,219644,208038,427682
10456,179,$ALPA3,2013-12-31,219644,208038,427682
10456,179,$ALPA3,2014-03-31,219644,208038,427682
10456,179,$ALPA3,2014-06-30,241609,228841,470450
10456,179,$ALPA3,2014-09-30,241609,228841,470450
10456,179,$ALPA3,2014-12-31,241609,228841,470450
10456,179,$ALPA3,2015-03-31,241609,228841,470450
10456,179,$ALPA3,2015-06-30,241609,228841,470450
10456,179,$ALPA3,2015-09-30,241609,228841,470450
10456,179,$ALPA3,2015-12-31,241609,228841,470450
10456,179,$ALPA3,2016-03-31,241609,228841,470450
10456,179,$ALPA3,2016-06-30,241609,228841,470450
10456,179,$ALPA3,2016-09-30,241609,228841,470450
10456,179,$ALPA3,2016-12-31,241609,228841,470450
10456,179,$ALPA3,2017-03-31,241609,228841,470450
10456,179,$ALPA3,2017-06-30,241609,228841,470450
10456,179,$ALPA3,2017-09-30,241609,228841,470450
10456,179,$ALPA3,2017-12-31,241609,228841,470450
10456,179,$ALPA3,2018-03-31,241608551,228841226,470449777
10456,179,$ALPA3,2018-06-30,241608551,228841226,470449777
10456,179,$ALPA3,2018-09-30,241608551,228841226,470449777
10456,179,$ALPA3,2018-12-31,241608551,228841226,470449777
10456,179,$ALPA3,2019-03-31,302010689,286051533,588062222
10456,179,$ALPA3,2019-06-30,302010689,286051533,588062222
10456,179,$ALPA3,2019-09-30,302010689,286051533,588062222
10456,179,$ALPA3,2019-12-31,302010689,286051533,588062222
10456,179,$ALPA3,2020-03-31,302010689,286051533,588062222
10456,179,$ALPA3,2020-06-30,302010689,286051533,588062222
10456,179,$ALPA3,2020-09-30,302010689,286051533,588062222
10456,180,$ALPA4,2010-12-31,181524,171932,353456
10456,180,$ALPA4,2011-03-31,181524,171932,353456
10456,180,$ALPA4,2011-06-30,181524,171932,353456
10456,180,$ALPA4,2011-09-30,181524,171932,353456
10456,180,$ALPA4,2011-12-31,181524,171932,353456
10456,180,$ALPA4,2012-03-31,181524,171932,353456
10456,180,$ALPA4,2012-06-30,199676,189125,388801
10456,180,$ALPA4,2012-09-30,199676,189125,388801
10456,180,$ALPA4,2012-12-31,199676,189125,388801
10456,180,$ALPA4,2013-03-31,199676,189125,388801
10456,180,$ALPA4,2013-06-30,219644,208038,427682
10456,180,$ALPA4,2013-09-30,219644,208038,427682
10456,180,$ALPA4,2013-12-31,219644,208038,427682
10456,180,$ALPA4,2014-03-31,219644,208038,427682
10456,180,$ALPA4,2014-06-30,241609,228841,470450
10456,180,$ALPA4,2014-09-30,241609,228841,470450
10456,180,$ALPA4,2014-12-31,241609,228841,470450
10456,180,$ALPA4,2015-03-31,241609,228841,470450
10456,180,$ALPA4,2015-06-30,241609,228841,470450
10456,180,$ALPA4,2015-09-30,241609,228841,470450
10456,180,$ALPA4,2015-12-31,241609,228841,470450
10456,180,$ALPA4,2016-03-31,241609,228841,470450
10456,180,$ALPA4,2016-06-30,241609,228841,470450
10456,180,$ALPA4,2016-09-30,241609,228841,470450
10456,180,$ALPA4,2016-12-31,241609,228841,470450
10456,180,$ALPA4,2017-03-31,241609,228841,470450
10456,180,$ALPA4,2017-06-30,241609,228841,470450
10456,180,$ALPA4,2017-09-30,241609,228841,470450
10456,180,$ALPA4,2017-12-31,241609,228841,470450
10456,180,$ALPA4,2018-03-31,241608551,228841226,470449777
10456,180,$ALPA4,2018-06-30,241608551,228841226,470449777
10456,180,$ALPA4,2018-09-30,241608551,228841226,470449777
10456,180,$ALPA4,2018-12-31,241608551,228841226,470449777
10456,180,$ALPA4,2019-03-31,302010689,286051533,588062222
10456,180,$ALPA4,2019-06-30,302010689,286051533,588062222
10456,180,$ALPA4,2019-09-30,302010689,286051533,588062222
10456,180,$ALPA4,2019-12-31,302010689,286051533,588062222
10456,180,$ALPA4,2020-03-31,302010689,286051533,588062222
10456,180,$ALPA4,2020-06-30,302010689,286051533,588062222
10456,180,$ALPA4,2020-09-30,302010689,286051533,588062222
10472,174,$SLED3,2010-12-31,9622,18974,28596
10472,174,$SLED3,2011-03-31,9622,18974,28596
10472,174,$SLED3,2011-06-30,9622,18974,28596
10472,174,$SLED3,2011-09-30,9622,18974,28596
10472,174,$SLED3,2011-12-31,9622,18974,28596
10472,174,$SLED3,2012-03-31,9622,18974,28596
10472,174,$SLED3,2012-06-30,9622,18974,28596
10472,174,$SLED3,2012-09-30,9622,18974,28596
10472,174,$SLED3,2012-12-31,9622,18974,28596
10472,174,$SLED3,2013-03-31,9622,18974,28596
10472,174,$SLED3,2013-06-30,9622,18974,28596
10472,174,$SLED3,2013-09-30,9622,18974,28596
10472,174,$SLED3,2013-12-31,9622,18974,28596
10472,174,$SLED3,2014-03-31,9622,18974,28596
10472,174,$SLED3,2014-06-30,9622,18974,28596
10472,174,$SLED3,2014-09-30,9622,18974,28596
10472,174,$SLED3,2014-12-31,9622,18974,28596
10472,174,$SLED3,2015-03-31,9622,18974,28596
10472,174,$SLED3,2015-06-30,9622,18974,28596
10472,174,$SLED3,2015-09-30,9622,18974,28596
10472,174,$SLED3,2015-12-31,9622,18974,28596
10472,174,$SLED3,2016-03-31,9622,18974,28596
10472,174,$SLED3,2016-06-30,9622,17080,26702
10472,174,$SLED3,2016-09-30,9622,17080,26702
10472,174,$SLED3,2016-12-31,9622,17080,26702
10472,174,$SLED3,2017-03-31,9622,17080,26702
10472,174,$SLED3,2017-06-30,9622,17080,26702
10472,174,$SLED3,2017-09-30,9622,17080,26702
10472,174,$SLED3,2017-12-31,9622,17080,26702
10472,174,$SLED3,2018-03-31,9622,17080,26702
10472,174,$SLED3,2018-06-30,9622,17080,26702
10472,174,$SLED3,2018-09-30,9622,17080,26702
10472,174,$SLED3,2018-12-31,9622,17080,26702
10472,174,$SLED3,2019-03-31,9622,17080,26702
10472,174,$SLED3,2019-06-30,9622,17080,26702
10472,174,$SLED3,2019-09-30,9622,17080,26702
10472,174,$SLED3,2019-12-31,9622,17080,26702
10472,174,$SLED3,2020-03-31,18621,20325,38946
10472,174,$SLED3,2020-06-30,18621,20325,38946
10472,174,$SLED3,2020-09-30,22481,35766,58247
10472,175,$SLED4,2010-12-31,9622,18974,28596
10472,175,$SLED4,2011-03-31,9622,18974,28596
10472,175,$SLED4,2011-06-30,9622,18974,28596
10472,175,$SLED4,2011-09-30,9622,18974,28596
10472,175,$SLED4,2011-12-31,9622,18974,28596
10472,175,$SLED4,2012-03-31,9622,18974,28596
10472,175,$SLED4,2012-06-30,9622,18974,28596
10472,175,$SLED4,2012-09-30,9622,18974,28596
10472,175,$SLED4,2012-12-31,9622,18974,28596
10472,175,$SLED4,2013-03-31,9622,18974,28596
10472,175,$SLED4,2013-06-30,9622,18974,28596
10472,175,$SLED4,2013-09-30,9622,18974,28596
10472,175,$SLED4,2013-12-31,9622,18974,28596
10472,175,$SLED4,2014-03-31,9622,18974,28596
10472,175,$SLED4,2014-06-30,9622,18974,28596
10472,175,$SLED4,2014-09-30,9622,18974,28596
10472,175,$SLED4,2014-12-31,9622,18974,28596
10472,175,$SLED4,2015-03-31,9622,18974,28596
10472,175,$SLED4,2015-06-30,9622,18974,28596
10472,175,$SLED4,2015-09-30,9622,18974,28596
10472,175,$SLED4,2015-12-31,9622,18974,28596
10472,175,$SLED4,2016-03-31,9622,18974,28596
10472,175,$SLED4,2016-06-30,9622,17080,26702
10472,175,$SLED4,2016-09-30,9622,17080,26702
10472,175,$SLED4,2016-12-31,9622,17080,26702
10472,175,$SLED4,2017-03-31,9622,17080,26702
10472,175,$SLED4,2017-06-30,9622,17080,26702
10472,175,$SLED4,2017-09-30,9622,17080,26702
10472,175,$SLED4,2017-12-31,9622,17080,26702
10472,175,$SLED4,2018-03-31,9622,17080,26702
10472,175,$SLED4,2018-06-30,9622,17080,26702
10472,175,$SLED4,2018-09-30,9622,17080,26702
10472,175,$SLED4,2018-12-31,9622,17080,26702
10472,175,$SLED4,2019-03-31,9622,17080,26702
10472,175,$SLED4,2019-06-30,9622,17080,26702
10472,175,$SLED4,2019-09-30,9622,17080,26702
10472,175,$SLED4,2019-12-31,9622,17080,26702
10472,175,$SLED4,2020-03-31,18621,20325,38946
10472,175,$SLED4,2020-06-30,18621,20325,38946
10472,175,$SLED4,2020-09-30,22481,35766,58247
10561,435,$SEIVA,2010-12-31,8573,10491,19064
10561,435,$SEIVA,2011-03-31,8573186,10491038,19064224
10561,435,$SEIVA,2011-06-30,8573186,10491038,19064224
10561,435,$SEIVA,2011-09-30,8573186,10491038,19064224
10561,435,$SEIVA,2011-12-31,8573,10491,19064
10561,435,$SEIVA,2012-03-31,8573186,10491038,19064224
10561,435,$SEIVA,2012-06-30,8573186,10491038,19064224
10561,435,$SEIVA,2012-09-30,8573186,10491038,19064224
10561,435,$SEIVA,2012-12-31,8573186,10491038,19064224
10561,435,$SEIVA,2013-03-31,8573186,10491038,19064224
10561,435,$SEIVA,2013-06-30,8573186,10491038,19064224
10561,435,$SEIVA,2013-09-30,8573186,10491038,19064224
10561,435,$SEIVA,2013-12-31,8573186,10491038,19064224
10561,435,$SEIVA,2014-03-31,8573186,10491038,19064224
10561,435,$SEIVA,2014-06-30,8573186,10491038,19064224
10561,435,$SEIVA,2014-09-30,8573186,10491038,19064224
10561,435,$SEIVA,2014-12-31,8573186,10491038,19064224
10561,435,$SEIVA,2015-03-31,8573186,10491038,19064224
10561,435,$SEIVA,2015-06-30,8573186,10491038,19064224
10561,435,$SEIVA,2015-09-30,8573186,10491038,19064224
10561,435,$SEIVA,2015-12-31,8573186,10491038,19064224
10561,435,$SEIVA,2016-03-31,8573186,10491038,19064224
10561,435,$SEIVA,2016-06-30,8573186,10491038,19064224
10561,435,$SEIVA,2016-09-30,8573186,10491038,19064224
10561,435,$SEIVA,2016-12-31,8573186,10491038,19064224
10561,435,$SEIVA,2017-03-31,8573186,10491038,19064224
10561,435,$SEIVA,2017-06-30,8573186,10491038,19064224
10561,435,$SEIVA,2017-09-30,8573186,10491038,19064224
10561,435,$SEIVA,2017-12-31,8573186,10491038,19064224
10561,435,$SEIVA,2018-03-31,8573186,10491038,19064224
10561,435,$SEIVA,2018-06-30,8573186,10491038,19064224
10561,435,$SEIVA,2018-09-30,8573186,10491038,19064224
10561,435,$SEIVA,2018-12-31,8573186,10491038,19064224
10561,435,$SEIVA,2019-03-31,8573186,10491038,19064224
10561,435,$SEIVA,2019-06-30,8573186,10491038,19064224
10561,435,$SEIVA,2019-09-30,8573186,10491038,19064224
10561,435,$SEIVA,2019-12-31,8573186,10491038,19064224
10561,435,$SEIVA,2020-03-31,8573186,10491038,19064224
10561,435,$SEIVA,2020-06-30,8573186,10491038,19064224
10561,435,$SEIVA,2020-09-30,8573186,10491038,19064224
10880,183,$5.4,2010-12-31,856,1712,2568
10880,183,$5.4,2011-03-31,856,1712,2568
10880,183,$5.4,2011-06-30,856,1712,2568
10880,183,$5.4,2011-09-30,856,1712,2568
10880,183,$5.4,2011-12-31,856,1712,2568
10880,183,$5.4,2012-03-31,856,1712,2568
10880,183,$5.4,2012-06-30,856,1712,2568
10880,183,$5.4,2012-09-30,856,1712,2568
10880,183,$5.4,2012-12-31,856,1712,2568
10880,183,$5.4,2013-03-31,856,1712,2568
10880,183,$5.4,2013-06-30,856,1601,2457
10880,183,$5.4,2013-09-30,856,1601,2457
10880,183,$5.4,2013-12-31,856,1601,2457
10880,183,$5.4,2014-03-31,856,1575,2431
10880,183,$5.4,2014-06-30,856,1575,2431
10880,183,$5.4,2014-09-30,856,1575,2431
10880,183,$5.4,2014-12-31,856,1575,2431
10880,183,$5.4,2015-03-31,856,1575,2431
10880,183,$5.4,2015-06-30,856,1575,2431
10880,183,$5.4,2015-09-30,856,1575,2431
10880,183,$5.4,2015-12-31,856,1575,2431
10880,183,$5.4,2016-03-31,856,1575,2431
10880,183,$5.4,2016-06-30,856,1575,2431
10880,183,$5.4,2016-09-30,856,1575,2431
10880,183,$5.4,2016-12-31,856,1575,2431
10880,183,$5.4,2017-03-31,856,1575,2431
10880,183,$5.4,2017-06-30,856,1575,2431
10880,183,$5.4,2017-09-30,856,1575,2431
10880,183,$5.4,2017-12-31,856,1575,2431
10880,183,$5.4,2018-03-31,856,1575,2431
10880,183,$5.4,2018-06-30,856,1575,2431
10880,183,$5.4,2018-09-30,856,1575,2431
10880,183,$5.4,2018-12-31,856,1575,2431
10880,183,$5.4,2019-03-31,856,1575,2431
10880,183,$5.4,2019-06-30,856,1602,2458
10880,183,$5.4,2019-09-30,856,1575,2431
10880,183,$5.4,2019-12-31,856,1575,2431
10880,183,$5.4,2020-03-31,856,1575,2431
10880,183,$5.4,2020-06-30,856,1575,2431
10880,183,$5.4,2020-09-30,856,1575,2431
10880,184,"$5,4",2010-12-31,856,1712,2568
10880,184,"$5,4",2011-03-31,856,1712,2568
10880,184,"$5,4",2011-06-30,856,1712,2568
10880,184,"$5,4",2011-09-30,856,1712,2568
10880,184,"$5,4",2011-12-31,856,1712,2568
10880,184,"$5,4",2012-03-31,856,1712,2568
10880,184,"$5,4",2012-06-30,856,1712,2568
10880,184,"$5,4",2012-09-30,856,1712,2568
10880,184,"$5,4",2012-12-31,856,1712,2568
10880,184,"$5,4",2013-03-31,856,1712,2568
10880,184,"$5,4",2013-06-30,856,1601,2457
10880,184,"$5,4",2013-09-30,856,1601,2457
10880,184,"$5,4",2013-12-31,856,1601,2457
10880,184,"$5,4",2014-03-31,856,1575,2431
10880,184,"$5,4",2014-06-30,856,1575,2431
10880,184,"$5,4",2014-09-30,856,1575,2431
10880,184,"$5,4",2014-12-31,856,1575,2431
10880,184,"$5,4",2015-03-31,856,1575,2431
10880,184,"$5,4",2015-06-30,856,1575,2431
10880,184,"$5,4",2015-09-30,856,1575,2431
10880,184,"$5,4",2015-12-31,856,1575,2431
10880,184,"$5,4",2016-03-31,856,1575,2431
10880,184,"$5,4",2016-06-30,856,1575,2431
10880,184,"$5,4",2016-09-30,856,1575,2431
10880,184,"$5,4",2016-12-31,856,1575,2431
10880,184,"$5,4",2017-03-31,856,1575,2431
10880,184,"$5,4",2017-06-30,856,1575,2431
10880,184,"$5,4",2017-09-30,856,1575,2431
10880,184,"$5,4",2017-12-31,856,1575,2431
10880,184,"$5,4",2018-03-31,856,1575,2431
10880,184,"$5,4",2018-06-30,856,1575,2431
10880,184,"$5,4",2018-09-30,856,1575,2431
10880,184,"$5,4",2018-12-31,856,1575,2431
10880,184,"$5,4",2019-03-31,856,1575,2431
10880,184,"$5,4",2019-06-30,856,1602,2458
10880,184,"$5,4",2019-09-30,856,1575,2431
10880,184,"$5,4",2019-12-31,856,1575,2431
10880,184,"$5,4",2020-03-31,856,1575,2431
10880,184,"$5,4",2020-06-30,856,1575,2431
10880,184,"$5,4",2020-09-30,856,1575,2431
10880,607,$SOND3,2010-12-31,856,1712,2568
10880,607,$SOND3,2011-03-31,856,1712,2568
10880,607,$SOND3,2011-06-30,856,1712,2568
10880,607,$SOND3,2011-09-30,856,1712,2568
10880,607,$SOND3,2011-12-31,856,1712,2568
10880,607,$SOND3,2012-03-31,856,1712,2568
10880,607,$SOND3,2012-06-30,856,1712,2568
10880,607,$SOND3,2012-09-30,856,1712,2568
10880,607,$SOND3,2012-12-31,856,1712,2568
10880,607,$SOND3,2013-03-31,856,1712,2568
10880,607,$SOND3,2013-06-30,856,1601,2457
10880,607,$SOND3,2013-09-30,856,1601,2457
10880,607,$SOND3,2013-12-31,856,1601,2457
10880,607,$SOND3,2014-03-31,856,1575,2431
10880,607,$SOND3,2014-06-30,856,1575,2431
10880,607,$SOND3,2014-09-30,856,1575,2431
10880,607,$SOND3,2014-12-31,856,1575,2431
10880,607,$SOND3,2015-03-31,856,1575,2431
10880,607,$SOND3,2015-06-30,856,1575,2431
10880,607,$SOND3,2015-09-30,856,1575,2431
10880,607,$SOND3,2015-12-31,856,1575,2431
10880,607,$SOND3,2016-03-31,856,1575,2431
10880,607,$SOND3,2016-06-30,856,1575,2431
10880,607,$SOND3,2016-09-30,856,1575,2431
10880,607,$SOND3,2016-12-31,856,1575,2431
10880,607,$SOND3,2017-03-31,856,1575,2431
10880,607,$SOND3,2017-06-30,856,1575,2431
10880,607,$SOND3,2017-09-30,856,1575,2431
10880,607,$SOND3,2017-12-31,856,1575,2431
10880,607,$SOND3,2018-03-31,856,1575,2431
10880,607,$SOND3,2018-06-30,856,1575,2431
10880,607,$SOND3,2018-09-30,856,1575,2431
10880,607,$SOND3,2018-12-31,856,1575,2431
10880,607,$SOND3,2019-03-31,856,1575,2431
10880,607,$SOND3,2019-06-30,856,1602,2458
10880,607,$SOND3,2019-09-30,856,1575,2431
10880,607,$SOND3,2019-12-31,856,1575,2431
10880,607,$SOND3,2020-03-31,856,1575,2431
10880,607,$SOND3,2020-06-30,856,1575,2431
10880,607,$SOND3,2020-09-30,856,1575,2431
10880,608,$SOND6,2010-12-31,856,1712,2568
10880,608,$SOND6,2011-03-31,856,1712,2568
10880,608,$SOND6,2011-06-30,856,1712,2568
10880,608,$SOND6,2011-09-30,856,1712,2568
10880,608,$SOND6,2011-12-31,856,1712,2568
10880,608,$SOND6,2012-03-31,856,1712,2568
10880,608,$SOND6,2012-06-30,856,1712,2568
10880,608,$SOND6,2012-09-30,856,1712,2568
10880,608,$SOND6,2012-12-31,856,1712,2568
10880,608,$SOND6,2013-03-31,856,1712,2568
10880,608,$SOND6,2013-06-30,856,1601,2457
10880,608,$SOND6,2013-09-30,856,1601,2457
10880,608,$SOND6,2013-12-31,856,1601,2457
10880,608,$SOND6,2014-03-31,856,1575,2431
10880,608,$SOND6,2014-06-30,856,1575,2431
10880,608,$SOND6,2014-09-30,856,1575,2431
10880,608,$SOND6,2014-12-31,856,1575,2431
10880,608,$SOND6,2015-03-31,856,1575,2431
10880,608,$SOND6,2015-06-30,856,1575,2431
10880,608,$SOND6,2015-09-30,856,1575,2431
10880,608,$SOND6,2015-12-31,856,1575,2431
10880,608,$SOND6,2016-03-31,856,1575,2431
10880,608,$SOND6,2016-06-30,856,1575,2431
10880,608,$SOND6,2016-09-30,856,1575,2431
10880,608,$SOND6,2016-12-31,856,1575,2431
10880,608,$SOND6,2017-03-31,856,1575,2431
10880,608,$SOND6,2017-06-30,856,1575,2431
10880,608,$SOND6,2017-09-30,856,1575,2431
10880,608,$SOND6,2017-12-31,856,1575,2431
10880,608,$SOND6,2018-03-31,856,1575,2431
10880,608,$SOND6,2018-06-30,856,1575,2431
10880,608,$SOND6,2018-09-30,856,1575,2431
10880,608,$SOND6,2018-12-31,856,1575,2431
10880,608,$SOND6,2019-03-31,856,1575,2431
10880,608,$SOND6,2019-06-30,856,1602,2458
10880,608,$SOND6,2019-09-30,856,1575,2431
10880,608,$SOND6,2019-12-31,856,1575,2431
10880,608,$SOND6,2020-03-31,856,1575,2431
10880,608,$SOND6,2020-06-30,856,1575,2431
10880,608,$SOND6,2020-09-30,856,1575,2431
10880,610,$SOND5,2010-12-31,856,1712,2568
10880,610,$SOND5,2011-03-31,856,1712,2568
10880,610,$SOND5,2011-06-30,856,1712,2568
10880,610,$SOND5,2011-09-30,856,1712,2568
10880,610,$SOND5,2011-12-31,856,1712,2568
10880,610,$SOND5,2012-03-31,856,1712,2568
10880,610,$SOND5,2012-06-30,856,1712,2568
10880,610,$SOND5,2012-09-30,856,1712,2568
10880,610,$SOND5,2012-12-31,856,1712,2568
10880,610,$SOND5,2013-03-31,856,1712,2568
10880,610,$SOND5,2013-06-30,856,1601,2457
10880,610,$SOND5,2013-09-30,856,1601,2457
10880,610,$SOND5,2013-12-31,856,1601,2457
10880,610,$SOND5,2014-03-31,856,1575,2431
10880,610,$SOND5,2014-06-30,856,1575,2431
10880,610,$SOND5,2014-09-30,856,1575,2431
10880,610,$SOND5,2014-12-31,856,1575,2431
10880,610,$SOND5,2015-03-31,856,1575,2431
10880,610,$SOND5,2015-06-30,856,1575,2431
10880,610,$SOND5,2015-09-30,856,1575,2431
10880,610,$SOND5,2015-12-31,856,1575,2431
10880,610,$SOND5,2016-03-31,856,1575,2431
10880,610,$SOND5,2016-06-30,856,1575,2431
10880,610,$SOND5,2016-09-30,856,1575,2431
10880,610,$SOND5,2016-12-31,856,1575,2431
10880,610,$SOND5,2017-03-31,856,1575,2431
10880,610,$SOND5,2017-06-30,856,1575,2431
10880,610,$SOND5,2017-09-30,856,1575,2431
10880,610,$SOND5,2017-12-31,856,1575,2431
10880,610,$SOND5,2018-03-31,856,1575,2431
10880,610,$SOND5,2018-06-30,856,1575,2431
10880,610,$SOND5,2018-09-30,856,1575,2431
10880,610,$SOND5,2018-12-31,856,1575,2431
10880,610,$SOND5,2019-03-31,856,1575,2431
10880,610,$SOND5,2019-06-30,856,1602,2458
10880,610,$SOND5,2019-09-30,856,1575,2431
10880,610,$SOND5,2019-12-31,856,1575,2431
10880,610,$SOND5,2020-03-31,856,1575,2431
10880,610,$SOND5,2020-06-30,856,1575,2431
10880,610,$SOND5,2020-09-30,856,1575,2431
10960,170,$SPRI3,2010-12-31,9445,3202,12647
10960,170,$SPRI3,2011-03-31,9445,3202,12647
10960,170,$SPRI3,2011-06-30,94450,32021,126471
10960,170,$SPRI3,2011-09-30,94450,32021,126471
10960,170,$SPRI3,2011-12-31,94450230,32020800,126471030
10960,170,$SPRI3,2012-03-31,94450,32021,126471
10960,170,$SPRI3,2012-06-30,94450,32021,126471
10960,170,$SPRI3,2012-09-30,94450,32021,126471
10960,170,$SPRI3,2012-12-31,94450230,32020800,126471030
10960,170,$SPRI3,2013-03-31,94450,32021,126471
10960,170,$SPRI3,2013-06-30,94450,32021,126471
10960,170,$SPRI3,2013-09-30,94450,32021,126471
10960,170,$SPRI3,2013-12-31,94450230,32020800,126471030
10960,170,$SPRI3,2014-03-31,94450,32021,126471
10960,170,$SPRI3,2014-06-30,94450,32021,126471
10960,170,$SPRI3,2014-09-30,94450,32021,126471
10960,170,$SPRI3,2014-12-31,94450230,32020800,126471030
10960,170,$SPRI3,2015-03-31,94450,32021,126471
10960,170,$SPRI3,2015-06-30,94450,32021,126471
10960,170,$SPRI3,2015-09-30,94450,32021,126471
10960,170,$SPRI3,2015-12-31,94450230,32020800,126471030
10960,170,$SPRI3,2016-03-31,94450230,32020800,126471030
10960,170,$SPRI3,2016-06-30,1889004,640415,2529419
10960,170,$SPRI3,2016-09-30,1889004,640415,2529419
10960,170,$SPRI3,2016-12-31,1889004,640415,2529419
10960,170,$SPRI3,2017-03-31,1889004,640415,2529419
10960,170,$SPRI3,2017-06-30,1889004,640415,2529419
10960,170,$SPRI3,2017-09-30,1889004,640415,2529419
10960,170,$SPRI3,2017-12-31,1889004,640415,2529419
10960,170,$SPRI3,2018-03-31,1889004,640415,2529419
10960,170,$SPRI3,2018-06-30,1889004,640415,2529419
10960,170,$SPRI3,2018-09-30,1889004,640415,2529419
10960,170,$SPRI3,2018-12-31,1889004,640415,2529419
10960,170,$SPRI3,2019-03-31,1889004,640415,2529419
10960,170,$SPRI3,2019-06-30,1889004,640415,2529419
10960,170,$SPRI3,2019-09-30,1889004,640415,2529419
10960,170,$SPRI3,2019-12-31,1889004,640415,2529419
10960,170,$SPRI3,2020-03-31,1889004,640415,2529419
10960,170,$SPRI3,2020-06-30,1889004,640415,2529419
10960,171,$SPRI5,2010-12-31,9445,3202,12647
10960,171,$SPRI5,2011-03-31,9445,3202,12647
10960,171,$SPRI5,2011-06-30,94450,32021,126471
10960,171,$SPRI5,2011-09-30,94450,32021,126471
10960,171,$SPRI5,2011-12-31,94450230,32020800,126471030
10960,171,$SPRI5,2012-03-31,94450,32021,126471
10960,171,$SPRI5,2012-06-30,94450,32021,126471
10960,171,$SPRI5,2012-09-30,94450,32021,126471
10960,171,$SPRI5,2012-12-31,94450230,32020800,126471030
10960,171,$SPRI5,2013-03-31,94450,32021,126471
10960,171,$SPRI5,2013-06-30,94450,32021,126471
10960,171,$SPRI5,2013-09-30,94450,32021,126471
10960,171,$SPRI5,2013-12-31,94450230,32020800,126471030
10960,171,$SPRI5,2014-03-31,94450,32021,126471
10960,171,$SPRI5,2014-06-30,94450,32021,126471
10960,171,$SPRI5,2014-09-30,94450,32021,126471
10960,171,$SPRI5,2014-12-31,94450230,32020800,126471030
10960,171,$SPRI5,2015-03-31,94450,32021,126471
10960,171,$SPRI5,2015-06-30,94450,32021,126471
10960,171,$SPRI5,2015-09-30,94450,32021,126471
10960,171,$SPRI5,2015-12-31,94450230,32020800,126471030
10960,171,$SPRI5,2016-03-31,94450230,32020800,126471030
10960,171,$SPRI5,2016-06-30,1889004,640415,2529419
10960,171,$SPRI5,2016-09-30,1889004,640415,2529419
10960,171,$SPRI5,2016-12-31,1889004,640415,2529419
10960,171,$SPRI5,2017-03-31,1889004,640415,2529419
10960,171,$SPRI5,2017-06-30,1889004,640415,2529419
10960,171,$SPRI5,2017-09-30,1889004,640415,2529419
10960,171,$SPRI5,2017-12-31,1889004,640415,2529419
10960,171,$SPRI5,2018-03-31,1889004,640415,2529419
10960,171,$SPRI5,2018-06-30,1889004,640415,2529419
10960,171,$SPRI5,2018-09-30,1889004,640415,2529419
10960,171,$SPRI5,2018-12-31,1889004,640415,2529419
10960,171,$SPRI5,2019-03-31,1889004,640415,2529419
10960,171,$SPRI5,2019-06-30,1889004,640415,2529419
10960,171,$SPRI5,2019-09-30,1889004,640415,2529419
10960,171,$SPRI5,2019-12-31,1889004,640415,2529419
10960,171,$SPRI5,2020-03-31,1889004,640415,2529419
10960,171,$SPRI5,2020-06-30,1889004,640415,2529419
10960,172,$SPRI6,2010-12-31,9445,3202,12647
10960,172,$SPRI6,2011-03-31,9445,3202,12647
10960,172,$SPRI6,2011-06-30,94450,32021,126471
10960,172,$SPRI6,2011-09-30,94450,32021,126471
10960,172,$SPRI6,2011-12-31,94450230,32020800,126471030
10960,172,$SPRI6,2012-03-31,94450,32021,126471
10960,172,$SPRI6,2012-06-30,94450,32021,126471
10960,172,$SPRI6,2012-09-30,94450,32021,126471
10960,172,$SPRI6,2012-12-31,94450230,32020800,126471030
10960,172,$SPRI6,2013-03-31,94450,32021,126471
10960,172,$SPRI6,2013-06-30,94450,32021,126471
10960,172,$SPRI6,2013-09-30,94450,32021,126471
10960,172,$SPRI6,2013-12-31,94450230,32020800,126471030
10960,172,$SPRI6,2014-03-31,94450,32021,126471
10960,172,$SPRI6,2014-06-30,94450,32021,126471
10960,172,$SPRI6,2014-09-30,94450,32021,126471
10960,172,$SPRI6,2014-12-31,94450230,32020800,126471030
10960,172,$SPRI6,2015-03-31,94450,32021,126471
10960,172,$SPRI6,2015-06-30,94450,32021,126471
10960,172,$SPRI6,2015-09-30,94450,32021,126471
10960,172,$SPRI6,2015-12-31,94450230,32020800,126471030
10960,172,$SPRI6,2016-03-31,94450230,32020800,126471030
10960,172,$SPRI6,2016-06-30,1889004,640415,2529419
10960,172,$SPRI6,2016-09-30,1889004,640415,2529419
10960,172,$SPRI6,2016-12-31,1889004,640415,2529419
10960,172,$SPRI6,2017-03-31,1889004,640415,2529419
10960,172,$SPRI6,2017-06-30,1889004,640415,2529419
10960,172,$SPRI6,2017-09-30,1889004,640415,2529419
10960,172,$SPRI6,2017-12-31,1889004,640415,2529419
10960,172,$SPRI6,2018-03-31,1889004,640415,2529419
10960,172,$SPRI6,2018-06-30,1889004,640415,2529419
10960,172,$SPRI6,2018-09-30,1889004,640415,2529419
10960,172,$SPRI6,2018-12-31,1889004,640415,2529419
10960,172,$SPRI6,2019-03-31,1889004,640415,2529419
10960,172,$SPRI6,2019-06-30,1889004,640415,2529419
10960,172,$SPRI6,2019-09-30,1889004,640415,2529419
10960,172,$SPRI6,2019-12-31,1889004,640415,2529419
10960,172,$SPRI6,2020-03-31,1889004,640415,2529419
10960,172,$SPRI6,2020-06-30,1889004,640415,2529419
11070,192,$WLMM3,2010-12-31,3314244,3968690,7282934
11070,192,$WLMM3,2011-03-31,3314244,3968690,7282934
11070,192,$WLMM3,2011-06-30,3314244,3968690,7282934
11070,192,$WLMM3,2011-09-30,3314244,3968690,7282934
11070,192,$WLMM3,2011-12-31,3314244,3968690,7282934
11070,192,$WLMM3,2012-03-31,3314244,3968690,7282934
11070,192,$WLMM3,2012-06-30,3314244,3968690,7282934
11070,192,$WLMM3,2012-09-30,3314244,3968690,7282934
11070,192,$WLMM3,2012-12-31,3314244,3968690,7282934
11070,192,$WLMM3,2013-03-31,3314244,3968690,7282934
11070,192,$WLMM3,2013-06-30,3314244,3968690,7282934
11070,192,$WLMM3,2013-09-30,3314244,3968690,7282934
11070,192,$WLMM3,2013-12-31,3314244,3968690,7282934
11070,192,$WLMM3,2014-03-31,3314244,3968690,7282934
11070,192,$WLMM3,2014-06-30,3314244,3968690,7282934
11070,192,$WLMM3,2014-09-30,3314244,3968690,7282934
11070,192,$WLMM3,2014-12-31,3314244,3968690,7282934
11070,192,$WLMM3,2015-03-31,3314244,3968690,7282934
11070,192,$WLMM3,2015-06-30,3314244,3968690,7282934
11070,192,$WLMM3,2015-09-30,16571220,19843450,36414670
11070,192,$WLMM3,2015-12-31,16571220,19843450,36414670
11070,192,$WLMM3,2016-03-31,16571220,19843450,36414670
11070,192,$WLMM3,2016-06-30,16571220,19843450,36414670
11070,192,$WLMM3,2016-09-30,16571220,19843450,36414670
11070,192,$WLMM3,2016-12-31,16571220,19843450,36414670
11070,192,$WLMM3,2017-03-31,16571220,19843450,36414670
11070,192,$WLMM3,2017-06-30,16571220,19843450,36414670
11070,192,$WLMM3,2017-09-30,16571220,19843450,36414670
11070,192,$WLMM3,2017-12-31,16571220,19843450,36414670
11070,192,$WLMM3,2018-03-31,16571220,19843450,36414670
11070,192,$WLMM3,2018-06-30,16571220,19843450,36414670
11070,192,$WLMM3,2018-09-30,16571220,19843450,36414670
11070,192,$WLMM3,2018-12-31,16571220,19843450,36414670
11070,192,$WLMM3,2019-03-31,16571220,19843450,36414670
11070,192,$WLMM3,2019-06-30,16571220,19843450,36414670
11070,192,$WLMM3,2019-09-30,16571220,19843450,36414670
11070,192,$WLMM3,2019-12-31,16571220,19843450,36414670
11070,192,$WLMM3,2020-03-31,16571220,19843450,36414670
11070,192,$WLMM3,2020-06-30,16571220,19843450,36414670
11070,192,$WLMM3,2020-09-30,16571220,19843450,36414670
11070,193,$WLMM4,2010-12-31,3314244,3968690,7282934
11070,193,$WLMM4,2011-03-31,3314244,3968690,7282934
11070,193,$WLMM4,2011-06-30,3314244,3968690,7282934
11070,193,$WLMM4,2011-09-30,3314244,3968690,7282934
11070,193,$WLMM4,2011-12-31,3314244,3968690,7282934
11070,193,$WLMM4,2012-03-31,3314244,3968690,7282934
11070,193,$WLMM4,2012-06-30,3314244,3968690,7282934
11070,193,$WLMM4,2012-09-30,3314244,3968690,7282934
11070,193,$WLMM4,2012-12-31,3314244,3968690,7282934
11070,193,$WLMM4,2013-03-31,3314244,3968690,7282934
11070,193,$WLMM4,2013-06-30,3314244,3968690,7282934
11070,193,$WLMM4,2013-09-30,3314244,3968690,7282934
11070,193,$WLMM4,2013-12-31,3314244,3968690,7282934
11070,193,$WLMM4,2014-03-31,3314244,3968690,7282934
11070,193,$WLMM4,2014-06-30,3314244,3968690,7282934
11070,193,$WLMM4,2014-09-30,3314244,3968690,7282934
11070,193,$WLMM4,2014-12-31,3314244,3968690,7282934
11070,193,$WLMM4,2015-03-31,3314244,3968690,7282934
11070,193,$WLMM4,2015-06-30,3314244,3968690,7282934
11070,193,$WLMM4,2015-09-30,16571220,19843450,36414670
11070,193,$WLMM4,2015-12-31,16571220,19843450,36414670
11070,193,$WLMM4,2016-03-31,16571220,19843450,36414670
11070,193,$WLMM4,2016-06-30,16571220,19843450,36414670
11070,193,$WLMM4,2016-09-30,16571220,19843450,36414670
11070,193,$WLMM4,2016-12-31,16571220,19843450,36414670
11070,193,$WLMM4,2017-03-31,16571220,19843450,36414670
11070,193,$WLMM4,2017-06-30,16571220,19843450,36414670
11070,193,$WLMM4,2017-09-30,16571220,19843450,36414670
11070,193,$WLMM4,2017-12-31,16571220,19843450,36414670
11070,193,$WLMM4,2018-03-31,16571220,19843450,36414670
11070,193,$WLMM4,2018-06-30,16571220,19843450,36414670
11070,193,$WLMM4,2018-09-30,16571220,19843450,36414670
11070,193,$WLMM4,2018-12-31,16571220,19843450,36414670
11070,193,$WLMM4,2019-03-31,16571220,19843450,36414670
11070,193,$WLMM4,2019-06-30,16571220,19843450,36414670
11070,193,$WLMM4,2019-09-30,16571220,19843450,36414670
11070,193,$WLMM4,2019-12-31,16571220,19843450,36414670
11070,193,$WLMM4,2020-03-31,16571220,19843450,36414670
11070,193,$WLMM4,2020-06-30,16571220,19843450,36414670
11070,193,$WLMM4,2020-09-30,16571220,19843450,36414670
11207,181,$TCNO3,2010-12-31,32000000,64000000,96000000
11207,181,$TCNO3,2011-03-31,32000,64000,96000
11207,181,$TCNO3,2011-06-30,32000,64000,96000
11207,181,$TCNO3,2011-09-30,32000,64000,96000
11207,181,$TCNO3,2011-12-31,32000000,64000000,96000000
11207,181,$TCNO3,2012-03-31,35305,64000,99305
11207,181,$TCNO3,2012-06-30,35305,64000,99305
11207,181,$TCNO3,2012-09-30,35305,64000,99305
11207,181,$TCNO3,2012-12-31,35305,64000,99305
11207,181,$TCNO3,2013-03-31,35305,64000,99305
11207,181,$TCNO3,2013-06-30,35305,64000,99305
11207,181,$TCNO3,2013-09-30,35305,64000,99305
11207,181,$TCNO3,2013-12-31,35305,64000,99305
11207,181,$TCNO3,2014-03-31,35305,64000,99305
11207,181,$TCNO3,2014-06-30,35305,64000,99305
11207,181,$TCNO3,2014-09-30,35305,64000,99305
11207,181,$TCNO3,2014-12-31,35305,64000,99305
11207,181,$TCNO3,2015-03-31,35305,64000,99305
11207,181,$TCNO3,2015-06-30,35305,64000,99305
11207,181,$TCNO3,2015-09-30,35305,64000,99305
11207,181,$TCNO3,2015-12-31,35305,64000,99305
11207,181,$TCNO3,2016-03-31,2353,4267,6620
11207,181,$TCNO3,2016-06-30,2353,4267,6620
11207,181,$TCNO3,2016-09-30,2353,4267,6620
11207,181,$TCNO3,2016-12-31,2353,4267,6620
11207,181,$TCNO3,2017-03-31,2353,4267,6620
11207,181,$TCNO3,2017-06-30,2353,4267,6620
11207,181,$TCNO3,2017-09-30,2353,4267,6620
11207,181,$TCNO3,2017-12-31,2353,4267,6620
11207,181,$TCNO3,2018-03-31,2353,4267,6620
11207,181,$TCNO3,2018-06-30,2353,4267,6620
11207,181,$TCNO3,2018-09-30,2353,4267,6620
11207,181,$TCNO3,2018-12-31,2353,4267,6620
11207,181,$TCNO3,2019-03-31,2353,4267,6620
11207,181,$TCNO3,2019-06-30,2353,4267,6620
11207,181,$TCNO3,2019-09-30,2353,4267,6620
11207,181,$TCNO3,2019-12-31,2353,4267,6620
11207,181,$TCNO3,2020-03-31,2353,4267,6620
11207,181,$TCNO3,2020-06-30,2353,4267,6620
11207,181,$TCNO3,2020-09-30,2353,4267,6620
11207,182,$TCNO4,2010-12-31,32000000,64000000,96000000
11207,182,$TCNO4,2011-03-31,32000,64000,96000
11207,182,$TCNO4,2011-06-30,32000,64000,96000
11207,182,$TCNO4,2011-09-30,32000,64000,96000
11207,182,$TCNO4,2011-12-31,32000000,64000000,96000000
11207,182,$TCNO4,2012-03-31,35305,64000,99305
11207,182,$TCNO4,2012-06-30,35305,64000,99305
11207,182,$TCNO4,2012-09-30,35305,64000,99305
11207,182,$TCNO4,2012-12-31,35305,64000,99305
11207,182,$TCNO4,2013-03-31,35305,64000,99305
11207,182,$TCNO4,2013-06-30,35305,64000,99305
11207,182,$TCNO4,2013-09-30,35305,64000,99305
11207,182,$TCNO4,2013-12-31,35305,64000,99305
11207,182,$TCNO4,2014-03-31,35305,64000,99305
11207,182,$TCNO4,2014-06-30,35305,64000,99305
11207,182,$TCNO4,2014-09-30,35305,64000,99305
11207,182,$TCNO4,2014-12-31,35305,64000,99305
11207,182,$TCNO4,2015-03-31,35305,64000,99305
11207,182,$TCNO4,2015-06-30,35305,64000,99305
11207,182,$TCNO4,2015-09-30,35305,64000,99305
11207,182,$TCNO4,2015-12-31,35305,64000,99305
11207,182,$TCNO4,2016-03-31,2353,4267,6620
11207,182,$TCNO4,2016-06-30,2353,4267,6620
11207,182,$TCNO4,2016-09-30,2353,4267,6620
11207,182,$TCNO4,2016-12-31,2353,4267,6620
11207,182,$TCNO4,2017-03-31,2353,4267,6620
11207,182,$TCNO4,2017-06-30,2353,4267,6620
11207,182,$TCNO4,2017-09-30,2353,4267,6620
11207,182,$TCNO4,2017-12-31,2353,4267,6620
11207,182,$TCNO4,2018-03-31,2353,4267,6620
11207,182,$TCNO4,2018-06-30,2353,4267,6620
11207,182,$TCNO4,2018-09-30,2353,4267,6620
11207,182,$TCNO4,2018-12-31,2353,4267,6620
11207,182,$TCNO4,2019-03-31,2353,4267,6620
11207,182,$TCNO4,2019-06-30,2353,4267,6620
11207,182,$TCNO4,2019-09-30,2353,4267,6620
11207,182,$TCNO4,2019-12-31,2353,4267,6620
11207,182,$TCNO4,2020-03-31,2353,4267,6620
11207,182,$TCNO4,2020-06-30,2353,4267,6620
11207,182,$TCNO4,2020-09-30,2353,4267,6620
11215,173,$11215,2010-12-31,181,1026,1207
11215,173,$11215,2011-03-31,180894,1025897,1206791
11215,173,$11215,2011-06-30,180894,1025897,1206791
11215,173,$11215,2011-09-30,180894,1025897,1206791
11215,173,$11215,2011-12-31,180894,1025897,1206791
11215,173,$11215,2012-03-31,180894,1025897,1206791
11215,173,$11215,2012-06-30,180894,1025897,1206791
11215,173,$11215,2012-09-30,180894,1025897,1206791
11215,173,$11215,2012-12-31,180894,1025897,1206791
11215,173,$11215,2013-03-31,180894,1025897,1206791
11215,173,$11215,2013-06-30,180894,1025897,1206791
11215,173,$11215,2013-09-30,180894,1025897,1206791
11215,173,$11215,2013-12-31,180894,1025897,1206791
11215,173,$11215,2014-03-31,180894,1025897,1206791
11215,173,$11215,2014-06-30,180894,1025897,1206791
11215,173,$11215,2014-09-30,180894,1025897,1206791
11215,173,$11215,2014-12-31,180894,1025897,1206791
11215,173,$11215,2015-03-31,180894,1025897,1206791
11215,173,$11215,2015-06-30,180894,1025897,1206791
11215,173,$11215,2015-09-30,180894,1025897,1206791
11215,173,$11215,2015-12-31,180894,1025897,1206791
11215,173,$11215,2016-03-31,180894,1025897,1206791
11215,173,$11215,2016-06-30,180894,1025897,1206791
11215,173,$11215,2016-09-30,180894,1025897,1206791
11215,173,$11215,2016-12-31,180894,1025897,1206791
11215,173,$11215,2017-03-31,180894,1025897,1206791
11215,173,$11215,2017-06-30,180894,1025897,1206791
11215,173,$11215,2017-09-30,180894,1025897,1206791
11215,173,$11215,2017-12-31,180894,1025897,1206791
11215,173,$11215,2018-03-31,180894,1025897,1206791
11215,173,$11215,2018-06-30,180894,1025897,1206791
11215,173,$11215,2018-09-30,180894,1025897,1206791
11215,173,$11215,2018-12-31,180894,1025897,1206791
11215,173,$11215,2019-03-31,180894,1025897,1206791
11215,173,$11215,2019-06-30,180894,1025897,1206791
11215,173,$11215,2019-09-30,180894,1025897,1206791
11223,187,$TEKA3,2010-12-31,12786,25573,38359
11223,187,$TEKA3,2011-03-31,12786,25573,38359
11223,187,$TEKA3,2011-06-30,12786,25573,38359
11223,187,$TEKA3,2011-09-30,12786,25573,38359
11223,187,$TEKA3,2011-12-31,12786,25573,38359
11223,187,$TEKA3,2012-03-31,12786,25573,38359
11223,187,$TEKA3,2012-06-30,16791,33524,50315
11223,187,$TEKA3,2012-09-30,16791,33524,50315
11223,187,$TEKA3,2012-12-31,16791,33524,50315
11223,187,$TEKA3,2013-03-31,16791,33524,50315
11223,187,$TEKA3,2013-06-30,16791,33524,50315
11223,187,$TEKA3,2013-09-30,16791,33524,50315
11223,187,$TEKA3,2013-12-31,16791,33524,50315
11223,187,$TEKA3,2014-03-31,16791,33524,50315
11223,187,$TEKA3,2014-06-30,16791,33524,50315
11223,187,$TEKA3,2014-09-30,16791,33524,50315
11223,187,$TEKA3,2014-12-31,16791,33524,50315
11223,187,$TEKA3,2015-03-31,16791,33524,50315
11223,187,$TEKA3,2015-06-30,16791,33524,50315
11223,187,$TEKA3,2015-09-30,16791,33524,50315
11223,187,$TEKA3,2015-12-31,168,335,503
11223,187,$TEKA3,2016-03-31,168,335,503
11223,187,$TEKA3,2016-06-30,168,335,503
11223,187,$TEKA3,2016-09-30,168,335,503
11223,187,$TEKA3,2016-12-31,168,335,503
11223,187,$TEKA3,2017-03-31,168,335,503
11223,187,$TEKA3,2017-06-30,168,335,503
11223,187,$TEKA3,2017-09-30,168,335,503
11223,187,$TEKA3,2017-12-31,168,335,503
11223,187,$TEKA3,2018-03-31,168,335,503
11223,187,$TEKA3,2018-06-30,168,335,503
11223,187,$TEKA3,2018-09-30,168,335,503
11223,187,$TEKA3,2018-12-31,168,335,503
11223,187,$TEKA3,2019-03-31,168,335,503
11223,187,$TEKA3,2019-06-30,168,335,503
11223,187,$TEKA3,2019-09-30,168,335,503
11223,187,$TEKA3,2019-12-31,168,335,503
11223,187,$TEKA3,2020-03-31,168,335,503
11223,187,$TEKA3,2020-06-30,168,335,503
11223,187,$TEKA3,2020-09-30,168,335,503
11223,188,$TEKA4,2010-12-31,12786,25573,38359
11223,188,$TEKA4,2011-03-31,12786,25573,38359
11223,188,$TEKA4,2011-06-30,12786,25573,38359
11223,188,$TEKA4,2011-09-30,12786,25573,38359
11223,188,$TEKA4,2011-12-31,12786,25573,38359
11223,188,$TEKA4,2012-03-31,12786,25573,38359
11223,188,$TEKA4,2012-06-30,16791,33524,50315
11223,188,$TEKA4,2012-09-30,16791,33524,50315
11223,188,$TEKA4,2012-12-31,16791,33524,50315
11223,188,$TEKA4,2013-03-31,16791,33524,50315
11223,188,$TEKA4,2013-06-30,16791,33524,50315
11223,188,$TEKA4,2013-09-30,16791,33524,50315
11223,188,$TEKA4,2013-12-31,16791,33524,50315
11223,188,$TEKA4,2014-03-31,16791,33524,50315
11223,188,$TEKA4,2014-06-30,16791,33524,50315
11223,188,$TEKA4,2014-09-30,16791,33524,50315
11223,188,$TEKA4,2014-12-31,16791,33524,50315
11223,188,$TEKA4,2015-03-31,16791,33524,50315
11223,188,$TEKA4,2015-06-30,16791,33524,50315
11223,188,$TEKA4,2015-09-30,16791,33524,50315
11223,188,$TEKA4,2015-12-31,168,335,503
11223,188,$TEKA4,2016-03-31,168,335,503
11223,188,$TEKA4,2016-06-30,168,335,503
11223,188,$TEKA4,2016-09-30,168,335,503
11223,188,$TEKA4,2016-12-31,168,335,503
11223,188,$TEKA4,2017-03-31,168,335,503
11223,188,$TEKA4,2017-06-30,168,335,503
11223,188,$TEKA4,2017-09-30,168,335,503
11223,188,$TEKA4,2017-12-31,168,335,503
11223,188,$TEKA4,2018-03-31,168,335,503
11223,188,$TEKA4,2018-06-30,168,335,503
11223,188,$TEKA4,2018-09-30,168,335,503
11223,188,$TEKA4,2018-12-31,168,335,503
11223,188,$TEKA4,2019-03-31,168,335,503
11223,188,$TEKA4,2019-06-30,168,335,503
11223,188,$TEKA4,2019-09-30,168,335,503
11223,188,$TEKA4,2019-12-31,168,335,503
11223,188,$TEKA4,2020-03-31,168,335,503
11223,188,$TEKA4,2020-06-30,168,335,503
11223,188,$TEKA4,2020-09-30,168,335,503
11231,185,$TKNO3,2010-12-31,1419,1216,2635
11231,185,$TKNO3,2011-03-31,1419,1216,2635
11231,185,$TKNO3,2011-06-30,1450,1244,2694
11231,185,$TKNO3,2011-09-30,1450,1244,2694
11231,185,$TKNO3,2011-12-31,1450,1244,2694
11231,185,$TKNO3,2012-03-31,1450,1244,2694
11231,185,$TKNO3,2012-06-30,1492,1279,2771
11231,185,$TKNO3,2012-09-30,1492,1279,2771
11231,185,$TKNO3,2012-12-31,1279,1492,2771
11231,185,$TKNO3,2013-03-31,1279,1492,2771
11231,185,$TKNO3,2013-06-30,1319,1538,2857
11231,185,$TKNO3,2013-09-30,1538,1319,2857
11231,185,$TKNO3,2013-12-31,1538,1319,2857
11231,185,$TKNO3,2014-03-31,1538,1319,2857
11231,185,$TKNO3,2014-06-30,1587,1361,2948
11231,185,$TKNO3,2014-09-30,1587,1361,2948
11231,185,$TKNO3,2014-12-31,1587,1361,2948
11231,185,$TKNO3,2015-03-31,1587,1361,2948
11231,185,$TKNO3,2015-06-30,1587,1361,2948
11231,185,$TKNO3,2015-09-30,1587,1361,2948
11231,185,$TKNO3,2015-12-31,1587,1361,2948
11231,185,$TKNO3,2016-03-31,1361,1587,2948
11231,185,$TKNO3,2016-06-30,1361,1587,2948
11231,185,$TKNO3,2016-09-30,1361,1587,2948
11231,185,$TKNO3,2016-12-31,1361,1587,2948
11231,185,$TKNO3,2017-03-31,1361,1587,2948
11231,185,$TKNO3,2017-06-30,1361,1587,2948
11231,185,$TKNO3,2017-09-30,1361,1587,2948
11231,185,$TKNO3,2017-12-31,1361,1587,2948
11231,185,$TKNO3,2018-03-31,1361,1587,2948
11231,185,$TKNO3,2018-06-30,1361,1587,2948
11231,185,$TKNO3,2018-09-30,1361,1587,2948
11231,185,$TKNO3,2018-12-31,1361,1587,2948
11231,185,$TKNO3,2019-03-31,1361,1587,2948
11231,185,$TKNO3,2019-06-30,1361,1587,2948
11231,185,$TKNO3,2019-09-30,1361,1587,2948
11231,185,$TKNO3,2019-12-31,1361,1587,2948
11231,185,$TKNO3,2020-03-31,1361,1587,2948
11231,185,$TKNO3,2020-06-30,1361,1587,2948
11231,185,$TKNO3,2020-09-30,1361,1587,2948
11231,186,$TKNO4,2010-12-31,1419,1216,2635
11231,186,$TKNO4,2011-03-31,1419,1216,2635
11231,186,$TKNO4,2011-06-30,1450,1244,2694
11231,186,$TKNO4,2011-09-30,1450,1244,2694
11231,186,$TKNO4,2011-12-31,1450,1244,2694
11231,186,$TKNO4,2012-03-31,1450,1244,2694
11231,186,$TKNO4,2012-06-30,1492,1279,2771
11231,186,$TKNO4,2012-09-30,1492,1279,2771
11231,186,$TKNO4,2012-12-31,1279,1492,2771
11231,186,$TKNO4,2013-03-31,1279,1492,2771
11231,186,$TKNO4,2013-06-30,1319,1538,2857
11231,186,$TKNO4,2013-09-30,1538,1319,2857
11231,186,$TKNO4,2013-12-31,1538,1319,2857
11231,186,$TKNO4,2014-03-31,1538,1319,2857
11231,186,$TKNO4,2014-06-30,1587,1361,2948
11231,186,$TKNO4,2014-09-30,1587,1361,2948
11231,186,$TKNO4,2014-12-31,1587,1361,2948
11231,186,$TKNO4,2015-03-31,1587,1361,2948
11231,186,$TKNO4,2015-06-30,1587,1361,2948
11231,186,$TKNO4,2015-09-30,1587,1361,2948
11231,186,$TKNO4,2015-12-31,1587,1361,2948
11231,186,$TKNO4,2016-03-31,1361,1587,2948
11231,186,$TKNO4,2016-06-30,1361,1587,2948
11231,186,$TKNO4,2016-09-30,1361,1587,2948
11231,186,$TKNO4,2016-12-31,1361,1587,2948
11231,186,$TKNO4,2017-03-31,1361,1587,2948
11231,186,$TKNO4,2017-06-30,1361,1587,2948
11231,186,$TKNO4,2017-09-30,1361,1587,2948
11231,186,$TKNO4,2017-12-31,1361,1587,2948
11231,186,$TKNO4,2018-03-31,1361,1587,2948
11231,186,$TKNO4,2018-06-30,1361,1587,2948
11231,186,$TKNO4,2018-09-30,1361,1587,2948
11231,186,$TKNO4,2018-12-31,1361,1587,2948
11231,186,$TKNO4,2019-03-31,1361,1587,2948
11231,186,$TKNO4,2019-06-30,1361,1587,2948
11231,186,$TKNO4,2019-09-30,1361,1587,2948
11231,186,$TKNO4,2019-12-31,1361,1587,2948
11231,186,$TKNO4,2020-03-31,1361,1587,2948
11231,186,$TKNO4,2020-06-30,1361,1587,2948
11231,186,$TKNO4,2020-09-30,1361,1587,2948
11258,197,$TELB3,2010-12-31,886919131950,210029997060,1096949129010
11258,197,$TELB3,2011-03-31,88695913,21002999,109698912
11258,197,$TELB3,2011-06-30,88695913,21002999,109698912
11258,197,$TELB3,2011-09-30,88695913,21002999,109698912
11258,197,$TELB3,2011-12-31,88695913,21002999,109698912
11258,197,$TELB3,2012-03-31,88695913,21002999,109698912
11258,197,$TELB3,2012-06-30,88695913,21002999,109698912
11258,197,$TELB3,2012-09-30,97439719,21002999,118442718
11258,197,$TELB3,2012-12-31,97439719,21002999,118442718
11258,197,$TELB3,2013-03-31,97439719,21002999,118442718
11258,197,$TELB3,2013-06-30,97439719,21002999,118442718
11258,197,$TELB3,2013-09-30,97439719,21002999,118442718
11258,197,$TELB3,2013-12-31,97439719,21002999,118442718
11258,197,$TELB3,2014-03-31,97439719,21002999,118442718
11258,197,$TELB3,2014-06-30,97437783,21002999,118440782
11258,197,$TELB3,2014-09-30,97437783,21002999,118440782
11258,197,$TELB3,2014-12-31,97437783,21002999,118440782
11258,197,$TELB3,2015-03-31,97437783,21002999,118440782
11258,197,$TELB3,2015-06-30,97437783,21002999,118440782
11258,197,$TELB3,2015-09-30,97437783,21002999,118440782
11258,197,$TELB3,2015-12-31,97437783,21002999,118440782
11258,197,$TELB3,2016-03-31,97437783,21002999,118440782
11258,197,$TELB3,2016-06-30,97437783,21002999,118440782
11258,197,$TELB3,2016-09-30,9743971,2100299,11844270
11258,197,$TELB3,2016-12-31,9743971,2100299,11844270
11258,197,$TELB3,2017-03-31,9743971,2100299,11844270
11258,197,$TELB3,2017-06-30,9743971,2100299,11844270
11258,197,$TELB3,2017-09-30,9743971,2100299,11844270
11258,197,$TELB3,2017-12-31,39272779,10332711,49605490
11258,197,$TELB3,2018-03-31,39272779,10332711,49605490
11258,197,$TELB3,2018-06-30,39272779,10332711,49605490
11258,197,$TELB3,2018-09-30,39272779,10332711,49605490
11258,197,$TELB3,2018-12-31,39272779,10332711,49605490
11258,197,$TELB3,2019-03-31,39272779,10332711,49605490
11258,197,$TELB3,2019-06-30,39272779,10332711,49605490
11258,197,$TELB3,2019-09-30,39272779,10332711,49605490
11258,197,$TELB3,2019-12-31,39272779,10332711,49605490
11258,197,$TELB3,2020-03-31,39272779,10332711,49605490
11258,197,$TELB3,2020-06-30,49457271,18407491,67864762
11258,197,$TELB3,2020-09-30,49457271,18407491,67864762
11258,198,$TELB4,2010-12-31,886919131950,210029997060,1096949129010
11258,198,$TELB4,2011-03-31,88695913,21002999,109698912
11258,198,$TELB4,2011-06-30,88695913,21002999,109698912
11258,198,$TELB4,2011-09-30,88695913,21002999,109698912
11258,198,$TELB4,2011-12-31,88695913,21002999,109698912
11258,198,$TELB4,2012-03-31,88695913,21002999,109698912
11258,198,$TELB4,2012-06-30,88695913,21002999,109698912
11258,198,$TELB4,2012-09-30,97439719,21002999,118442718
11258,198,$TELB4,2012-12-31,97439719,21002999,118442718
11258,198,$TELB4,2013-03-31,97439719,21002999,118442718
11258,198,$TELB4,2013-06-30,97439719,21002999,118442718
11258,198,$TELB4,2013-09-30,97439719,21002999,118442718
11258,198,$TELB4,2013-12-31,97439719,21002999,118442718
11258,198,$TELB4,2014-03-31,97439719,21002999,118442718
11258,198,$TELB4,2014-06-30,97437783,21002999,118440782
11258,198,$TELB4,2014-09-30,97437783,21002999,118440782
11258,198,$TELB4,2014-12-31,97437783,21002999,118440782
11258,198,$TELB4,2015-03-31,97437783,21002999,118440782
11258,198,$TELB4,2015-06-30,97437783,21002999,118440782
11258,198,$TELB4,2015-09-30,97437783,21002999,118440782
11258,198,$TELB4,2015-12-31,97437783,21002999,118440782
11258,198,$TELB4,2016-03-31,97437783,21002999,118440782
11258,198,$TELB4,2016-06-30,97437783,21002999,118440782
11258,198,$TELB4,2016-09-30,9743971,2100299,11844270
11258,198,$TELB4,2016-12-31,9743971,2100299,11844270
11258,198,$TELB4,2017-03-31,9743971,2100299,11844270
11258,198,$TELB4,2017-06-30,9743971,2100299,11844270
11258,198,$TELB4,2017-09-30,9743971,2100299,11844270
11258,198,$TELB4,2017-12-31,39272779,10332711,49605490
11258,198,$TELB4,2018-03-31,39272779,10332711,49605490
11258,198,$TELB4,2018-06-30,39272779,10332711,49605490
11258,198,$TELB4,2018-09-30,39272779,10332711,49605490
11258,198,$TELB4,2018-12-31,39272779,10332711,49605490
11258,198,$TELB4,2019-03-31,39272779,10332711,49605490
11258,198,$TELB4,2019-06-30,39272779,10332711,49605490
11258,198,$TELB4,2019-09-30,39272779,10332711,49605490
11258,198,$TELB4,2019-12-31,39272779,10332711,49605490
11258,198,$TELB4,2020-03-31,39272779,10332711,49605490
11258,198,$TELB4,2020-06-30,49457271,18407491,67864762
11258,198,$TELB4,2020-09-30,49457271,18407491,67864762
11398,189,$CRPG3,2010-12-31,812672,1508828,2321500
11398,189,$CRPG3,2011-03-31,812672,1508828,2321500
11398,189,$CRPG3,2011-06-30,812671,1508829,2321500
11398,189,$CRPG3,2011-09-30,812672,1508828,2321500
11398,189,$CRPG3,2011-12-31,812672,1508828,2321500
11398,189,$CRPG3,2012-03-31,812671840,1508827930,2321499770
11398,189,$CRPG3,2012-06-30,812671840,1508827930,2321499770
11398,189,$CRPG3,2012-09-30,812671840,1508827930,2321499770
11398,189,$CRPG3,2012-12-31,812672,1508828,2321500
11398,189,$CRPG3,2013-03-31,812672,1508828,2321500
11398,189,$CRPG3,2013-06-30,812672,1508828,2321500
11398,189,$CRPG3,2013-09-30,812672,1508828,2321500
11398,189,$CRPG3,2013-12-31,812671840,1508827930,2321499770
11398,189,$CRPG3,2014-03-31,812672,1508828,2321500
11398,189,$CRPG3,2014-06-30,812672,1508828,2321500
11398,189,$CRPG3,2014-09-30,812672,1508828,2321500
11398,189,$CRPG3,2014-12-31,812671900,1508827900,2321499800
11398,189,$CRPG3,2015-03-31,8126719,15088279,23214998
11398,189,$CRPG3,2015-06-30,8126719,15088279,23214998
11398,189,$CRPG3,2015-09-30,8126719,15088279,23214998
11398,189,$CRPG3,2015-12-31,8126718,15088280,23214998
11398,189,$CRPG3,2016-03-31,8126719,15088279,23214998
11398,189,$CRPG3,2016-06-30,8126719,15088279,23214998
11398,189,$CRPG3,2016-09-30,8126719,15088279,23214998
11398,189,$CRPG3,2016-12-31,8126718,15088280,23214998
11398,189,$CRPG3,2017-03-31,8126719,15088279,23214998
11398,189,$CRPG3,2017-06-30,8126719,15088279,23214998
11398,189,$CRPG3,2017-09-30,8126719,15088279,23214998
11398,189,$CRPG3,2017-12-31,8126718,15088280,23214998
11398,189,$CRPG3,2018-03-31,8126719,15088279,23214998
11398,189,$CRPG3,2018-06-30,8126719,15088279,23214998
11398,189,$CRPG3,2018-09-30,8126719,15088279,23214998
11398,189,$CRPG3,2018-12-31,8126718,15088280,23214998
11398,189,$CRPG3,2019-03-31,8126719,15088279,23214998
11398,189,$CRPG3,2019-06-30,10158398,18860349,29018747
11398,189,$CRPG3,2019-09-30,10158398,18860349,29018747
11398,189,$CRPG3,2019-12-31,10158398,18860349,29018747
11398,189,$CRPG3,2020-03-31,10158398,18860349,29018747
11398,189,$CRPG3,2020-06-30,10158398,18860349,29018747
11398,189,$CRPG3,2020-09-30,10158398,18860349,29018747
11398,190,$CRPG6,2010-12-31,812672,1508828,2321500
11398,190,$CRPG6,2011-03-31,812672,1508828,2321500
11398,190,$CRPG6,2011-06-30,812671,1508829,2321500
11398,190,$CRPG6,2011-09-30,812672,1508828,2321500
11398,190,$CRPG6,2011-12-31,812672,1508828,2321500
11398,190,$CRPG6,2012-03-31,812671840,1508827930,2321499770
11398,190,$CRPG6,2012-06-30,812671840,1508827930,2321499770
11398,190,$CRPG6,2012-09-30,812671840,1508827930,2321499770
11398,190,$CRPG6,2012-12-31,812672,1508828,2321500
11398,190,$CRPG6,2013-03-31,812672,1508828,2321500
11398,190,$CRPG6,2013-06-30,812672,1508828,2321500
11398,190,$CRPG6,2013-09-30,812672,1508828,2321500
11398,190,$CRPG6,2013-12-31,812671840,1508827930,2321499770
11398,190,$CRPG6,2014-03-31,812672,1508828,2321500
11398,190,$CRPG6,2014-06-30,812672,1508828,2321500
11398,190,$CRPG6,2014-09-30,812672,1508828,2321500
11398,190,$CRPG6,2014-12-31,812671900,1508827900,2321499800
11398,190,$CRPG6,2015-03-31,8126719,15088279,23214998
11398,190,$CRPG6,2015-06-30,8126719,15088279,23214998
11398,190,$CRPG6,2015-09-30,8126719,15088279,23214998
11398,190,$CRPG6,2015-12-31,8126718,15088280,23214998
11398,190,$CRPG6,2016-03-31,8126719,15088279,23214998
11398,190,$CRPG6,2016-06-30,8126719,15088279,23214998
11398,190,$CRPG6,2016-09-30,8126719,15088279,23214998
11398,190,$CRPG6,2016-12-31,8126718,15088280,23214998
11398,190,$CRPG6,2017-03-31,8126719,15088279,23214998
11398,190,$CRPG6,2017-06-30,8126719,15088279,23214998
11398,190,$CRPG6,2017-09-30,8126719,15088279,23214998
11398,190,$CRPG6,2017-12-31,8126718,15088280,23214998
11398,190,$CRPG6,2018-03-31,8126719,15088279,23214998
11398,190,$CRPG6,2018-06-30,8126719,15088279,23214998
11398,190,$CRPG6,2018-09-30,8126719,15088279,23214998
11398,190,$CRPG6,2018-12-31,8126718,15088280,23214998
11398,190,$CRPG6,2019-03-31,8126719,15088279,23214998
11398,190,$CRPG6,2019-06-30,10158398,18860349,29018747
11398,190,$CRPG6,2019-09-30,10158398,18860349,29018747
11398,190,$CRPG6,2019-12-31,10158398,18860349,29018747
11398,190,$CRPG6,2020-03-31,10158398,18860349,29018747
11398,190,$CRPG6,2020-06-30,10158398,18860349,29018747
11398,190,$CRPG6,2020-09-30,10158398,18860349,29018747
11398,191,$CRPG5,2010-12-31,812672,1508828,2321500
11398,191,$CRPG5,2011-03-31,812672,1508828,2321500
11398,191,$CRPG5,2011-06-30,812671,1508829,2321500
11398,191,$CRPG5,2011-09-30,812672,1508828,2321500
11398,191,$CRPG5,2011-12-31,812672,1508828,2321500
11398,191,$CRPG5,2012-03-31,812671840,1508827930,2321499770
11398,191,$CRPG5,2012-06-30,812671840,1508827930,2321499770
11398,191,$CRPG5,2012-09-30,812671840,1508827930,2321499770
11398,191,$CRPG5,2012-12-31,812672,1508828,2321500
11398,191,$CRPG5,2013-03-31,812672,1508828,2321500
11398,191,$CRPG5,2013-06-30,812672,1508828,2321500
11398,191,$CRPG5,2013-09-30,812672,1508828,2321500
11398,191,$CRPG5,2013-12-31,812671840,1508827930,2321499770
11398,191,$CRPG5,2014-03-31,812672,1508828,2321500
11398,191,$CRPG5,2014-06-30,812672,1508828,2321500
11398,191,$CRPG5,2014-09-30,812672,1508828,2321500
11398,191,$CRPG5,2014-12-31,812671900,1508827900,2321499800
11398,191,$CRPG5,2015-03-31,8126719,15088279,23214998
11398,191,$CRPG5,2015-06-30,8126719,15088279,23214998
11398,191,$CRPG5,2015-09-30,8126719,15088279,23214998
11398,191,$CRPG5,2015-12-31,8126718,15088280,23214998
11398,191,$CRPG5,2016-03-31,8126719,15088279,23214998
11398,191,$CRPG5,2016-06-30,8126719,15088279,23214998
11398,191,$CRPG5,2016-09-30,8126719,15088279,23214998
11398,191,$CRPG5,2016-12-31,8126718,15088280,23214998
11398,191,$CRPG5,2017-03-31,8126719,15088279,23214998
11398,191,$CRPG5,2017-06-30,8126719,15088279,23214998
11398,191,$CRPG5,2017-09-30,8126719,15088279,23214998
11398,191,$CRPG5,2017-12-31,8126718,15088280,23214998
11398,191,$CRPG5,2018-03-31,8126719,15088279,23214998
11398,191,$CRPG5,2018-06-30,8126719,15088279,23214998
11398,191,$CRPG5,2018-09-30,8126719,15088279,23214998
11398,191,$CRPG5,2018-12-31,8126718,15088280,23214998
11398,191,$CRPG5,2019-03-31,8126719,15088279,23214998
11398,191,$CRPG5,2019-06-30,10158398,18860349,29018747
11398,191,$CRPG5,2019-09-30,10158398,18860349,29018747
11398,191,$CRPG5,2019-12-31,10158398,18860349,29018747
11398,191,$CRPG5,2020-03-31,10158398,18860349,29018747
11398,191,$CRPG5,2020-06-30,10158398,18860349,29018747
11398,191,$CRPG5,2020-09-30,10158398,18860349,29018747
11592,194,$UNIP3,2010-12-31,278499,556999,835498
11592,194,$UNIP3,2011-03-31,278499,556999,835498
11592,194,$UNIP3,2011-06-30,278499,556999,835498
11592,194,$UNIP3,2011-09-30,278499,556999,835498
11592,194,$UNIP3,2011-12-31,278499,556999,835498
11592,194,$UNIP3,2012-03-31,278499,556999,835498
11592,194,$UNIP3,2012-06-30,278499,556999,835498
11592,194,$UNIP3,2012-09-30,278499,556999,835498
11592,194,$UNIP3,2012-12-31,278499,556999,835498
11592,194,$UNIP3,2013-03-31,278499,556999,835498
11592,194,$UNIP3,2013-06-30,278499,556999,835498
11592,194,$UNIP3,2013-09-30,278501,557001,835502
11592,194,$UNIP3,2013-12-31,278501,557001,835502
11592,194,$UNIP3,2014-03-31,278501,557001,835502
11592,194,$UNIP3,2014-06-30,278501,557001,835502
11592,194,$UNIP3,2014-09-30,278501,557001,835502
11592,194,$UNIP3,2014-12-31,27850,55700,83550
11592,194,$UNIP3,2015-03-31,27850,55700,83550
11592,194,$UNIP3,2015-06-30,27850,55700,83550
11592,194,$UNIP3,2015-09-30,27850,55700,83550
11592,194,$UNIP3,2015-12-31,27850,55700,83550
11592,194,$UNIP3,2016-03-31,27850,55700,83550
11592,194,$UNIP3,2016-06-30,27850,55700,83550
11592,194,$UNIP3,2016-09-30,27850,55700,83550
11592,194,$UNIP3,2016-12-31,27850,55700,83550
11592,194,$UNIP3,2017-03-31,27850,55700,83550
11592,194,$UNIP3,2017-06-30,27850,55700,83550
11592,194,$UNIP3,2017-09-30,27850,55700,83550
11592,194,$UNIP3,2017-12-31,27850,55700,83550
11592,194,$UNIP3,2018-03-31,27850,55700,83550
11592,194,$UNIP3,2018-06-30,27850,55700,83550
11592,194,$UNIP3,2018-09-30,27850,55700,83550
11592,194,$UNIP3,2018-12-31,30382,60764,91146
11592,194,$UNIP3,2019-03-31,30216,56938,87154
11592,194,$UNIP3,2019-06-30,35252,66428,101680
11592,194,$UNIP3,2019-09-30,35252,66428,101680
11592,194,$UNIP3,2019-12-31,35252,66428,101680
11592,194,$UNIP3,2020-03-31,34462,63356,97818
11592,194,$UNIP3,2020-06-30,34462,63356,97818
11592,194,$UNIP3,2020-09-30,33703,61914,95617
11592,195,$UNIP6,2010-12-31,278499,556999,835498
11592,195,$UNIP6,2011-03-31,278499,556999,835498
11592,195,$UNIP6,2011-06-30,278499,556999,835498
11592,195,$UNIP6,2011-09-30,278499,556999,835498
11592,195,$UNIP6,2011-12-31,278499,556999,835498
11592,195,$UNIP6,2012-03-31,278499,556999,835498
11592,195,$UNIP6,2012-06-30,278499,556999,835498
11592,195,$UNIP6,2012-09-30,278499,556999,835498
11592,195,$UNIP6,2012-12-31,278499,556999,835498
11592,195,$UNIP6,2013-03-31,278499,556999,835498
11592,195,$UNIP6,2013-06-30,278499,556999,835498
11592,195,$UNIP6,2013-09-30,278501,557001,835502
11592,195,$UNIP6,2013-12-31,278501,557001,835502
11592,195,$UNIP6,2014-03-31,278501,557001,835502
11592,195,$UNIP6,2014-06-30,278501,557001,835502
11592,195,$UNIP6,2014-09-30,278501,557001,835502
11592,195,$UNIP6,2014-12-31,27850,55700,83550
11592,195,$UNIP6,2015-03-31,27850,55700,83550
11592,195,$UNIP6,2015-06-30,27850,55700,83550
11592,195,$UNIP6,2015-09-30,27850,55700,83550
11592,195,$UNIP6,2015-12-31,27850,55700,83550
11592,195,$UNIP6,2016-03-31,27850,55700,83550
11592,195,$UNIP6,2016-06-30,27850,55700,83550
11592,195,$UNIP6,2016-09-30,27850,55700,83550
11592,195,$UNIP6,2016-12-31,27850,55700,83550
11592,195,$UNIP6,2017-03-31,27850,55700,83550
11592,195,$UNIP6,2017-06-30,27850,55700,83550
11592,195,$UNIP6,2017-09-30,27850,55700,83550
11592,195,$UNIP6,2017-12-31,27850,55700,83550
11592,195,$UNIP6,2018-03-31,27850,55700,83550
11592,195,$UNIP6,2018-06-30,27850,55700,83550
11592,195,$UNIP6,2018-09-30,27850,55700,83550
11592,195,$UNIP6,2018-12-31,30382,60764,91146
11592,195,$UNIP6,2019-03-31,30216,56938,87154
11592,195,$UNIP6,2019-06-30,35252,66428,101680
11592,195,$UNIP6,2019-09-30,35252,66428,101680
11592,195,$UNIP6,2019-12-31,35252,66428,101680
11592,195,$UNIP6,2020-03-31,34462,63356,97818
11592,195,$UNIP6,2020-06-30,34462,63356,97818
11592,195,$UNIP6,2020-09-30,33703,61914,95617
11592,196,$UNIP5,2010-12-31,278499,556999,835498
11592,196,$UNIP5,2011-03-31,278499,556999,835498
11592,196,$UNIP5,2011-06-30,278499,556999,835498
11592,196,$UNIP5,2011-09-30,278499,556999,835498
11592,196,$UNIP5,2011-12-31,278499,556999,835498
11592,196,$UNIP5,2012-03-31,278499,556999,835498
11592,196,$UNIP5,2012-06-30,278499,556999,835498
11592,196,$UNIP5,2012-09-30,278499,556999,835498
11592,196,$UNIP5,2012-12-31,278499,556999,835498
11592,196,$UNIP5,2013-03-31,278499,556999,835498
11592,196,$UNIP5,2013-06-30,278499,556999,835498
11592,196,$UNIP5,2013-09-30,278501,557001,835502
11592,196,$UNIP5,2013-12-31,278501,557001,835502
11592,196,$UNIP5,2014-03-31,278501,557001,835502
11592,196,$UNIP5,2014-06-30,278501,557001,835502
11592,196,$UNIP5,2014-09-30,278501,557001,835502
11592,196,$UNIP5,2014-12-31,27850,55700,83550
11592,196,$UNIP5,2015-03-31,27850,55700,83550
11592,196,$UNIP5,2015-06-30,27850,55700,83550
11592,196,$UNIP5,2015-09-30,27850,55700,83550
11592,196,$UNIP5,2015-12-31,27850,55700,83550
11592,196,$UNIP5,2016-03-31,27850,55700,83550
11592,196,$UNIP5,2016-06-30,27850,55700,83550
11592,196,$UNIP5,2016-09-30,27850,55700,83550
11592,196,$UNIP5,2016-12-31,27850,55700,83550
11592,196,$UNIP5,2017-03-31,27850,55700,83550
11592,196,$UNIP5,2017-06-30,27850,55700,83550
11592,196,$UNIP5,2017-09-30,27850,55700,83550
11592,196,$UNIP5,2017-12-31,27850,55700,83550
11592,196,$UNIP5,2018-03-31,27850,55700,83550
11592,196,$UNIP5,2018-06-30,27850,55700,83550
11592,196,$UNIP5,2018-09-30,27850,55700,83550
11592,196,$UNIP5,2018-12-31,30382,60764,91146
11592,196,$UNIP5,2019-03-31,30216,56938,87154
11592,196,$UNIP5,2019-06-30,35252,66428,101680
11592,196,$UNIP5,2019-09-30,35252,66428,101680
11592,196,$UNIP5,2019-12-31,35252,66428,101680
11592,196,$UNIP5,2020-03-31,34462,63356,97818
11592,196,$UNIP5,2020-06-30,34462,63356,97818
11592,196,$UNIP5,2020-09-30,33703,61914,95617
11762,202,$.,2010-12-31,70000000,0,70000000
11762,202,$.,2011-03-31,280000,0,280000
11762,202,$.,2011-06-30,280000,0,280000
11762,202,$.,2011-09-30,280000,0,280000
11762,202,$.,2011-12-31,280000000,0,280000000
11762,202,$.,2012-03-31,280000,0,280000
11762,202,$.,2012-06-30,280000,0,280000
11762,202,$.,2012-09-30,280000,0,280000
11762,202,$.,2012-12-31,280000,0,280000
11762,202,$.,2013-03-31,280000,0,280000
11762,202,$.,2013-06-30,280000,0,280000
11762,202,$.,2013-09-30,332285,0,332285
11762,202,$.,2013-12-31,740921,0,740921
11762,202,$.,2014-03-31,740921,0,740921
11762,202,$.,2014-06-30,740921,0,740921
11762,202,$.,2014-09-30,740921,0,740921
11762,202,$.,2014-12-31,740921,0,740921
11762,202,$.,2015-03-31,740921,0,740921
11762,202,$.,2015-06-30,740921,0,740921
11762,202,$.,2015-09-30,740921,0,740921
11762,202,$.,2015-12-31,740921,0,740921
11762,202,$.,2016-03-31,185230,0,185230
11762,202,$.,2016-06-30,185230,0,185230
11762,202,$.,2016-09-30,185230,0,185230
11762,202,$.,2016-12-31,185230,0,185230
11762,202,$.,2017-03-31,185230,0,185230
11762,202,$.,2017-06-30,185230,0,185230
11762,202,$.,2017-09-30,185230,0,185230
11762,202,$.,2017-12-31,245756,0,245756
11762,202,$.,2018-03-31,245756,0,245756
11762,202,$.,2018-06-30,245756,0,245756
11762,202,$.,2018-09-30,245756,0,245756
11762,202,$.,2018-12-31,245756,0,245756
11762,202,$.,2019-03-31,245756,0,245756
11762,202,$.,2019-06-30,245756,0,245756
11762,202,$.,2019-09-30,245756,0,245756
11762,202,$.,2019-12-31,245756,0,245756
11762,202,$.,2020-03-31,245756,0,245756
11762,202,$.,2020-06-30,245756,0,245756
11762,202,$.,2020-09-30,245756,0,245756
11762,204,$VULC3,2010-12-31,70000000,0,70000000
11762,204,$VULC3,2011-03-31,280000,0,280000
11762,204,$VULC3,2011-06-30,280000,0,280000
11762,204,$VULC3,2011-09-30,280000,0,280000
11762,204,$VULC3,2011-12-31,280000000,0,280000000
11762,204,$VULC3,2012-03-31,280000,0,280000
11762,204,$VULC3,2012-06-30,280000,0,280000
11762,204,$VULC3,2012-09-30,280000,0,280000
11762,204,$VULC3,2012-12-31,280000,0,280000
11762,204,$VULC3,2013-03-31,280000,0,280000
11762,204,$VULC3,2013-06-30,280000,0,280000
11762,204,$VULC3,2013-09-30,332285,0,332285
11762,204,$VULC3,2013-12-31,740921,0,740921
11762,204,$VULC3,2014-03-31,740921,0,740921
11762,204,$VULC3,2014-06-30,740921,0,740921
11762,204,$VULC3,2014-09-30,740921,0,740921
11762,204,$VULC3,2014-12-31,740921,0,740921
11762,204,$VULC3,2015-03-31,740921,0,740921
11762,204,$VULC3,2015-06-30,740921,0,740921
11762,204,$VULC3,2015-09-30,740921,0,740921
11762,204,$VULC3,2015-12-31,740921,0,740921
11762,204,$VULC3,2016-03-31,185230,0,185230
11762,204,$VULC3,2016-06-30,185230,0,185230
11762,204,$VULC3,2016-09-30,185230,0,185230
11762,204,$VULC3,2016-12-31,185230,0,185230
11762,204,$VULC3,2017-03-31,185230,0,185230
11762,204,$VULC3,2017-06-30,185230,0,185230
11762,204,$VULC3,2017-09-30,185230,0,185230
11762,204,$VULC3,2017-12-31,245756,0,245756
11762,204,$VULC3,2018-03-31,245756,0,245756
11762,204,$VULC3,2018-06-30,245756,0,245756
11762,204,$VULC3,2018-09-30,245756,0,245756
11762,204,$VULC3,2018-12-31,245756,0,245756
11762,204,$VULC3,2019-03-31,245756,0,245756
11762,204,$VULC3,2019-06-30,245756,0,245756
11762,204,$VULC3,2019-09-30,245756,0,245756
11762,204,$VULC3,2019-12-31,245756,0,245756
11762,204,$VULC3,2020-03-31,245756,0,245756
11762,204,$VULC3,2020-06-30,245756,0,245756
11762,204,$VULC3,2020-09-30,245756,0,245756
11932,205,$MYPK3,2010-12-31,94863,0,94863
11932,205,$MYPK3,2011-03-31,94863,0,94863
11932,205,$MYPK3,2011-06-30,94863,0,94863
11932,205,$MYPK3,2011-09-30,94863,0,94863
11932,205,$MYPK3,2011-12-31,94863,0,94863
11932,205,$MYPK3,2012-03-31,94863,0,94863
11932,205,$MYPK3,2012-06-30,94863,0,94863
11932,205,$MYPK3,2012-09-30,94863,0,94863
11932,205,$MYPK3,2012-12-31,94863,0,94863
11932,205,$MYPK3,2013-03-31,94863,0,94863
11932,205,$MYPK3,2013-06-30,94863,0,94863
11932,205,$MYPK3,2013-09-30,94863,0,94863
11932,205,$MYPK3,2013-12-31,94863,0,94863
11932,205,$MYPK3,2014-03-31,94863,0,94863
11932,205,$MYPK3,2014-06-30,94863,0,94863
11932,205,$MYPK3,2014-09-30,94863,0,94863
11932,205,$MYPK3,2014-12-31,94863,0,94863
11932,205,$MYPK3,2015-03-31,94863,0,94863
11932,205,$MYPK3,2015-06-30,94863,0,94863
11932,205,$MYPK3,2015-09-30,94863,0,94863
11932,205,$MYPK3,2015-12-31,94863,0,94863
11932,205,$MYPK3,2016-03-31,94863,0,94863
11932,205,$MYPK3,2016-06-30,94863,0,94863
11932,205,$MYPK3,2016-09-30,94863,0,94863
11932,205,$MYPK3,2016-12-31,94863,0,94863
11932,205,$MYPK3,2017-03-31,138511,0,138511
11932,205,$MYPK3,2017-06-30,138519,0,138519
11932,205,$MYPK3,2017-09-30,139167,0,139167
11932,205,$MYPK3,2017-12-31,140328,0,140328
11932,205,$MYPK3,2018-03-31,150575,0,150575
11932,205,$MYPK3,2018-06-30,150575,0,150575
11932,205,$MYPK3,2018-09-30,150575,0,150575
11932,205,$MYPK3,2018-12-31,150575,0,150575
11932,205,$MYPK3,2019-03-31,150575,0,150575
11932,205,$MYPK3,2019-06-30,153720,0,153720
11932,205,$MYPK3,2019-09-30,153720,0,153720
11932,205,$MYPK3,2019-12-31,153720,0,153720
11932,205,$MYPK3,2020-03-31,153720,0,153720
11932,205,$MYPK3,2020-06-30,153720,0,153720
11932,205,$MYPK3,2020-09-30,153720,0,153720
11975,201,$AZEV4,2010-12-31,9000,18000,27000
11975,201,$AZEV4,2011-03-31,9000,18000,27000
11975,201,$AZEV4,2011-06-30,9000000,18000000,27000000
11975,201,$AZEV4,2011-09-30,9000000,18000000,27000000
11975,201,$AZEV4,2011-12-31,9000000,18000000,27000000
11975,201,$AZEV4,2012-03-31,9000000,18000000,27000000
11975,201,$AZEV4,2012-06-30,9000000,18000000,27000000
11975,201,$AZEV4,2012-09-30,9000000,18000000,27000000
11975,201,$AZEV4,2012-12-31,9000000,18000000,27000000
11975,201,$AZEV4,2013-03-31,9000000,18000000,27000000
11975,201,$AZEV4,2013-06-30,9000000,18000000,27000000
11975,201,$AZEV4,2013-09-30,9000000,18000000,27000000
11975,201,$AZEV4,2013-12-31,9000000,18000000,27000000
11975,201,$AZEV4,2014-03-31,9000000,18000000,27000000
11975,201,$AZEV4,2014-06-30,9000000,18000000,27000000
11975,201,$AZEV4,2014-09-30,9000000,18000000,27000000
11975,201,$AZEV4,2014-12-31,9000000,18000000,27000000
11975,201,$AZEV4,2015-03-31,9000000,18000000,27000000
11975,201,$AZEV4,2015-06-30,9000000,18000000,27000000
11975,201,$AZEV4,2015-09-30,9000000,18000000,27000000
11975,201,$AZEV4,2015-12-31,9000000,18000000,27000000
11975,201,$AZEV4,2016-03-31,9000000,18000000,27000000
11975,201,$AZEV4,2016-06-30,9000000,18000000,27000000
11975,201,$AZEV4,2016-09-30,9000000,18000000,27000000
11975,201,$AZEV4,2016-12-31,9000000,18000000,27000000
11975,201,$AZEV4,2017-03-31,9000000,18000000,27000000
11975,201,$AZEV4,2017-06-30,9000000,18000000,27000000
11975,201,$AZEV4,2017-09-30,9000000,18000000,27000000
11975,201,$AZEV4,2017-12-31,9000000,18000000,27000000
11975,201,$AZEV4,2018-03-31,9000000,18000000,27000000
11975,201,$AZEV4,2018-06-30,9000000,18000000,27000000
11975,201,$AZEV4,2018-09-30,9000000,18000000,27000000
11975,201,$AZEV4,2018-12-31,9000000,18000000,27000000
11975,201,$AZEV4,2019-03-31,9000000,18000000,27000000
11975,201,$AZEV4,2019-06-30,1800000,3600000,5400000
11975,201,$AZEV4,2019-09-30,1800000,3600000,5400000
11975,201,$AZEV4,2019-12-31,1800000,3600000,5400000
11975,201,$AZEV4,2020-03-31,1800000,3600000,5400000
11975,201,$AZEV4,2020-06-30,1800000,3600000,5400000
11975,201,$AZEV4,2020-09-30,1800000,3600000,5400000
11975,211,$AZEV3,2010-12-31,9000,18000,27000
11975,211,$AZEV3,2011-03-31,9000,18000,27000
11975,211,$AZEV3,2011-06-30,9000000,18000000,27000000
11975,211,$AZEV3,2011-09-30,9000000,18000000,27000000
11975,211,$AZEV3,2011-12-31,9000000,18000000,27000000
11975,211,$AZEV3,2012-03-31,9000000,18000000,27000000
11975,211,$AZEV3,2012-06-30,9000000,18000000,27000000
11975,211,$AZEV3,2012-09-30,9000000,18000000,27000000
11975,211,$AZEV3,2012-12-31,9000000,18000000,27000000
11975,211,$AZEV3,2013-03-31,9000000,18000000,27000000
11975,211,$AZEV3,2013-06-30,9000000,18000000,27000000
11975,211,$AZEV3,2013-09-30,9000000,18000000,27000000
11975,211,$AZEV3,2013-12-31,9000000,18000000,27000000
11975,211,$AZEV3,2014-03-31,9000000,18000000,27000000
11975,211,$AZEV3,2014-06-30,9000000,18000000,27000000
11975,211,$AZEV3,2014-09-30,9000000,18000000,27000000
11975,211,$AZEV3,2014-12-31,9000000,18000000,27000000
11975,211,$AZEV3,2015-03-31,9000000,18000000,27000000
11975,211,$AZEV3,2015-06-30,9000000,18000000,27000000
11975,211,$AZEV3,2015-09-30,9000000,18000000,27000000
11975,211,$AZEV3,2015-12-31,9000000,18000000,27000000
11975,211,$AZEV3,2016-03-31,9000000,18000000,27000000
11975,211,$AZEV3,2016-06-30,9000000,18000000,27000000
11975,211,$AZEV3,2016-09-30,9000000,18000000,27000000
11975,211,$AZEV3,2016-12-31,9000000,18000000,27000000
11975,211,$AZEV3,2017-03-31,9000000,18000000,27000000
11975,211,$AZEV3,2017-06-30,9000000,18000000,27000000
11975,211,$AZEV3,2017-09-30,9000000,18000000,27000000
11975,211,$AZEV3,2017-12-31,9000000,18000000,27000000
11975,211,$AZEV3,2018-03-31,9000000,18000000,27000000
11975,211,$AZEV3,2018-06-30,9000000,18000000,27000000
11975,211,$AZEV3,2018-09-30,9000000,18000000,27000000
11975,211,$AZEV3,2018-12-31,9000000,18000000,27000000
11975,211,$AZEV3,2019-03-31,9000000,18000000,27000000
11975,211,$AZEV3,2019-06-30,1800000,3600000,5400000
11975,211,$AZEV3,2019-09-30,1800000,3600000,5400000
11975,211,$AZEV3,2019-12-31,1800000,3600000,5400000
11975,211,$AZEV3,2020-03-31,1800000,3600000,5400000
11975,211,$AZEV3,2020-06-30,1800000,3600000,5400000
11975,211,$AZEV3,2020-09-30,1800000,3600000,5400000
11991,199,$MWET3,2010-12-31,1715,3430,5145
11991,199,$MWET3,2011-03-31,1715,3430,5145
11991,199,$MWET3,2011-06-30,6860,13720,20580
11991,199,$MWET3,2011-09-30,6860,13720,20580
11991,199,$MWET3,2011-12-31,6860,13720,20580
11991,199,$MWET3,2012-03-31,6860,13720,20580
11991,199,$MWET3,2012-06-30,6860,13720,20580
11991,199,$MWET3,2012-09-30,6860,13720,20580
11991,199,$MWET3,2012-12-31,6860,13720,20580
11991,199,$MWET3,2013-03-31,6860,13720,20580
11991,199,$MWET3,2013-06-30,6860,13720,20580
11991,199,$MWET3,2013-09-30,6860,13720,20580
11991,199,$MWET3,2013-12-31,6860,13720,20580
11991,199,$MWET3,2014-03-31,6860,13720,20580
11991,199,$MWET3,2014-06-30,6860,13720,20580
11991,199,$MWET3,2014-09-30,6860,13720,20580
11991,199,$MWET3,2014-12-31,6860,13720,20580
11991,199,$MWET3,2015-03-31,6860,13720,20580
11991,199,$MWET3,2015-06-30,6860,13720,20580
11991,199,$MWET3,2015-09-30,686,1372,2058
11991,199,$MWET3,2015-12-31,686,1372,2058
11991,199,$MWET3,2016-03-31,686,1372,2058
11991,199,$MWET3,2016-06-30,686,1372,2058
11991,199,$MWET3,2016-09-30,686,1372,2058
11991,199,$MWET3,2016-12-31,686,1372,2058
11991,199,$MWET3,2017-03-31,686,1372,2058
11991,199,$MWET3,2017-06-30,686,1372,2058
11991,199,$MWET3,2017-09-30,686,1372,2058
11991,199,$MWET3,2017-12-31,686,1372,2058
11991,199,$MWET3,2018-03-31,686,1372,2058
11991,199,$MWET3,2018-06-30,686,1372,2058
11991,199,$MWET3,2018-09-30,686,1372,2058
11991,199,$MWET3,2018-12-31,686,1372,2058
11991,199,$MWET3,2019-03-31,686,1372,2058
11991,199,$MWET3,2019-06-30,686,1372,2058
11991,199,$MWET3,2019-09-30,686,1372,2058
11991,199,$MWET3,2019-12-31,686,1372,2058
11991,199,$MWET3,2020-03-31,686,1372,2058
11991,199,$MWET3,2020-06-30,686,1372,2058
11991,199,$MWET3,2020-09-30,686,1372,2058
11991,200,$MWET4,2010-12-31,1715,3430,5145
11991,200,$MWET4,2011-03-31,1715,3430,5145
11991,200,$MWET4,2011-06-30,6860,13720,20580
11991,200,$MWET4,2011-09-30,6860,13720,20580
11991,200,$MWET4,2011-12-31,6860,13720,20580
11991,200,$MWET4,2012-03-31,6860,13720,20580
11991,200,$MWET4,2012-06-30,6860,13720,20580
11991,200,$MWET4,2012-09-30,6860,13720,20580
11991,200,$MWET4,2012-12-31,6860,13720,20580
11991,200,$MWET4,2013-03-31,6860,13720,20580
11991,200,$MWET4,2013-06-30,6860,13720,20580
11991,200,$MWET4,2013-09-30,6860,13720,20580
11991,200,$MWET4,2013-12-31,6860,13720,20580
11991,200,$MWET4,2014-03-31,6860,13720,20580
11991,200,$MWET4,2014-06-30,6860,13720,20580
11991,200,$MWET4,2014-09-30,6860,13720,20580
11991,200,$MWET4,2014-12-31,6860,13720,20580
11991,200,$MWET4,2015-03-31,6860,13720,20580
11991,200,$MWET4,2015-06-30,6860,13720,20580
11991,200,$MWET4,2015-09-30,686,1372,2058
11991,200,$MWET4,2015-12-31,686,1372,2058
11991,200,$MWET4,2016-03-31,686,1372,2058
11991,200,$MWET4,2016-06-30,686,1372,2058
11991,200,$MWET4,2016-09-30,686,1372,2058
11991,200,$MWET4,2016-12-31,686,1372,2058
11991,200,$MWET4,2017-03-31,686,1372,2058
11991,200,$MWET4,2017-06-30,686,1372,2058
11991,200,$MWET4,2017-09-30,686,1372,2058
11991,200,$MWET4,2017-12-31,686,1372,2058
11991,200,$MWET4,2018-03-31,686,1372,2058
11991,200,$MWET4,2018-06-30,686,1372,2058
11991,200,$MWET4,2018-09-30,686,1372,2058
11991,200,$MWET4,2018-12-31,686,1372,2058
11991,200,$MWET4,2019-03-31,686,1372,2058
11991,200,$MWET4,2019-06-30,686,1372,2058
11991,200,$MWET4,2019-09-30,686,1372,2058
11991,200,$MWET4,2019-12-31,686,1372,2058
11991,200,$MWET4,2020-03-31,686,1372,2058
11991,200,$MWET4,2020-06-30,686,1372,2058
11991,200,$MWET4,2020-09-30,686,1372,2058
12190,214,$BOBR3,2010-12-31,20000,34065,54065
12190,214,$BOBR3,2011-03-31,20000,34065,54065
12190,214,$BOBR3,2011-06-30,20000,34065,54065
12190,214,$BOBR3,2011-09-30,20000,34065,54065
12190,214,$BOBR3,2011-12-31,20000,34065,54065
12190,214,$BOBR3,2012-03-31,20000,34065,54065
12190,214,$BOBR3,2012-06-30,20000,34065,54065
12190,214,$BOBR3,2012-09-30,20000,34065,54065
12190,214,$BOBR3,2012-12-31,20000,34065,54065
12190,214,$BOBR3,2013-03-31,20000,34065,54065
12190,214,$BOBR3,2013-06-30,20000,34065,54065
12190,214,$BOBR3,2013-09-30,20000,34065,54065
12190,214,$BOBR3,2013-12-31,20000,34065,54065
12190,214,$BOBR3,2014-03-31,20000,34065,54065
12190,214,$BOBR3,2014-06-30,20000,34065,54065
12190,214,$BOBR3,2014-09-30,20000,34065,54065
12190,214,$BOBR3,2014-12-31,20000,34065,54065
12190,214,$BOBR3,2015-03-31,20000,34065,54065
12190,214,$BOBR3,2015-06-30,20000,34065,54065
12190,214,$BOBR3,2015-09-30,20000,34065,54065
12190,214,$BOBR3,2015-12-31,20000,34065,54065
12190,214,$BOBR3,2016-03-31,20000,34065,54065
12190,214,$BOBR3,2016-06-30,20000,34065,54065
12190,214,$BOBR3,2016-09-30,20000,34065,54065
12190,214,$BOBR3,2016-12-31,20000,34065,54065
12190,214,$BOBR3,2017-03-31,20000,34065,54065
12190,214,$BOBR3,2017-06-30,20000,34065,54065
12190,214,$BOBR3,2017-09-30,20000,34065,54065
12190,214,$BOBR3,2017-12-31,20000,34065,54065
12190,214,$BOBR3,2018-03-31,20000,34065,54065
12190,214,$BOBR3,2018-06-30,20000,34065,54065
12190,214,$BOBR3,2018-09-30,20000,34065,54065
12190,214,$BOBR3,2018-12-31,20000,34065,54065
12190,214,$BOBR3,2019-03-31,20000,34065,54065
12190,214,$BOBR3,2019-06-30,20000,34065,54065
12190,214,$BOBR3,2019-09-30,137615,122895,260510
12190,214,$BOBR3,2019-12-31,137615,122894,260509
12190,214,$BOBR3,2020-03-31,137615,122894,260509
12190,214,$BOBR3,2020-06-30,137615,122894,260509
12190,214,$BOBR3,2020-09-30,137615,122894,260509
12190,215,$BOBR4,2010-12-31,20000,34065,54065
12190,215,$BOBR4,2011-03-31,20000,34065,54065
12190,215,$BOBR4,2011-06-30,20000,34065,54065
12190,215,$BOBR4,2011-09-30,20000,34065,54065
12190,215,$BOBR4,2011-12-31,20000,34065,54065
12190,215,$BOBR4,2012-03-31,20000,34065,54065
12190,215,$BOBR4,2012-06-30,20000,34065,54065
12190,215,$BOBR4,2012-09-30,20000,34065,54065
12190,215,$BOBR4,2012-12-31,20000,34065,54065
12190,215,$BOBR4,2013-03-31,20000,34065,54065
12190,215,$BOBR4,2013-06-30,20000,34065,54065
12190,215,$BOBR4,2013-09-30,20000,34065,54065
12190,215,$BOBR4,2013-12-31,20000,34065,54065
12190,215,$BOBR4,2014-03-31,20000,34065,54065
12190,215,$BOBR4,2014-06-30,20000,34065,54065
12190,215,$BOBR4,2014-09-30,20000,34065,54065
12190,215,$BOBR4,2014-12-31,20000,34065,54065
12190,215,$BOBR4,2015-03-31,20000,34065,54065
12190,215,$BOBR4,2015-06-30,20000,34065,54065
12190,215,$BOBR4,2015-09-30,20000,34065,54065
12190,215,$BOBR4,2015-12-31,20000,34065,54065
12190,215,$BOBR4,2016-03-31,20000,34065,54065
12190,215,$BOBR4,2016-06-30,20000,34065,54065
12190,215,$BOBR4,2016-09-30,20000,34065,54065
12190,215,$BOBR4,2016-12-31,20000,34065,54065
12190,215,$BOBR4,2017-03-31,20000,34065,54065
12190,215,$BOBR4,2017-06-30,20000,34065,54065
12190,215,$BOBR4,2017-09-30,20000,34065,54065
12190,215,$BOBR4,2017-12-31,20000,34065,54065
12190,215,$BOBR4,2018-03-31,20000,34065,54065
12190,215,$BOBR4,2018-06-30,20000,34065,54065
12190,215,$BOBR4,2018-09-30,20000,34065,54065
12190,215,$BOBR4,2018-12-31,20000,34065,54065
12190,215,$BOBR4,2019-03-31,20000,34065,54065
12190,215,$BOBR4,2019-06-30,20000,34065,54065
12190,215,$BOBR4,2019-09-30,137615,122895,260510
12190,215,$BOBR4,2019-12-31,137615,122894,260509
12190,215,$BOBR4,2020-03-31,137615,122894,260509
12190,215,$BOBR4,2020-06-30,137615,122894,260509
12190,215,$BOBR4,2020-09-30,137615,122894,260509
12319,203,$JBDU3,2010-12-31,193573,387132,580705
12319,203,$JBDU3,2011-03-31,193573,387132,580705
12319,203,$JBDU3,2011-06-30,193573,387132,580705
12319,203,$JBDU3,2011-09-30,193573,387132,580705
12319,203,$JBDU3,2011-12-31,309716,619412,929128
12319,203,$JBDU3,2012-03-31,309716,619412,929128
12319,203,$JBDU3,2012-06-30,309716,619412,929128
12319,203,$JBDU3,2012-09-30,309716,619412,929128
12319,203,$JBDU3,2012-12-31,464575,929117,1393692
12319,203,$JBDU3,2013-03-31,464575,929117,1393692
12319,203,$JBDU3,2013-06-30,4646,9291,13937
12319,203,$JBDU3,2013-09-30,9291,18582,27873
12319,203,$JBDU3,2013-12-31,9291,18582,27873
12319,203,$JBDU3,2014-03-31,9292,18582,27874
12319,203,$JBDU3,2014-06-30,9292,18582,27874
12319,203,$JBDU3,2014-09-30,18583,37165,55748
12319,203,$JBDU3,2014-12-31,186,371,557
12319,203,$JBDU3,2015-03-31,186,371,557
12319,203,$JBDU3,2015-06-30,186,371,557
12319,203,$JBDU3,2015-09-30,186,371,557
12319,203,$JBDU3,2015-12-31,186,371,557
12319,203,$JBDU3,2016-03-31,185830,371647,557477
12319,203,$JBDU3,2016-06-30,185830,371647,557477
12319,203,$JBDU3,2016-09-30,371660,743294,1114954
12319,203,$JBDU3,2016-12-31,371660,743294,1114954
12319,203,$JBDU3,2017-03-31,371660,743294,1114954
12319,203,$JBDU3,2017-06-30,371660,743294,1114954
12319,203,$JBDU3,2017-09-30,371660,743294,1114954
12319,203,$JBDU3,2017-12-31,1356559,2713023,4069582
12319,203,$JBDU3,2018-03-31,1356559,2713023,4069582
12319,203,$JBDU3,2018-06-30,1356559,2713023,4069582
12319,203,$JBDU3,2018-09-30,45218,90435,135653
12319,203,$JBDU3,2018-12-31,45218,90435,135653
12319,203,$JBDU3,2019-03-31,1673066,3346095,5019161
12319,203,$JBDU3,2019-06-30,1673066,3346095,5019161
12319,203,$JBDU3,2019-09-30,1673066,3346095,5019161
12319,203,$JBDU3,2019-12-31,1673066,3346095,5019161
12319,203,$JBDU3,2020-03-31,1673066,3346095,5019161
12319,203,$JBDU3,2020-06-30,1673066,3346095,5019161
12572,212,$RCSL3,2010-12-31,18430,32849,51279
12572,212,$RCSL3,2011-03-31,22970,40941,63911
12572,212,$RCSL3,2011-06-30,22970,40941,63911
12572,212,$RCSL3,2011-09-30,22970,40941,63911
12572,212,$RCSL3,2011-12-31,22970,40941,63911
12572,212,$RCSL3,2012-03-31,22970,40941,63911
12572,212,$RCSL3,2012-06-30,35128,69701,104829
12572,212,$RCSL3,2012-09-30,35128,69701,104829
12572,212,$RCSL3,2012-12-31,78179,155124,233303
12572,212,$RCSL3,2013-03-31,78179,155124,233303
12572,212,$RCSL3,2013-06-30,78179,155124,233303
12572,212,$RCSL3,2013-09-30,78179,155124,233303
12572,212,$RCSL3,2013-12-31,78179,155124,233303
12572,212,$RCSL3,2014-03-31,78179,155124,233303
12572,212,$RCSL3,2014-06-30,78179,155124,233303
12572,212,$RCSL3,2014-09-30,78179,155124,233303
12572,212,$RCSL3,2014-12-31,78179,155124,233303
12572,212,$RCSL3,2015-03-31,78179,155124,233303
12572,212,$RCSL3,2015-06-30,78179,155124,233303
12572,212,$RCSL3,2015-09-30,1042,2068,3110
12572,212,$RCSL3,2015-12-31,1042,2068,3110
12572,212,$RCSL3,2016-03-31,1042,2068,3110
12572,212,$RCSL3,2016-06-30,1042,2068,3110
12572,212,$RCSL3,2016-09-30,12771,25338,38109
12572,212,$RCSL3,2016-12-31,12771,25338,38109
12572,212,$RCSL3,2017-03-31,12771,25338,38109
12572,212,$RCSL3,2017-06-30,12771,25338,38109
12572,212,$RCSL3,2017-09-30,12771,25338,38109
12572,212,$RCSL3,2017-12-31,1703,3378,5081
12572,212,$RCSL3,2018-03-31,1703,3378,5081
12572,212,$RCSL3,2018-06-30,1703,3378,5081
12572,212,$RCSL3,2018-09-30,1703,3378,5081
12572,212,$RCSL3,2018-12-31,1703,3378,5081
12572,212,$RCSL3,2019-03-31,1703,3378,5081
12572,212,$RCSL3,2019-06-30,25409,50414,75823
12572,212,$RCSL3,2019-09-30,25409,50414,75823
12572,212,$RCSL3,2019-12-31,25409,50414,75823
12572,212,$RCSL3,2020-03-31,25409,50414,75823
12572,212,$RCSL3,2020-06-30,25409,50414,75823
12572,212,$RCSL3,2020-09-30,25409,50414,75823
12572,213,$RCSL4,2010-12-31,18430,32849,51279
12572,213,$RCSL4,2011-03-31,22970,40941,63911
12572,213,$RCSL4,2011-06-30,22970,40941,63911
12572,213,$RCSL4,2011-09-30,22970,40941,63911
12572,213,$RCSL4,2011-12-31,22970,40941,63911
12572,213,$RCSL4,2012-03-31,22970,40941,63911
12572,213,$RCSL4,2012-06-30,35128,69701,104829
12572,213,$RCSL4,2012-09-30,35128,69701,104829
12572,213,$RCSL4,2012-12-31,78179,155124,233303
12572,213,$RCSL4,2013-03-31,78179,155124,233303
12572,213,$RCSL4,2013-06-30,78179,155124,233303
12572,213,$RCSL4,2013-09-30,78179,155124,233303
12572,213,$RCSL4,2013-12-31,78179,155124,233303
12572,213,$RCSL4,2014-03-31,78179,155124,233303
12572,213,$RCSL4,2014-06-30,78179,155124,233303
12572,213,$RCSL4,2014-09-30,78179,155124,233303
12572,213,$RCSL4,2014-12-31,78179,155124,233303
12572,213,$RCSL4,2015-03-31,78179,155124,233303
12572,213,$RCSL4,2015-06-30,78179,155124,233303
12572,213,$RCSL4,2015-09-30,1042,2068,3110
12572,213,$RCSL4,2015-12-31,1042,2068,3110
12572,213,$RCSL4,2016-03-31,1042,2068,3110
12572,213,$RCSL4,2016-06-30,1042,2068,3110
12572,213,$RCSL4,2016-09-30,12771,25338,38109
12572,213,$RCSL4,2016-12-31,12771,25338,38109
12572,213,$RCSL4,2017-03-31,12771,25338,38109
12572,213,$RCSL4,2017-06-30,12771,25338,38109
12572,213,$RCSL4,2017-09-30,12771,25338,38109
12572,213,$RCSL4,2017-12-31,1703,3378,5081
12572,213,$RCSL4,2018-03-31,1703,3378,5081
12572,213,$RCSL4,2018-06-30,1703,3378,5081
12572,213,$RCSL4,2018-09-30,1703,3378,5081
12572,213,$RCSL4,2018-12-31,1703,3378,5081
12572,213,$RCSL4,2019-03-31,1703,3378,5081
12572,213,$RCSL4,2019-06-30,25409,50414,75823
12572,213,$RCSL4,2019-09-30,25409,50414,75823
12572,213,$RCSL4,2019-12-31,25409,50414,75823
12572,213,$RCSL4,2020-03-31,25409,50414,75823
12572,213,$RCSL4,2020-06-30,25409,50414,75823
12572,213,$RCSL4,2020-09-30,25409,50414,75823
12653,605,$KLBN11,2010-12-31,316827563,600855733,917683296
12653,605,$KLBN11,2011-03-31,316827563,600855733,917683296
12653,605,$KLBN11,2011-03-31,316827563,600855733,917683296
12653,605,$KLBN11,2011-06-30,316827563,600855733,917683296
12653,605,$KLBN11,2011-09-30,316827563,600855733,917683296
12653,605,$KLBN11,2011-09-30,316827563,600855733,917683296
12653,605,$KLBN11,2011-12-31,316827563,600855733,917683296
12653,605,$KLBN11,2012-03-31,316827563,600855733,917683296
12653,605,$KLBN11,2012-06-30,316827563,600855733,917683296
12653,605,$KLBN11,2012-09-30,316827563,600855733,917683296
12653,605,$KLBN11,2012-12-31,316827563,600855733,917683296
12653,605,$KLBN11,2013-03-31,316827563,600855733,917683296
12653,605,$KLBN11,2013-06-30,316827563,600855733,917683296
12653,605,$KLBN11,2013-09-30,316827563,600855733,917683296
12653,605,$KLBN11,2013-12-31,316827563,600855733,917683296
12653,605,$KLBN11,2014-03-31,1684897850,3044891685,4729789535
12653,605,$KLBN11,2014-06-30,1768769959,2961019576,4729789535
12653,605,$KLBN11,2014-09-30,1768769964,2961019601,4729789565
12653,605,$KLBN11,2014-12-31,1848592200,2881197365,4729789565
12653,605,$KLBN11,2015-03-31,1848592200,2881197365,4729789565
12653,605,$KLBN11,2015-06-30,1848592200,2881197365,4729789565
12653,605,$KLBN11,2015-06-30,1848592200,2881197365,4729789565
12653,605,$KLBN11,2015-09-30,1848740115,2881789025,4730529140
12653,605,$KLBN11,2015-12-31,1849160105,2883468985,4732629090
12653,605,$KLBN11,2016-03-31,1849269750,2883907565,4733177315
12653,605,$KLBN11,2016-03-31,1849269750,2883907565,4733177315
12653,605,$KLBN11,2016-06-30,1849270515,2883910625,4733181140
12653,605,$KLBN11,2016-09-30,1849270515,2883910625,4733181140
12653,605,$KLBN11,2016-09-30,1849270515,2883910625,4733181140
12653,605,$KLBN11,2016-12-31,1849270515,2883910625,4733181140
12653,605,$KLBN11,2017-03-31,1849270515,2883910625,4733181140
12653,605,$KLBN11,2017-03-31,1849270515,2883910625,4733181140
12653,605,$KLBN11,2017-06-30,1849270515,2883910625,4733181140
12653,605,$KLBN11,2017-06-30,1849270515,2883910625,4733181140
12653,605,$KLBN11,2017-09-30,1849270515,2883910625,4733181140
12653,605,$KLBN11,2017-09-30,1849270515,2883910625,4733181140
12653,605,$KLBN11,2017-12-31,1859852065,2926236825,4786088890
12653,605,$KLBN11,2017-12-31,1859852065,2926236825,4786088890
12653,605,$KLBN11,2018-03-31,1984594655,3425207181,5409801836
12653,605,$KLBN11,2018-06-30,1984594655,3425207181,5409801836
12653,605,$KLBN11,2018-09-30,1984594655,3425207185,5409801840
12653,605,$KLBN11,2018-12-31,1984594655,3425207185,5409801840
12653,605,$KLBN11,2019-03-31,1984594655,3425207185,5409801840
12653,605,$KLBN11,2019-03-31,1984594655,3425207185,5409801840
12653,605,$KLBN11,2019-06-30,1984594655,3425207185,5409801840
12653,605,$KLBN11,2019-09-30,1984594655,3425207185,5409801840
12653,605,$KLBN11,2019-12-31,1984594655,3425207185,5409801840
12653,605,$KLBN11,2020-03-31,1984594655,3425207185,5409801840
12653,605,$KLBN11,2020-06-30,2012333899,3536164161,5548498060
12653,605,$KLBN11,2020-09-30,2012333899,3536164161,5548498060
12653,605,$KLBN11,2020-09-30,2012333899,3536164161,5548498060
12696,206,$SNSY5,2010-12-31,6645,12646,19291
12696,206,$SNSY5,2011-03-31,6645,12646,19291
12696,206,$SNSY5,2011-06-30,6645,12646,19291
12696,206,$SNSY5,2011-09-30,6645,12646,19291
12696,206,$SNSY5,2011-12-31,6645,12646,19291
12696,206,$SNSY5,2012-03-31,6645,12646,19291
12696,206,$SNSY5,2012-06-30,6645,12646,19291
12696,206,$SNSY5,2012-09-30,6645,12646,19291
12696,206,$SNSY5,2012-12-31,6645,12646,19291
12696,206,$SNSY5,2013-03-31,6645,12646,19291
12696,206,$SNSY5,2013-06-30,6645,12646,19291
12696,206,$SNSY5,2013-09-30,6645,12646,19291
12696,206,$SNSY5,2013-12-31,6645,12646,19291
12696,206,$SNSY5,2014-03-31,6645,12646,19291
12696,206,$SNSY5,2014-06-30,6645,12646,19291
12696,206,$SNSY5,2014-09-30,6645,12646,19291
12696,206,$SNSY5,2014-12-31,6645,12646,19291
12696,206,$SNSY5,2015-03-31,6645,12646,19291
12696,206,$SNSY5,2015-06-30,6645,12646,19291
12696,206,$SNSY5,2015-09-30,6645,12646,19291
12696,206,$SNSY5,2015-12-31,6645,12646,19291
12696,206,$SNSY5,2016-03-31,66448,126462,192910
12696,206,$SNSY5,2016-06-30,66448,126462,192910
12696,206,$SNSY5,2016-09-30,66448,126462,192910
12696,206,$SNSY5,2016-12-31,66448,126462,192910
12696,206,$SNSY5,2017-03-31,66448,126462,192910
12696,206,$SNSY5,2017-06-30,66448,126462,192910
12696,206,$SNSY5,2017-09-30,66448,126462,192910
12696,206,$SNSY5,2017-12-31,66448,126462,192910
12696,206,$SNSY5,2018-03-31,66448,126462,192910
12696,206,$SNSY5,2018-06-30,66448,126462,192910
12696,206,$SNSY5,2018-09-30,66448,126462,192910
12696,206,$SNSY5,2018-12-31,66448,126462,192910
12696,206,$SNSY5,2019-03-31,66448,126462,192910
12696,206,$SNSY5,2019-06-30,66448,126462,192910
12696,206,$SNSY5,2019-09-30,66448,126462,192910
12696,206,$SNSY5,2019-12-31,66448,126462,192910
12696,206,$SNSY5,2020-03-31,66448,126462,192910
12696,206,$SNSY5,2020-06-30,66448,126462,192910
12696,206,$SNSY5,2020-09-30,2657920,5058480,7716400
12696,207,$SNSY6,2010-12-31,6645,12646,19291
12696,207,$SNSY6,2011-03-31,6645,12646,19291
12696,207,$SNSY6,2011-06-30,6645,12646,19291
12696,207,$SNSY6,2011-09-30,6645,12646,19291
12696,207,$SNSY6,2011-12-31,6645,12646,19291
12696,207,$SNSY6,2012-03-31,6645,12646,19291
12696,207,$SNSY6,2012-06-30,6645,12646,19291
12696,207,$SNSY6,2012-09-30,6645,12646,19291
12696,207,$SNSY6,2012-12-31,6645,12646,19291
12696,207,$SNSY6,2013-03-31,6645,12646,19291
12696,207,$SNSY6,2013-06-30,6645,12646,19291
12696,207,$SNSY6,2013-09-30,6645,12646,19291
12696,207,$SNSY6,2013-12-31,6645,12646,19291
12696,207,$SNSY6,2014-03-31,6645,12646,19291
12696,207,$SNSY6,2014-06-30,6645,12646,19291
12696,207,$SNSY6,2014-09-30,6645,12646,19291
12696,207,$SNSY6,2014-12-31,6645,12646,19291
12696,207,$SNSY6,2015-03-31,6645,12646,19291
12696,207,$SNSY6,2015-06-30,6645,12646,19291
12696,207,$SNSY6,2015-09-30,6645,12646,19291
12696,207,$SNSY6,2015-12-31,6645,12646,19291
12696,207,$SNSY6,2016-03-31,66448,126462,192910
12696,207,$SNSY6,2016-06-30,66448,126462,192910
12696,207,$SNSY6,2016-09-30,66448,126462,192910
12696,207,$SNSY6,2016-12-31,66448,126462,192910
12696,207,$SNSY6,2017-03-31,66448,126462,192910
12696,207,$SNSY6,2017-06-30,66448,126462,192910
12696,207,$SNSY6,2017-09-30,66448,126462,192910
12696,207,$SNSY6,2017-12-31,66448,126462,192910
12696,207,$SNSY6,2018-03-31,66448,126462,192910
12696,207,$SNSY6,2018-06-30,66448,126462,192910
12696,207,$SNSY6,2018-09-30,66448,126462,192910
12696,207,$SNSY6,2018-12-31,66448,126462,192910
12696,207,$SNSY6,2019-03-31,66448,126462,192910
12696,207,$SNSY6,2019-06-30,66448,126462,192910
12696,207,$SNSY6,2019-09-30,66448,126462,192910
12696,207,$SNSY6,2019-12-31,66448,126462,192910
12696,207,$SNSY6,2020-03-31,66448,126462,192910
12696,207,$SNSY6,2020-06-30,66448,126462,192910
12696,207,$SNSY6,2020-09-30,2657920,5058480,7716400
12696,208,$SNSY3,2010-12-31,6645,12646,19291
12696,208,$SNSY3,2011-03-31,6645,12646,19291
12696,208,$SNSY3,2011-06-30,6645,12646,19291
12696,208,$SNSY3,2011-09-30,6645,12646,19291
12696,208,$SNSY3,2011-12-31,6645,12646,19291
12696,208,$SNSY3,2012-03-31,6645,12646,19291
12696,208,$SNSY3,2012-06-30,6645,12646,19291
12696,208,$SNSY3,2012-09-30,6645,12646,19291
12696,208,$SNSY3,2012-12-31,6645,12646,19291
12696,208,$SNSY3,2013-03-31,6645,12646,19291
12696,208,$SNSY3,2013-06-30,6645,12646,19291
12696,208,$SNSY3,2013-09-30,6645,12646,19291
12696,208,$SNSY3,2013-12-31,6645,12646,19291
12696,208,$SNSY3,2014-03-31,6645,12646,19291
12696,208,$SNSY3,2014-06-30,6645,12646,19291
12696,208,$SNSY3,2014-09-30,6645,12646,19291
12696,208,$SNSY3,2014-12-31,6645,12646,19291
12696,208,$SNSY3,2015-03-31,6645,12646,19291
12696,208,$SNSY3,2015-06-30,6645,12646,19291
12696,208,$SNSY3,2015-09-30,6645,12646,19291
12696,208,$SNSY3,2015-12-31,6645,12646,19291
12696,208,$SNSY3,2016-03-31,66448,126462,192910
12696,208,$SNSY3,2016-06-30,66448,126462,192910
12696,208,$SNSY3,2016-09-30,66448,126462,192910
12696,208,$SNSY3,2016-12-31,66448,126462,192910
12696,208,$SNSY3,2017-03-31,66448,126462,192910
12696,208,$SNSY3,2017-06-30,66448,126462,192910
12696,208,$SNSY3,2017-09-30,66448,126462,192910
12696,208,$SNSY3,2017-12-31,66448,126462,192910
12696,208,$SNSY3,2018-03-31,66448,126462,192910
12696,208,$SNSY3,2018-06-30,66448,126462,192910
12696,208,$SNSY3,2018-09-30,66448,126462,192910
12696,208,$SNSY3,2018-12-31,66448,126462,192910
12696,208,$SNSY3,2019-03-31,66448,126462,192910
12696,208,$SNSY3,2019-06-30,66448,126462,192910
12696,208,$SNSY3,2019-09-30,66448,126462,192910
12696,208,$SNSY3,2019-12-31,66448,126462,192910
12696,208,$SNSY3,2020-03-31,66448,126462,192910
12696,208,$SNSY3,2020-06-30,66448,126462,192910
12696,208,$SNSY3,2020-09-30,2657920,5058480,7716400
12823,209,$APTI3,2010-12-31,62500,123455,185955
12823,209,$APTI3,2011-03-31,62500,123455,185955
12823,209,$APTI3,2011-06-30,62500,123455,185955
12823,209,$APTI3,2011-09-30,62500,123455,185955
12823,209,$APTI3,2011-12-31,62500,123455,185955
12823,209,$APTI3,2012-03-31,62500,123455,185955
12823,209,$APTI3,2012-06-30,62500,123455,185955
12823,209,$APTI3,2012-09-30,62500,123455,185955
12823,209,$APTI3,2012-12-31,62500,123455,185955
12823,209,$APTI3,2013-03-31,62500,123455,185955
12823,209,$APTI3,2013-06-30,62500,123455,185955
12823,209,$APTI3,2013-09-30,62500,123455,185955
12823,209,$APTI3,2013-12-31,62500,123455,185955
12823,209,$APTI3,2014-03-31,62500,123455,185955
12823,209,$APTI3,2014-06-30,62500,123455,185955
12823,209,$APTI3,2014-09-30,62500,123455,185955
12823,209,$APTI3,2014-12-31,62500,123455,185955
12823,209,$APTI3,2015-03-31,62500,123455,185955
12823,209,$APTI3,2015-06-30,62500,123455,185955
12823,209,$APTI3,2015-09-30,62500,123455,185955
12823,209,$APTI3,2015-12-31,62500,123455,185955
12823,209,$APTI3,2016-03-31,62500,123455,185955
12823,209,$APTI3,2016-06-30,6250,12345,18595
12823,209,$APTI3,2016-09-30,6250,12345,18595
12823,209,$APTI3,2016-12-31,6250,12345,18595
12823,209,$APTI3,2017-03-31,6250,12345,18595
12823,209,$APTI3,2017-06-30,6250,12345,18595
12823,209,$APTI3,2017-09-30,6250,12345,18595
12823,209,$APTI3,2017-12-31,6250,12345,18595
12823,209,$APTI3,2018-03-31,6250,12345,18595
12823,209,$APTI3,2018-06-30,6250,12345,18595
12823,209,$APTI3,2018-09-30,6250,12345,18595
12823,209,$APTI3,2018-12-31,6250,12345,18595
12823,209,$APTI3,2019-03-31,6250,12345,18595
12823,209,$APTI3,2019-06-30,6250,12345,18595
12823,209,$APTI3,2019-09-30,6250,12345,18595
12823,209,$APTI3,2019-12-31,6250,12345,18595
12823,209,$APTI3,2020-03-31,6250,12345,18595
12823,209,$APTI3,2020-06-30,6250,12345,18595
12823,209,$APTI3,2020-09-30,6250,12345,18595
12823,210,$APTI4,2010-12-31,62500,123455,185955
12823,210,$APTI4,2011-03-31,62500,123455,185955
12823,210,$APTI4,2011-06-30,62500,123455,185955
12823,210,$APTI4,2011-09-30,62500,123455,185955
12823,210,$APTI4,2011-12-31,62500,123455,185955
12823,210,$APTI4,2012-03-31,62500,123455,185955
12823,210,$APTI4,2012-06-30,62500,123455,185955
12823,210,$APTI4,2012-09-30,62500,123455,185955
12823,210,$APTI4,2012-12-31,62500,123455,185955
12823,210,$APTI4,2013-03-31,62500,123455,185955
12823,210,$APTI4,2013-06-30,62500,123455,185955
12823,210,$APTI4,2013-09-30,62500,123455,185955
12823,210,$APTI4,2013-12-31,62500,123455,185955
12823,210,$APTI4,2014-03-31,62500,123455,185955
12823,210,$APTI4,2014-06-30,62500,123455,185955
12823,210,$APTI4,2014-09-30,62500,123455,185955
12823,210,$APTI4,2014-12-31,62500,123455,185955
12823,210,$APTI4,2015-03-31,62500,123455,185955
12823,210,$APTI4,2015-06-30,62500,123455,185955
12823,210,$APTI4,2015-09-30,62500,123455,185955
12823,210,$APTI4,2015-12-31,62500,123455,185955
12823,210,$APTI4,2016-03-31,62500,123455,185955
12823,210,$APTI4,2016-06-30,6250,12345,18595
12823,210,$APTI4,2016-09-30,6250,12345,18595
12823,210,$APTI4,2016-12-31,6250,12345,18595
12823,210,$APTI4,2017-03-31,6250,12345,18595
12823,210,$APTI4,2017-06-30,6250,12345,18595
12823,210,$APTI4,2017-09-30,6250,12345,18595
12823,210,$APTI4,2017-12-31,6250,12345,18595
12823,210,$APTI4,2018-03-31,6250,12345,18595
12823,210,$APTI4,2018-06-30,6250,12345,18595
12823,210,$APTI4,2018-09-30,6250,12345,18595
12823,210,$APTI4,2018-12-31,6250,12345,18595
12823,210,$APTI4,2019-03-31,6250,12345,18595
12823,210,$APTI4,2019-06-30,6250,12345,18595
12823,210,$APTI4,2019-09-30,6250,12345,18595
12823,210,$APTI4,2019-12-31,6250,12345,18595
12823,210,$APTI4,2020-03-31,6250,12345,18595
12823,210,$APTI4,2020-06-30,6250,12345,18595
12823,210,$APTI4,2020-09-30,6250,12345,18595
13285,438,$JOPA,2010-12-31,10451,131,10582
13285,438,$JOPA,2011-03-31,10451,131,10582
13285,438,$JOPA,2011-06-30,10451,131,10582
13285,438,$JOPA,2011-09-30,10451,131,10582
13285,438,$JOPA,2011-12-31,10451,131,10582
13285,438,$JOPA,2012-03-31,10451,131,10582
13285,438,$JOPA,2012-06-30,10451,131,10582
13285,438,$JOPA,2012-09-30,10451,131,10582
13285,438,$JOPA,2012-12-31,10451,131,10582
13285,438,$JOPA,2013-03-31,10451,131,10582
13285,438,$JOPA,2013-06-30,10451,131,10582
13285,438,$JOPA,2013-09-30,10451,131,10582
13285,438,$JOPA,2013-12-31,10451,131,10582
13285,438,$JOPA,2014-03-31,10451,131,10582
13285,438,$JOPA,2014-06-30,10451,131,10582
13285,438,$JOPA,2014-09-30,10451,131,10582
13285,438,$JOPA,2014-12-31,10451,131,10582
13285,438,$JOPA,2015-03-31,10451,131,10582
13285,438,$JOPA,2015-06-30,10451,131,10582
13285,438,$JOPA,2015-09-30,10451,131,10582
13285,438,$JOPA,2015-12-31,10451,131,10582
13285,438,$JOPA,2016-03-31,10451,131,10582
13285,438,$JOPA,2016-06-30,10451,131,10582
13285,438,$JOPA,2016-09-30,10451,131,10582
13285,438,$JOPA,2016-12-31,10451,131,10582
13285,438,$JOPA,2017-03-31,10451,131,10582
13285,438,$JOPA,2017-06-30,10451,131,10582
13285,438,$JOPA,2017-09-30,10451,131,10582
13285,438,$JOPA,2017-12-31,10451,131,10582
13285,438,$JOPA,2018-03-31,10451,131,10582
13285,438,$JOPA,2018-06-30,10451,131,10582
13285,438,$JOPA,2018-09-30,10451,131,10582
13285,438,$JOPA,2018-12-31,10451,131,10582
13285,438,$JOPA,2019-03-31,10451,131,10582
13285,438,$JOPA,2019-06-30,10451,131,10582
13285,438,$JOPA,2019-09-30,10451,131,10582
13285,438,$JOPA,2019-12-31,10451,131,10582
13285,438,$JOPA,2020-03-31,10451,131,10582
13285,438,$JOPA,2020-06-30,10451,131,10582
13285,438,$JOPA,2020-09-30,10451,131,10582
13285,442,$JOPA3,2010-12-31,10451,131,10582
13285,442,$JOPA3,2011-03-31,10451,131,10582
13285,442,$JOPA3,2011-06-30,10451,131,10582
13285,442,$JOPA3,2011-09-30,10451,131,10582
13285,442,$JOPA3,2011-12-31,10451,131,10582
13285,442,$JOPA3,2012-03-31,10451,131,10582
13285,442,$JOPA3,2012-06-30,10451,131,10582
13285,442,$JOPA3,2012-09-30,10451,131,10582
13285,442,$JOPA3,2012-12-31,10451,131,10582
13285,442,$JOPA3,2013-03-31,10451,131,10582
13285,442,$JOPA3,2013-06-30,10451,131,10582
13285,442,$JOPA3,2013-09-30,10451,131,10582
13285,442,$JOPA3,2013-12-31,10451,131,10582
13285,442,$JOPA3,2014-03-31,10451,131,10582
13285,442,$JOPA3,2014-06-30,10451,131,10582
13285,442,$JOPA3,2014-09-30,10451,131,10582
13285,442,$JOPA3,2014-12-31,10451,131,10582
13285,442,$JOPA3,2015-03-31,10451,131,10582
13285,442,$JOPA3,2015-06-30,10451,131,10582
13285,442,$JOPA3,2015-09-30,10451,131,10582
13285,442,$JOPA3,2015-12-31,10451,131,10582
13285,442,$JOPA3,2016-03-31,10451,131,10582
13285,442,$JOPA3,2016-06-30,10451,131,10582
13285,442,$JOPA3,2016-09-30,10451,131,10582
13285,442,$JOPA3,2016-12-31,10451,131,10582
13285,442,$JOPA3,2017-03-31,10451,131,10582
13285,442,$JOPA3,2017-06-30,10451,131,10582
13285,442,$JOPA3,2017-09-30,10451,131,10582
13285,442,$JOPA3,2017-12-31,10451,131,10582
13285,442,$JOPA3,2018-03-31,10451,131,10582
13285,442,$JOPA3,2018-06-30,10451,131,10582
13285,442,$JOPA3,2018-09-30,10451,131,10582
13285,442,$JOPA3,2018-12-31,10451,131,10582
13285,442,$JOPA3,2019-03-31,10451,131,10582
13285,442,$JOPA3,2019-06-30,10451,131,10582
13285,442,$JOPA3,2019-09-30,10451,131,10582
13285,442,$JOPA3,2019-12-31,10451,131,10582
13285,442,$JOPA3,2020-03-31,10451,131,10582
13285,442,$JOPA3,2020-06-30,10451,131,10582
13285,442,$JOPA3,2020-09-30,10451,131,10582
13285,443,$JOPA4,2010-12-31,10451,131,10582
13285,443,$JOPA4,2011-03-31,10451,131,10582
13285,443,$JOPA4,2011-06-30,10451,131,10582
13285,443,$JOPA4,2011-09-30,10451,131,10582
13285,443,$JOPA4,2011-12-31,10451,131,10582
13285,443,$JOPA4,2012-03-31,10451,131,10582
13285,443,$JOPA4,2012-06-30,10451,131,10582
13285,443,$JOPA4,2012-09-30,10451,131,10582
13285,443,$JOPA4,2012-12-31,10451,131,10582
13285,443,$JOPA4,2013-03-31,10451,131,10582
13285,443,$JOPA4,2013-06-30,10451,131,10582
13285,443,$JOPA4,2013-09-30,10451,131,10582
13285,443,$JOPA4,2013-12-31,10451,131,10582
13285,443,$JOPA4,2014-03-31,10451,131,10582
13285,443,$JOPA4,2014-06-30,10451,131,10582
13285,443,$JOPA4,2014-09-30,10451,131,10582
13285,443,$JOPA4,2014-12-31,10451,131,10582
13285,443,$JOPA4,2015-03-31,10451,131,10582
13285,443,$JOPA4,2015-06-30,10451,131,10582
13285,443,$JOPA4,2015-09-30,10451,131,10582
13285,443,$JOPA4,2015-12-31,10451,131,10582
13285,443,$JOPA4,2016-03-31,10451,131,10582
13285,443,$JOPA4,2016-06-30,10451,131,10582
13285,443,$JOPA4,2016-09-30,10451,131,10582
13285,443,$JOPA4,2016-12-31,10451,131,10582
13285,443,$JOPA4,2017-03-31,10451,131,10582
13285,443,$JOPA4,2017-06-30,10451,131,10582
13285,443,$JOPA4,2017-09-30,10451,131,10582
13285,443,$JOPA4,2017-12-31,10451,131,10582
13285,443,$JOPA4,2018-03-31,10451,131,10582
13285,443,$JOPA4,2018-06-30,10451,131,10582
13285,443,$JOPA4,2018-09-30,10451,131,10582
13285,443,$JOPA4,2018-12-31,10451,131,10582
13285,443,$JOPA4,2019-03-31,10451,131,10582
13285,443,$JOPA4,2019-06-30,10451,131,10582
13285,443,$JOPA4,2019-09-30,10451,131,10582
13285,443,$JOPA4,2019-12-31,10451,131,10582
13285,443,$JOPA4,2020-03-31,10451,131,10582
13285,443,$JOPA4,2020-06-30,10451,131,10582
13285,443,$JOPA4,2020-09-30,10451,131,10582
13366,218,$2,2010-12-31,3966667,7933333,11900000
13366,218,$2,2011-03-31,3966667,7933333,11900000
13366,218,$2,2011-06-30,3966667,7933333,11900000
13366,218,$2,2011-09-30,3966667,7933333,11900000
13366,218,$2,2011-12-31,3966667,7933333,11900000
13366,218,$2,2012-03-31,3966667,7933333,11900000
13366,218,$2,2012-06-30,3966667,7933333,11900000
13366,218,$2,2012-09-30,3966667,7933333,11900000
13366,218,$2,2012-12-31,3966667,7933333,11900000
13366,218,$2,2013-03-31,3966667,7933333,11900000
13366,218,$2,2013-06-30,3966667,7933333,11900000
13366,218,$2,2013-09-30,3966667,7933333,11900000
13366,218,$2,2013-12-31,3966667,7933333,11900000
13366,218,$2,2014-03-31,3966667,7933333,11900000
13366,218,$2,2014-06-30,3966667,7933333,11900000
13366,218,$2,2014-09-30,3966667,7933333,11900000
13366,218,$2,2014-12-31,3966667,7933333,11900000
13366,218,$2,2015-03-31,3966667,7933333,11900000
13366,218,$2,2015-06-30,3966667,7933333,11900000
13366,218,$2,2015-09-30,3966667,7933333,11900000
13366,218,$2,2015-12-31,3966667,7933333,11900000
13366,218,$2,2016-03-31,3966667,7933333,11900000
13366,218,$2,2016-06-30,3966667,7933333,11900000
13366,218,$2,2016-09-30,3966667,7933333,11900000
13366,218,$2,2016-12-31,3966667,7933333,11900000
13366,218,$2,2017-03-31,3966667,7933333,11900000
13366,218,$2,2017-06-30,3966667,7933333,11900000
13366,218,$2,2017-09-30,3966667,7933333,11900000
13366,218,$2,2017-12-31,3966667,7933333,11900000
13366,218,$2,2018-03-31,3966667,7933333,11900000
13366,218,$2,2018-06-30,3966667,7933333,11900000
13366,218,$2,2018-09-30,3966667,7933333,11900000
13366,218,$2,2018-12-31,3966667,7933333,11900000
13366,218,$2,2019-03-31,3966667,7933333,11900000
13366,218,$2,2019-06-30,3966667,7933333,11900000
13366,218,$2,2019-09-30,3966667,7933333,11900000
13366,218,$2,2019-12-31,3966667,7933333,11900000
13366,218,$2,2020-03-31,3966667,7933333,11900000
13366,218,$2,2020-06-30,3966667,7933333,11900000
13366,218,$2,2020-09-30,3966667,7933333,11900000
13439,216,$RSUL3,2010-12-31,343000,240000,583000
13439,216,$RSUL3,2011-03-31,343000,240000,583000
13439,216,$RSUL3,2011-06-30,343000,240000,583000
13439,216,$RSUL3,2011-09-30,343000,240000,583000
13439,216,$RSUL3,2011-12-31,343000,240000,583000
13439,216,$RSUL3,2012-03-31,343000,240000,583000
13439,216,$RSUL3,2012-06-30,343000,240000,583000
13439,216,$RSUL3,2012-09-30,343000,240000,583000
13439,216,$RSUL3,2012-12-31,343000,240000,583000
13439,216,$RSUL3,2013-03-31,343000,240000,583000
13439,216,$RSUL3,2013-06-30,343000,240000,583000
13439,216,$RSUL3,2013-09-30,343000,240000,583000
13439,216,$RSUL3,2013-12-31,343000,240000,583000
13439,216,$RSUL3,2014-03-31,343000,240000,583000
13439,216,$RSUL3,2014-06-30,343000,240000,583000
13439,216,$RSUL3,2014-09-30,343000,240000,583000
13439,216,$RSUL3,2014-12-31,343000,240000,583000
13439,216,$RSUL3,2015-03-31,343000,240000,583000
13439,216,$RSUL3,2015-06-30,343000,240000,583000
13439,216,$RSUL3,2015-09-30,343000,240000,583000
13439,216,$RSUL3,2015-12-31,343000,240000,583000
13439,216,$RSUL3,2016-03-31,343000,240000,583000
13439,216,$RSUL3,2016-06-30,343000,240000,583000
13439,216,$RSUL3,2016-09-30,343000,240000,583000
13439,216,$RSUL3,2016-12-31,343000,240000,583000
13439,216,$RSUL3,2017-03-31,343000,240000,583000
13439,216,$RSUL3,2017-06-30,343000,240000,583000
13439,216,$RSUL3,2017-09-30,343000,240000,583000
13439,216,$RSUL3,2017-12-31,343000,240000,583000
13439,216,$RSUL3,2018-03-31,343000,240000,583000
13439,216,$RSUL3,2018-06-30,343000,240000,583000
13439,216,$RSUL3,2018-09-30,343000,240000,583000
13439,216,$RSUL3,2018-12-31,343000,240000,583000
13439,216,$RSUL3,2019-03-31,343000,240000,583000
13439,216,$RSUL3,2019-06-30,343000,240000,583000
13439,216,$RSUL3,2019-09-30,343000,240000,583000
13439,216,$RSUL3,2019-12-31,343000,240000,583000
13439,216,$RSUL3,2020-03-31,343000,240000,583000
13439,216,$RSUL3,2020-06-30,343000,240000,583000
13439,216,$RSUL3,2020-09-30,343000,240000,583000
13439,217,$RSUL4,2010-12-31,343000,240000,583000
13439,217,$RSUL4,2011-03-31,343000,240000,583000
13439,217,$RSUL4,2011-06-30,343000,240000,583000
13439,217,$RSUL4,2011-09-30,343000,240000,583000
13439,217,$RSUL4,2011-12-31,343000,240000,583000
13439,217,$RSUL4,2012-03-31,343000,240000,583000
13439,217,$RSUL4,2012-06-30,343000,240000,583000
13439,217,$RSUL4,2012-09-30,343000,240000,583000
13439,217,$RSUL4,2012-12-31,343000,240000,583000
13439,217,$RSUL4,2013-03-31,343000,240000,583000
13439,217,$RSUL4,2013-06-30,343000,240000,583000
13439,217,$RSUL4,2013-09-30,343000,240000,583000
13439,217,$RSUL4,2013-12-31,343000,240000,583000
13439,217,$RSUL4,2014-03-31,343000,240000,583000
13439,217,$RSUL4,2014-06-30,343000,240000,583000
13439,217,$RSUL4,2014-09-30,343000,240000,583000
13439,217,$RSUL4,2014-12-31,343000,240000,583000
13439,217,$RSUL4,2015-03-31,343000,240000,583000
13439,217,$RSUL4,2015-06-30,343000,240000,583000
13439,217,$RSUL4,2015-09-30,343000,240000,583000
13439,217,$RSUL4,2015-12-31,343000,240000,583000
13439,217,$RSUL4,2016-03-31,343000,240000,583000
13439,217,$RSUL4,2016-06-30,343000,240000,583000
13439,217,$RSUL4,2016-09-30,343000,240000,583000
13439,217,$RSUL4,2016-12-31,343000,240000,583000
13439,217,$RSUL4,2017-03-31,343000,240000,583000
13439,217,$RSUL4,2017-06-30,343000,240000,583000
13439,217,$RSUL4,2017-09-30,343000,240000,583000
13439,217,$RSUL4,2017-12-31,343000,240000,583000
13439,217,$RSUL4,2018-03-31,343000,240000,583000
13439,217,$RSUL4,2018-06-30,343000,240000,583000
13439,217,$RSUL4,2018-09-30,343000,240000,583000
13439,217,$RSUL4,2018-12-31,343000,240000,583000
13439,217,$RSUL4,2019-03-31,343000,240000,583000
13439,217,$RSUL4,2019-06-30,343000,240000,583000
13439,217,$RSUL4,2019-09-30,343000,240000,583000
13439,217,$RSUL4,2019-12-31,343000,240000,583000
13439,217,$RSUL4,2020-03-31,343000,240000,583000
13439,217,$RSUL4,2020-06-30,343000,240000,583000
13439,217,$RSUL4,2020-09-30,343000,240000,583000
13447,219,$PPAR3,2010-12-31,74,0,74
13447,219,$PPAR3,2011-03-31,74,0,74
13447,219,$PPAR3,2011-06-30,74,0,74
13447,219,$PPAR3,2011-09-30,74,0,74
13447,219,$PPAR3,2011-12-31,74,0,74
13447,219,$PPAR3,2012-03-31,74,0,74
13447,219,$PPAR3,2012-06-30,74,0,74
13447,219,$PPAR3,2012-09-30,74,0,74
13447,219,$PPAR3,2012-12-31,74,0,74
13447,219,$PPAR3,2013-03-31,74,0,74
13447,219,$PPAR3,2013-06-30,74,0,74
13447,219,$PPAR3,2013-09-30,74,0,74
13447,219,$PPAR3,2013-12-31,74,0,74
13447,219,$PPAR3,2014-03-31,74,0,74
13447,219,$PPAR3,2014-06-30,74,0,74
13447,219,$PPAR3,2014-09-30,74,0,74
13447,219,$PPAR3,2014-12-31,74,0,74
13447,219,$PPAR3,2015-03-31,74,0,74
13447,219,$PPAR3,2015-06-30,74,0,74
13447,219,$PPAR3,2015-09-30,74,0,74
13447,219,$PPAR3,2015-12-31,74,0,74
13447,219,$PPAR3,2016-03-31,74,0,74
13447,219,$PPAR3,2016-06-30,74,0,74
13447,219,$PPAR3,2016-09-30,74,0,74
13447,219,$PPAR3,2016-12-31,74,0,74
13447,219,$PPAR3,2017-03-31,74,0,74
13447,219,$PPAR3,2017-06-30,74,0,74
13447,219,$PPAR3,2017-09-30,74,0,74
13447,219,$PPAR3,2017-12-31,34,40,74
13447,219,$PPAR3,2018-03-31,34,40,74
13447,219,$PPAR3,2018-06-30,34,40,74
13447,219,$PPAR3,2018-09-30,34,40,74
13447,219,$PPAR3,2018-12-31,34,40,74
13447,219,$PPAR3,2019-03-31,34,40,74
13447,219,$PPAR3,2019-06-30,34,40,74
13447,219,$PPAR3,2019-09-30,34,40,74
13447,219,$PPAR3,2019-12-31,34,40,74
13447,219,$PPAR3,2020-03-31,34,40,74
13447,219,$PPAR3,2020-06-30,34,40,74
13447,219,$PPAR3,2020-09-30,34,40,74
13471,222,$13471,2010-12-31,166430,0,166430
13471,222,$13471,2011-03-31,166430,0,166430
13471,222,$13471,2011-06-30,166430,0,166430
13471,222,$13471,2011-09-30,166430,0,166430
13471,222,$13471,2011-12-31,166430,0,166430
13471,222,$13471,2012-03-31,166430,0,166430
13471,222,$13471,2012-06-30,239854,0,239854
13471,222,$13471,2012-09-30,239854,0,239854
13471,222,$13471,2012-12-31,239854,0,239854
13471,222,$13471,2013-03-31,239854,0,239854
13471,222,$13471,2013-06-30,242018,0,242018
13471,222,$13471,2013-09-30,242018,0,242018
13471,222,$13471,2013-12-31,242018,0,242018
13471,222,$13471,2014-03-31,242018,0,242018
13471,222,$13471,2014-06-30,248508,0,248508
13471,222,$13471,2014-09-30,248508,0,248508
13471,222,$13471,2014-12-31,248508,0,248508
13471,222,$13471,2015-03-31,248508,0,248508
13471,222,$13471,2015-06-30,248508,0,248508
13471,222,$13471,2015-09-30,4970,0,4970
13471,222,$13471,2015-12-31,4970,0,4970
13471,222,$13471,2016-03-31,4970,0,4970
13471,222,$13471,2016-06-30,4970,0,4970
13471,222,$13471,2016-09-30,4970,0,4970
13471,222,$13471,2016-12-31,4970,0,4970
13471,222,$13471,2017-03-31,4970,0,4970
13471,222,$13471,2017-06-30,4970,0,4970
13471,222,$13471,2017-09-30,4970,0,4970
13471,222,$13471,2017-12-31,4970,0,4970
13471,222,$13471,2018-03-31,4970,0,4970
13471,222,$13471,2018-06-30,4970,0,4970
13471,222,$13471,2018-09-30,4970,0,4970
13471,222,$13471,2018-12-31,4970,0,4970
13471,222,$13471,2019-03-31,12425,0,12425
13471,222,$13471,2019-06-30,12425,0,12425
13471,222,$13471,2019-09-30,12425,0,12425
13471,222,$13471,2019-12-31,12425,0,12425
13471,222,$13471,2020-03-31,12425,0,12425
13471,222,$13471,2020-06-30,12425,0,12425
13471,222,$13471,2020-09-30,12425,0,12425
13471,224,$BOLSA,2010-12-31,166430,0,166430
13471,224,$BOLSA,2011-03-31,166430,0,166430
13471,224,$BOLSA,2011-06-30,166430,0,166430
13471,224,$BOLSA,2011-09-30,166430,0,166430
13471,224,$BOLSA,2011-12-31,166430,0,166430
13471,224,$BOLSA,2012-03-31,166430,0,166430
13471,224,$BOLSA,2012-06-30,239854,0,239854
13471,224,$BOLSA,2012-09-30,239854,0,239854
13471,224,$BOLSA,2012-12-31,239854,0,239854
13471,224,$BOLSA,2013-03-31,239854,0,239854
13471,224,$BOLSA,2013-06-30,242018,0,242018
13471,224,$BOLSA,2013-09-30,242018,0,242018
13471,224,$BOLSA,2013-12-31,242018,0,242018
13471,224,$BOLSA,2014-03-31,242018,0,242018
13471,224,$BOLSA,2014-06-30,248508,0,248508
13471,224,$BOLSA,2014-09-30,248508,0,248508
13471,224,$BOLSA,2014-12-31,248508,0,248508
13471,224,$BOLSA,2015-03-31,248508,0,248508
13471,224,$BOLSA,2015-06-30,248508,0,248508
13471,224,$BOLSA,2015-09-30,4970,0,4970
13471,224,$BOLSA,2015-12-31,4970,0,4970
13471,224,$BOLSA,2016-03-31,4970,0,4970
13471,224,$BOLSA,2016-06-30,4970,0,4970
13471,224,$BOLSA,2016-09-30,4970,0,4970
13471,224,$BOLSA,2016-12-31,4970,0,4970
13471,224,$BOLSA,2017-03-31,4970,0,4970
13471,224,$BOLSA,2017-06-30,4970,0,4970
13471,224,$BOLSA,2017-09-30,4970,0,4970
13471,224,$BOLSA,2017-12-31,4970,0,4970
13471,224,$BOLSA,2018-03-31,4970,0,4970
13471,224,$BOLSA,2018-06-30,4970,0,4970
13471,224,$BOLSA,2018-09-30,4970,0,4970
13471,224,$BOLSA,2018-12-31,4970,0,4970
13471,224,$BOLSA,2019-03-31,12425,0,12425
13471,224,$BOLSA,2019-06-30,12425,0,12425
13471,224,$BOLSA,2019-09-30,12425,0,12425
13471,224,$BOLSA,2019-12-31,12425,0,12425
13471,224,$BOLSA,2020-03-31,12425,0,12425
13471,224,$BOLSA,2020-06-30,12425,0,12425
13471,224,$BOLSA,2020-09-30,12425,0,12425
13765,223,$MNPR3,2010-12-31,405720000,0,405720000
13765,223,$MNPR3,2011-03-31,405720000,0,405720000
13765,223,$MNPR3,2011-06-30,405720000,0,405720000
13765,223,$MNPR3,2011-09-30,507150000,0,507150000
13765,223,$MNPR3,2011-12-31,507150000,0,507150000
13765,223,$MNPR3,2012-03-31,507150000,0,507150000
13765,223,$MNPR3,2012-06-30,507150000,0,507150000
13765,223,$MNPR3,2012-09-30,573819104,0,573819104
13765,223,$MNPR3,2012-12-31,710010000,0,710010000
13765,223,$MNPR3,2013-03-31,710010000,0,710010000
13765,223,$MNPR3,2013-06-30,710010000,0,710010000
13765,223,$MNPR3,2013-09-30,710010000,0,710010000
13765,223,$MNPR3,2013-12-31,710010000,0,710010000
13765,223,$MNPR3,2014-03-31,710010,0,710010
13765,223,$MNPR3,2014-06-30,710010,0,710010
13765,223,$MNPR3,2014-09-30,710010,0,710010
13765,223,$MNPR3,2014-12-31,710010,0,710010
13765,223,$MNPR3,2015-03-31,710010,0,710010
13765,223,$MNPR3,2015-06-30,710010,0,710010
13765,223,$MNPR3,2015-09-30,710010,0,710010
13765,223,$MNPR3,2015-12-31,710010,0,710010
13765,223,$MNPR3,2016-03-31,710010,0,710010
13765,223,$MNPR3,2016-06-30,7100,0,7100
13765,223,$MNPR3,2016-09-30,7100,0,7100
13765,223,$MNPR3,2016-12-31,7100,0,7100
13765,223,$MNPR3,2017-03-31,7100,0,7100
13765,223,$MNPR3,2017-06-30,7100,0,7100
13765,223,$MNPR3,2017-09-30,7100,0,7100
13765,223,$MNPR3,2017-12-31,7100,0,7100
13765,223,$MNPR3,2018-03-31,7100,0,7100
13765,223,$MNPR3,2018-06-30,7100,0,7100
13765,223,$MNPR3,2018-09-30,7100,0,7100
13765,223,$MNPR3,2018-12-31,7100,0,7100
13765,223,$MNPR3,2019-03-31,7100,0,7100
13765,223,$MNPR3,2019-06-30,7100,0,7100
13765,223,$MNPR3,2019-09-30,7100,0,7100
13765,223,$MNPR3,2019-12-31,7100,0,7100
13765,223,$MNPR3,2020-03-31,7100,0,7100
13765,223,$MNPR3,2020-06-30,7100,0,7100
13765,223,$MNPR3,2020-09-30,7100,0,7100
13773,230,$PTBL3,2010-12-31,159009,0,159009
13773,230,$PTBL3,2011-03-31,159009,0,159009
13773,230,$PTBL3,2011-06-30,159008924,0,159008924
13773,230,$PTBL3,2011-09-30,159008924,0,159008924
13773,230,$PTBL3,2011-12-31,159009,0,159009
13773,230,$PTBL3,2012-03-31,159009,0,159009
13773,230,$PTBL3,2012-06-30,159009,0,159009
13773,230,$PTBL3,2012-09-30,159009,0,159009
13773,230,$PTBL3,2012-12-31,159009,0,159009
13773,230,$PTBL3,2013-03-31,159009,0,159009
13773,230,$PTBL3,2013-06-30,159009,0,159009
13773,230,$PTBL3,2013-09-30,159009,0,159009
13773,230,$PTBL3,2013-12-31,159009,0,159009
13773,230,$PTBL3,2014-03-31,159009,0,159009
13773,230,$PTBL3,2014-06-30,159009,0,159009
13773,230,$PTBL3,2014-09-30,158489,0,158489
13773,230,$PTBL3,2014-12-31,158488,0,158488
13773,230,$PTBL3,2015-03-31,158488,0,158488
13773,230,$PTBL3,2015-06-30,158489,0,158489
13773,230,$PTBL3,2015-09-30,158488,0,158488
13773,230,$PTBL3,2015-12-31,158488,0,158488
13773,230,$PTBL3,2016-03-31,158488,0,158488
13773,230,$PTBL3,2016-06-30,158488,0,158488
13773,230,$PTBL3,2016-09-30,158488,0,158488
13773,230,$PTBL3,2016-12-31,158489,0,158489
13773,230,$PTBL3,2017-03-31,158489,0,158489
13773,230,$PTBL3,2017-06-30,158488,0,158488
13773,230,$PTBL3,2017-09-30,158488,0,158488
13773,230,$PTBL3,2017-12-31,158489,0,158489
13773,230,$PTBL3,2018-03-31,158489,0,158489
13773,230,$PTBL3,2018-06-30,158489,0,158489
13773,230,$PTBL3,2018-09-30,158489,0,158489
13773,230,$PTBL3,2018-12-31,158489,0,158489
13773,230,$PTBL3,2019-03-31,158489,0,158489
13773,230,$PTBL3,2019-06-30,158489,0,158489
13773,230,$PTBL3,2019-09-30,158489,0,158489
13773,230,$PTBL3,2019-12-31,158489,0,158489
13773,230,$PTBL3,2020-03-31,158485,0,158485
13773,230,$PTBL3,2020-06-30,155649,0,155649
13773,230,$PTBL3,2020-09-30,158489,0,158489
13781,229,$SCAR3,2010-12-31,57737,0,57737
13781,229,$SCAR3,2011-03-31,57419,0,57419
13781,229,$SCAR3,2011-06-30,57737,0,57737
13781,229,$SCAR3,2011-09-30,57737,0,57737
13781,229,$SCAR3,2011-12-31,57737,0,57737
13781,229,$SCAR3,2012-03-31,57737,0,57737
13781,229,$SCAR3,2012-06-30,57307,0,57307
13781,229,$SCAR3,2012-09-30,57737,0,57737
13781,229,$SCAR3,2012-12-31,57737,0,57737
13781,229,$SCAR3,2013-03-31,57737,0,57737
13781,229,$SCAR3,2013-06-30,57737,0,57737
13781,229,$SCAR3,2013-09-30,57737,0,57737
13781,229,$SCAR3,2013-12-31,57737,0,57737
13781,229,$SCAR3,2014-03-31,57737,0,57737
13781,229,$SCAR3,2014-06-30,57737,0,57737
13781,229,$SCAR3,2014-09-30,57737,0,57737
13781,229,$SCAR3,2014-12-31,57737,0,57737
13781,229,$SCAR3,2015-03-31,57737,0,57737
13781,229,$SCAR3,2015-06-30,57737,0,57737
13781,229,$SCAR3,2015-09-30,57737,0,57737
13781,229,$SCAR3,2015-12-31,57737,0,57737
13781,229,$SCAR3,2016-03-31,57737,0,57737
13781,229,$SCAR3,2016-06-30,57737,0,57737
13781,229,$SCAR3,2016-09-30,57737,0,57737
13781,229,$SCAR3,2016-12-31,57737,0,57737
13781,229,$SCAR3,2017-03-31,57737,0,57737
13781,229,$SCAR3,2017-06-30,57737,0,57737
13781,229,$SCAR3,2017-09-30,57737,0,57737
13781,229,$SCAR3,2017-12-31,57737,0,57737
13781,229,$SCAR3,2018-03-31,57737,0,57737
13781,229,$SCAR3,2018-06-30,57737,0,57737
13781,229,$SCAR3,2018-09-30,57737,0,57737
13781,229,$SCAR3,2018-12-31,57737,0,57737
13781,229,$SCAR3,2019-03-31,57737,0,57737
13781,229,$SCAR3,2019-06-30,57737,0,57737
13781,229,$SCAR3,2019-09-30,57737,0,57737
13781,229,$SCAR3,2019-12-31,57737,0,57737
13781,229,$SCAR3,2020-03-31,57737,0,57737
13781,229,$SCAR3,2020-06-30,57737,0,57737
13781,229,$SCAR3,2020-09-30,57737,0,57737
13854,220,$713854,2010-12-31,4544544,4644403,9188947
13854,220,$713854,2011-03-31,4544544,4644403,9188947
13854,220,$713854,2011-06-30,4544544,4644403,9188947
13854,220,$713854,2011-09-30,4544544,4644403,9188947
13854,220,$713854,2011-12-31,4544544,4644403,9188947
13854,220,$713854,2012-03-31,4544544,4644403,9188947
13854,220,$713854,2012-06-30,4544544,4644403,9188947
13854,220,$713854,2012-09-30,4544544,4644403,9188947
13854,220,$713854,2012-12-31,4544544,4644403,9188947
13854,220,$713854,2013-03-31,4544544,4644403,9188947
13854,220,$713854,2013-06-30,4544544,4644403,9188947
13854,220,$713854,2013-09-30,4544544,4644403,9188947
13854,220,$713854,2013-12-31,4544544,4644403,9188947
13854,220,$713854,2014-03-31,4544544,4644403,9188947
13854,220,$713854,2014-06-30,4544544,4644403,9188947
13854,220,$713854,2014-09-30,4544544,4644403,9188947
13854,220,$713854,2014-12-31,4544544,4644403,9188947
13854,220,$713854,2015-03-31,4544544,4644403,9188947
13854,220,$713854,2015-06-30,4544544,4644403,9188947
13854,220,$713854,2015-09-30,4544544,4644403,9188947
13854,220,$713854,2015-12-31,454455,464440,918895
13854,220,$713854,2016-03-31,454455,464440,918895
13854,220,$713854,2016-06-30,454455,464440,918895
13854,220,$713854,2016-09-30,454455,464440,918895
13854,220,$713854,2016-12-31,454455,464440,918895
13854,220,$713854,2017-03-31,454455,464440,918895
13854,220,$713854,2017-06-30,454455,464440,918895
13854,220,$713854,2017-09-30,454455,464440,918895
13854,220,$713854,2017-12-31,454455,464440,918895
13854,220,$713854,2018-03-31,454455,464440,918895
13854,220,$713854,2018-06-30,454455,464440,918895
13854,220,$713854,2018-09-30,454455,464440,918895
13854,220,$713854,2018-12-31,454455,464440,918895
13854,220,$713854,2019-03-31,454455,464440,918895
13854,220,$713854,2019-06-30,454455,464440,918895
13854,220,$713854,2019-09-30,454455,464440,918895
13854,220,$713854,2019-12-31,454455,464440,918895
13854,220,$713854,2020-03-31,454455,464440,918895
13854,220,$713854,2020-06-30,454455,464440,918895
13854,220,$713854,2020-09-30,454455,464440,918895
13986,243,$SUZB3,2010-12-31,140039,268853,408892
13986,243,$SUZB3,2011-03-31,140039,268853,408892
13986,243,$SUZB3,2011-06-30,140039,268853,408892
13986,243,$SUZB3,2011-09-30,140039,268853,408892
13986,243,$SUZB3,2011-12-31,140039,268853,408892
13986,243,$SUZB3,2012-03-31,140039,268853,408892
13986,243,$SUZB3,2012-06-30,259646,506440,766086
13986,243,$SUZB3,2012-09-30,371128,736549,1107677
13986,243,$SUZB3,2012-12-31,371128,736549,1107677
13986,243,$SUZB3,2013-03-31,371128,736549,1107677
13986,243,$SUZB3,2013-06-30,371128,736549,1107677
13986,243,$SUZB3,2013-09-30,371128,736549,1107677
13986,243,$SUZB3,2013-12-31,371149,736590,1107739
13986,243,$SUZB3,2014-03-31,371149,736590,1107739
13986,243,$SUZB3,2014-06-30,371149,736590,1107739
13986,243,$SUZB3,2014-09-30,371149,736590,1107739
13986,243,$SUZB3,2014-12-31,371149,736590,1107739
13986,243,$SUZB3,2015-03-31,371149,736590,1107739
13986,243,$SUZB3,2015-06-30,371149,736590,1107739
13986,243,$SUZB3,2015-09-30,371149,736590,1107739
13986,243,$SUZB3,2015-12-31,371149,736590,1107739
13986,243,$SUZB3,2016-03-31,371149,736590,1107739
13986,243,$SUZB3,2016-06-30,371149,736590,1107739
13986,243,$SUZB3,2016-09-30,371149,736590,1107739
13986,243,$SUZB3,2016-12-31,371149,736590,1107739
13986,243,$SUZB3,2017-03-31,371149,736590,1107739
13986,243,$SUZB3,2017-06-30,371145,734681,1105826
13986,243,$SUZB3,2017-09-30,371145,734681,1105826
13986,243,$SUZB3,2017-12-31,1105826,0,1105826
13986,243,$SUZB3,2018-03-31,1105826,0,1105826
13986,243,$SUZB3,2018-06-30,1105826,0,1105826
13986,243,$SUZB3,2018-09-30,1105826,0,1105826
13986,243,$SUZB3,2018-12-31,1105826,0,1105826
13986,243,$SUZB3,2019-03-31,1361264,0,1361264
13986,243,$SUZB3,2019-06-30,1361264,0,1361264
13986,243,$SUZB3,2019-09-30,1361263584,0,1361263584
13986,243,$SUZB3,2019-12-31,1361263584,0,1361263584
13986,243,$SUZB3,2020-03-31,1361263584,0,1361263584
13986,243,$SUZB3,2020-06-30,1361263584,0,1361263584
13986,243,$SUZB3,2020-09-30,1361263584,0,1361263584
14109,241,$RAPT3,2010-12-31,81888,161897,243785
14109,241,$RAPT3,2011-03-31,81888,161897,243785
14109,241,$RAPT3,2011-06-30,81888,161897,243785
14109,241,$RAPT3,2011-09-30,81888,161897,243785
14109,241,$RAPT3,2011-12-31,81888,161897,243785
14109,241,$RAPT3,2012-03-31,81888,161897,243785
14109,241,$RAPT3,2012-06-30,81888,161897,243785
14109,241,$RAPT3,2012-09-30,81888,161897,243785
14109,241,$RAPT3,2012-12-31,81888,161897,243785
14109,241,$RAPT3,2013-03-31,81888,161897,243785
14109,241,$RAPT3,2013-06-30,81888,161897,243785
14109,241,$RAPT3,2013-09-30,81888,161897,243785
14109,241,$RAPT3,2013-12-31,81888,161897,243785
14109,241,$RAPT3,2014-03-31,81888,161897,243785
14109,241,$RAPT3,2014-06-30,102360,202371,304731
14109,241,$RAPT3,2014-09-30,102360,202371,304731
14109,241,$RAPT3,2014-12-31,102360,202371,304731
14109,241,$RAPT3,2015-03-31,102360,202371,304731
14109,241,$RAPT3,2015-06-30,102360,202371,304731
14109,241,$RAPT3,2015-09-30,102360,202371,304731
14109,241,$RAPT3,2015-12-31,102360,202371,304731
14109,241,$RAPT3,2016-03-31,102360,202371,304731
14109,241,$RAPT3,2016-06-30,116516,229260,345776
14109,241,$RAPT3,2016-09-30,116516,229260,345776
14109,241,$RAPT3,2016-12-31,116516,229260,345776
14109,241,$RAPT3,2017-03-31,116516,229260,345776
14109,241,$RAPT3,2017-06-30,116516,229260,345776
14109,241,$RAPT3,2017-09-30,116516,229260,345776
14109,241,$RAPT3,2017-12-31,116516,229260,345776
14109,241,$RAPT3,2018-03-31,116516,229260,345776
14109,241,$RAPT3,2018-06-30,116516,229260,345776
14109,241,$RAPT3,2018-09-30,116516,229260,345776
14109,241,$RAPT3,2018-12-31,116516,229260,345776
14109,241,$RAPT3,2019-03-31,116516,229260,345776
14109,241,$RAPT3,2019-06-30,116516,229260,345776
14109,241,$RAPT3,2019-09-30,116516,229260,345776
14109,241,$RAPT3,2019-12-31,116516,229260,345776
14109,241,$RAPT3,2020-03-31,116516,229260,345776
14109,241,$RAPT3,2020-06-30,116516,229260,345776
14109,241,$RAPT3,2020-09-30,116516,229260,345776
14109,242,$RAPT4,2010-12-31,81888,161897,243785
14109,242,$RAPT4,2011-03-31,81888,161897,243785
14109,242,$RAPT4,2011-06-30,81888,161897,243785
14109,242,$RAPT4,2011-09-30,81888,161897,243785
14109,242,$RAPT4,2011-12-31,81888,161897,243785
14109,242,$RAPT4,2012-03-31,81888,161897,243785
14109,242,$RAPT4,2012-06-30,81888,161897,243785
14109,242,$RAPT4,2012-09-30,81888,161897,243785
14109,242,$RAPT4,2012-12-31,81888,161897,243785
14109,242,$RAPT4,2013-03-31,81888,161897,243785
14109,242,$RAPT4,2013-06-30,81888,161897,243785
14109,242,$RAPT4,2013-09-30,81888,161897,243785
14109,242,$RAPT4,2013-12-31,81888,161897,243785
14109,242,$RAPT4,2014-03-31,81888,161897,243785
14109,242,$RAPT4,2014-06-30,102360,202371,304731
14109,242,$RAPT4,2014-09-30,102360,202371,304731
14109,242,$RAPT4,2014-12-31,102360,202371,304731
14109,242,$RAPT4,2015-03-31,102360,202371,304731
14109,242,$RAPT4,2015-06-30,102360,202371,304731
14109,242,$RAPT4,2015-09-30,102360,202371,304731
14109,242,$RAPT4,2015-12-31,102360,202371,304731
14109,242,$RAPT4,2016-03-31,102360,202371,304731
14109,242,$RAPT4,2016-06-30,116516,229260,345776
14109,242,$RAPT4,2016-09-30,116516,229260,345776
14109,242,$RAPT4,2016-12-31,116516,229260,345776
14109,242,$RAPT4,2017-03-31,116516,229260,345776
14109,242,$RAPT4,2017-06-30,116516,229260,345776
14109,242,$RAPT4,2017-09-30,116516,229260,345776
14109,242,$RAPT4,2017-12-31,116516,229260,345776
14109,242,$RAPT4,2018-03-31,116516,229260,345776
14109,242,$RAPT4,2018-06-30,116516,229260,345776
14109,242,$RAPT4,2018-09-30,116516,229260,345776
14109,242,$RAPT4,2018-12-31,116516,229260,345776
14109,242,$RAPT4,2019-03-31,116516,229260,345776
14109,242,$RAPT4,2019-06-30,116516,229260,345776
14109,242,$RAPT4,2019-09-30,116516,229260,345776
14109,242,$RAPT4,2019-12-31,116516,229260,345776
14109,242,$RAPT4,2020-03-31,116516,229260,345776
14109,242,$RAPT4,2020-06-30,116516,229260,345776
14109,242,$RAPT4,2020-09-30,116516,229260,345776
14176,231,$ELPL3,2010-12-31,66605,100739,167344
14176,231,$ELPL3,2011-03-31,66605,100739,167344
14176,231,$ELPL3,2011-06-30,66605,100739,167344
14176,231,$ELPL3,2011-09-30,66605,100739,167344
14176,231,$ELPL3,2011-12-31,66605,100739,167344
14176,231,$ELPL3,2012-03-31,66605,100739,167344
14176,231,$ELPL3,2012-06-30,66605,100739,167344
14176,231,$ELPL3,2012-09-30,66605,100739,167344
14176,231,$ELPL3,2012-12-31,66605,100739,167344
14176,231,$ELPL3,2013-03-31,66605,100739,167344
14176,231,$ELPL3,2013-06-30,66605,100739,167344
14176,231,$ELPL3,2013-09-30,66605,100739,167344
14176,231,$ELPL3,2013-12-31,66605,100739,167344
14176,231,$ELPL3,2014-03-31,66605,100739,167344
14176,231,$ELPL3,2014-06-30,66605,100739,167344
14176,231,$ELPL3,2014-09-30,66605,100739,167344
14176,231,$ELPL3,2014-12-31,66605,100739,167344
14176,231,$ELPL3,2015-03-31,66605,100739,167344
14176,231,$ELPL3,2015-06-30,66605,100739,167344
14176,231,$ELPL3,2015-09-30,66605,100739,167344
14176,231,$ELPL3,2015-12-31,66605,100739,167344
14176,231,$ELPL3,2016-03-31,66605,100739,167344
14176,231,$ELPL3,2016-06-30,66605,100739,167344
14176,231,$ELPL3,2016-09-30,66605,100739,167344
14176,231,$ELPL3,2016-12-31,55781,111563,167344
14176,231,$ELPL3,2017-03-31,55781,111563,167344
14176,231,$ELPL3,2017-06-30,55781,111563,167344
14176,231,$ELPL3,2017-09-30,55781,111563,167344
14176,231,$ELPL3,2017-12-31,164286,0,164286
14176,231,$ELPL3,2018-03-31,164286,0,164286
14176,231,$ELPL3,2018-06-30,167344,0,167344
14176,231,$ELPL3,2018-09-30,200515,0,200515
14176,231,$ELPL3,2018-12-31,200515,0,200515
14176,231,$ELPL3,2019-03-31,200515,0,200515
14176,231,$ELPL3,2019-06-30,200515,0,200515
14176,231,$ELPL3,2019-09-30,200515,0,200515
14176,231,$ELPL3,2019-12-31,197467,0,197467
14176,231,$ELPL3,2020-03-31,197467,0,197467
14176,231,$ELPL3,2020-06-30,197467,0,197467
14176,231,$ELPL3,2020-09-30,197467,0,197467
14206,234,$BSLI03,2010-12-31,28015,8290,36305
14206,234,$BSLI03,2011-03-31,28015,8290,36305
14206,234,$BSLI03,2011-06-30,28015,8290,36305
14206,234,$BSLI03,2011-09-30,28015,8290,36305
14206,234,$BSLI03,2011-12-31,28015,8290,36305
14206,234,$BSLI03,2012-03-31,28015,8290,36305
14206,234,$BSLI03,2012-06-30,28015,8290,36305
14206,234,$BSLI03,2012-09-30,28015,8290,36305
14206,234,$BSLI03,2012-12-31,28015,8290,36305
14206,234,$BSLI03,2013-03-31,28015,8290,36305
14206,234,$BSLI03,2013-06-30,28015,8290,36305
14206,234,$BSLI03,2013-09-30,28014,8290,36304
14206,234,$BSLI03,2013-12-31,28014,8290,36304
14206,234,$BSLI03,2014-03-31,28014,8290,36304
14206,234,$BSLI03,2014-06-30,28014,8290,36304
14206,234,$BSLI03,2014-09-30,28014,8290,36304
14206,234,$BSLI03,2014-12-31,28014,8290,36304
14206,234,$BSLI03,2015-03-31,28014,8290,36304
14206,234,$BSLI03,2015-06-30,28014,8290,36304
14206,234,$BSLI03,2015-09-30,28014,8290,36304
14206,234,$BSLI03,2015-12-31,28014,8290,36304
14206,234,$BSLI03,2016-03-31,28014,8290,36304
14206,234,$BSLI03,2016-06-30,28014,8290,36304
14206,234,$BSLI03,2016-09-30,28014,8290,36304
14206,234,$BSLI03,2016-12-31,28014,8290,36304
14206,234,$BSLI03,2017-03-31,28014,8290,36304
14206,234,$BSLI03,2017-06-30,28014,8290,36304
14206,234,$BSLI03,2017-09-30,28014,8290,36304
14206,234,$BSLI03,2017-12-31,28014,8290,36304
14206,234,$BSLI03,2018-03-31,28014,8290,36304
14206,234,$BSLI03,2018-06-30,28014,8290,36304
14206,234,$BSLI03,2018-09-30,28014,8290,36304
14206,234,$BSLI03,2018-12-31,28014,8290,36304
14206,234,$BSLI03,2019-03-31,28014,8290,36304
14206,234,$BSLI03,2019-06-30,28014,8290,36304
14206,234,$BSLI03,2019-09-30,28014,8290,36304
14206,234,$BSLI03,2019-12-31,28014,8290,36304
14206,234,$BSLI03,2020-03-31,28014,8290,36304
14206,234,$BSLI03,2020-06-30,28014,8290,36304
14206,234,$BSLI03,2020-09-30,28014,8290,36304
14206,235,$BSLI04,2010-12-31,28015,8290,36305
14206,235,$BSLI04,2011-03-31,28015,8290,36305
14206,235,$BSLI04,2011-06-30,28015,8290,36305
14206,235,$BSLI04,2011-09-30,28015,8290,36305
14206,235,$BSLI04,2011-12-31,28015,8290,36305
14206,235,$BSLI04,2012-03-31,28015,8290,36305
14206,235,$BSLI04,2012-06-30,28015,8290,36305
14206,235,$BSLI04,2012-09-30,28015,8290,36305
14206,235,$BSLI04,2012-12-31,28015,8290,36305
14206,235,$BSLI04,2013-03-31,28015,8290,36305
14206,235,$BSLI04,2013-06-30,28015,8290,36305
14206,235,$BSLI04,2013-09-30,28014,8290,36304
14206,235,$BSLI04,2013-12-31,28014,8290,36304
14206,235,$BSLI04,2014-03-31,28014,8290,36304
14206,235,$BSLI04,2014-06-30,28014,8290,36304
14206,235,$BSLI04,2014-09-30,28014,8290,36304
14206,235,$BSLI04,2014-12-31,28014,8290,36304
14206,235,$BSLI04,2015-03-31,28014,8290,36304
14206,235,$BSLI04,2015-06-30,28014,8290,36304
14206,235,$BSLI04,2015-09-30,28014,8290,36304
14206,235,$BSLI04,2015-12-31,28014,8290,36304
14206,235,$BSLI04,2016-03-31,28014,8290,36304
14206,235,$BSLI04,2016-06-30,28014,8290,36304
14206,235,$BSLI04,2016-09-30,28014,8290,36304
14206,235,$BSLI04,2016-12-31,28014,8290,36304
14206,235,$BSLI04,2017-03-31,28014,8290,36304
14206,235,$BSLI04,2017-06-30,28014,8290,36304
14206,235,$BSLI04,2017-09-30,28014,8290,36304
14206,235,$BSLI04,2017-12-31,28014,8290,36304
14206,235,$BSLI04,2018-03-31,28014,8290,36304
14206,235,$BSLI04,2018-06-30,28014,8290,36304
14206,235,$BSLI04,2018-09-30,28014,8290,36304
14206,235,$BSLI04,2018-12-31,28014,8290,36304
14206,235,$BSLI04,2019-03-31,28014,8290,36304
14206,235,$BSLI04,2019-06-30,28014,8290,36304
14206,235,$BSLI04,2019-09-30,28014,8290,36304
14206,235,$BSLI04,2019-12-31,28014,8290,36304
14206,235,$BSLI04,2020-03-31,28014,8290,36304
14206,235,$BSLI04,2020-06-30,28014,8290,36304
14206,235,$BSLI04,2020-09-30,28014,8290,36304
14311,237,$CPLE3,2010-12-31,145031080,128624295,273655375
14311,237,$CPLE3,2011-03-31,145031080,128624295,273655375
14311,237,$CPLE3,2011-06-30,145031080,128624295,273655375
14311,237,$CPLE3,2011-09-30,145031080,128624295,273655375
14311,237,$CPLE3,2011-12-31,145031080,128624295,273655375
14311,237,$CPLE3,2012-03-31,145031080,128624295,273655375
14311,237,$CPLE3,2012-06-30,145031080,128624295,273655375
14311,237,$CPLE3,2012-09-30,145031080,128624295,273655375
14311,237,$CPLE3,2012-12-31,145031080,128624295,273655375
14311,237,$CPLE3,2013-03-31,145031080,128624295,273655375
14311,237,$CPLE3,2013-06-30,145031080,128624295,273655375
14311,237,$CPLE3,2013-09-30,145031080,128624295,273655375
14311,237,$CPLE3,2013-12-31,145031080,128624295,273655375
14311,237,$CPLE3,2014-03-31,145031080,128624295,273655375
14311,237,$CPLE3,2014-06-30,145031080,128624295,273655375
14311,237,$CPLE3,2014-09-30,145031080,128624295,273655375
14311,237,$CPLE3,2014-12-31,145031080,128624295,273655375
14311,237,$CPLE3,2015-03-31,145031080,128624295,273655375
14311,237,$CPLE3,2015-06-30,145031080,128624295,273655375
14311,237,$CPLE3,2015-09-30,145031080,128624295,273655375
14311,237,$CPLE3,2015-12-31,145031080,128624295,273655375
14311,237,$CPLE3,2016-03-31,145031080,128624295,273655375
14311,237,$CPLE3,2016-06-30,145031080,128624295,273655375
14311,237,$CPLE3,2016-09-30,145031080,128624295,273655375
14311,237,$CPLE3,2016-12-31,145031080,128624295,273655375
14311,237,$CPLE3,2017-03-31,145031080,128624295,273655375
14311,237,$CPLE3,2017-06-30,145031080,128624295,273655375
14311,237,$CPLE3,2017-09-30,145031080,128624295,273655375
14311,237,$CPLE3,2017-12-31,145031080,128624295,273655375
14311,237,$CPLE3,2018-03-31,145031080,128624295,273655375
14311,237,$CPLE3,2018-06-30,145031080,128624295,273655375
14311,237,$CPLE3,2018-09-30,145031080,128624295,273655375
14311,237,$CPLE3,2018-12-31,145031080,128624295,273655375
14311,237,$CPLE3,2019-03-31,145031080,128624295,273655375
14311,237,$CPLE3,2019-06-30,145031080,128624295,273655375
14311,237,$CPLE3,2019-09-30,145031080,128624295,273655375
14311,237,$CPLE3,2019-12-31,145031080,128624295,273655375
14311,237,$CPLE3,2020-03-31,145031080,128624295,273655375
14311,237,$CPLE3,2020-06-30,145031080,128624295,273655375
14311,237,$CPLE3,2020-09-30,145031080,128624295,273655375
14311,238,$CPLE6,2010-12-31,145031080,128624295,273655375
14311,238,$CPLE6,2011-03-31,145031080,128624295,273655375
14311,238,$CPLE6,2011-06-30,145031080,128624295,273655375
14311,238,$CPLE6,2011-09-30,145031080,128624295,273655375
14311,238,$CPLE6,2011-12-31,145031080,128624295,273655375
14311,238,$CPLE6,2012-03-31,145031080,128624295,273655375
14311,238,$CPLE6,2012-06-30,145031080,128624295,273655375
14311,238,$CPLE6,2012-09-30,145031080,128624295,273655375
14311,238,$CPLE6,2012-12-31,145031080,128624295,273655375
14311,238,$CPLE6,2013-03-31,145031080,128624295,273655375
14311,238,$CPLE6,2013-06-30,145031080,128624295,273655375
14311,238,$CPLE6,2013-09-30,145031080,128624295,273655375
14311,238,$CPLE6,2013-12-31,145031080,128624295,273655375
14311,238,$CPLE6,2014-03-31,145031080,128624295,273655375
14311,238,$CPLE6,2014-06-30,145031080,128624295,273655375
14311,238,$CPLE6,2014-09-30,145031080,128624295,273655375
14311,238,$CPLE6,2014-12-31,145031080,128624295,273655375
14311,238,$CPLE6,2015-03-31,145031080,128624295,273655375
14311,238,$CPLE6,2015-06-30,145031080,128624295,273655375
14311,238,$CPLE6,2015-09-30,145031080,128624295,273655375
14311,238,$CPLE6,2015-12-31,145031080,128624295,273655375
14311,238,$CPLE6,2016-03-31,145031080,128624295,273655375
14311,238,$CPLE6,2016-06-30,145031080,128624295,273655375
14311,238,$CPLE6,2016-09-30,145031080,128624295,273655375
14311,238,$CPLE6,2016-12-31,145031080,128624295,273655375
14311,238,$CPLE6,2017-03-31,145031080,128624295,273655375
14311,238,$CPLE6,2017-06-30,145031080,128624295,273655375
14311,238,$CPLE6,2017-09-30,145031080,128624295,273655375
14311,238,$CPLE6,2017-12-31,145031080,128624295,273655375
14311,238,$CPLE6,2018-03-31,145031080,128624295,273655375
14311,238,$CPLE6,2018-06-30,145031080,128624295,273655375
14311,238,$CPLE6,2018-09-30,145031080,128624295,273655375
14311,238,$CPLE6,2018-12-31,145031080,128624295,273655375
14311,238,$CPLE6,2019-03-31,145031080,128624295,273655375
14311,238,$CPLE6,2019-06-30,145031080,128624295,273655375
14311,238,$CPLE6,2019-09-30,145031080,128624295,273655375
14311,238,$CPLE6,2019-12-31,145031080,128624295,273655375
14311,238,$CPLE6,2020-03-31,145031080,128624295,273655375
14311,238,$CPLE6,2020-06-30,145031080,128624295,273655375
14311,238,$CPLE6,2020-09-30,145031080,128624295,273655375
14311,239,$CPLE4,2010-12-31,145031080,128624295,273655375
14311,239,$CPLE4,2011-03-31,145031080,128624295,273655375
14311,239,$CPLE4,2011-06-30,145031080,128624295,273655375
14311,239,$CPLE4,2011-09-30,145031080,128624295,273655375
14311,239,$CPLE4,2011-12-31,145031080,128624295,273655375
14311,239,$CPLE4,2012-03-31,145031080,128624295,273655375
14311,239,$CPLE4,2012-06-30,145031080,128624295,273655375
14311,239,$CPLE4,2012-09-30,145031080,128624295,273655375
14311,239,$CPLE4,2012-12-31,145031080,128624295,273655375
14311,239,$CPLE4,2013-03-31,145031080,128624295,273655375
14311,239,$CPLE4,2013-06-30,145031080,128624295,273655375
14311,239,$CPLE4,2013-09-30,145031080,128624295,273655375
14311,239,$CPLE4,2013-12-31,145031080,128624295,273655375
14311,239,$CPLE4,2014-03-31,145031080,128624295,273655375
14311,239,$CPLE4,2014-06-30,145031080,128624295,273655375
14311,239,$CPLE4,2014-09-30,145031080,128624295,273655375
14311,239,$CPLE4,2014-12-31,145031080,128624295,273655375
14311,239,$CPLE4,2015-03-31,145031080,128624295,273655375
14311,239,$CPLE4,2015-06-30,145031080,128624295,273655375
14311,239,$CPLE4,2015-09-30,145031080,128624295,273655375
14311,239,$CPLE4,2015-12-31,145031080,128624295,273655375
14311,239,$CPLE4,2016-03-31,145031080,128624295,273655375
14311,239,$CPLE4,2016-06-30,145031080,128624295,273655375
14311,239,$CPLE4,2016-09-30,145031080,128624295,273655375
14311,239,$CPLE4,2016-12-31,145031080,128624295,273655375
14311,239,$CPLE4,2017-03-31,145031080,128624295,273655375
14311,239,$CPLE4,2017-06-30,145031080,128624295,273655375
14311,239,$CPLE4,2017-09-30,145031080,128624295,273655375
14311,239,$CPLE4,2017-12-31,145031080,128624295,273655375
14311,239,$CPLE4,2018-03-31,145031080,128624295,273655375
14311,239,$CPLE4,2018-06-30,145031080,128624295,273655375
14311,239,$CPLE4,2018-09-30,145031080,128624295,273655375
14311,239,$CPLE4,2018-12-31,145031080,128624295,273655375
14311,239,$CPLE4,2019-03-31,145031080,128624295,273655375
14311,239,$CPLE4,2019-06-30,145031080,128624295,273655375
14311,239,$CPLE4,2019-09-30,145031080,128624295,273655375
14311,239,$CPLE4,2019-12-31,145031080,128624295,273655375
14311,239,$CPLE4,2020-03-31,145031080,128624295,273655375
14311,239,$CPLE4,2020-06-30,145031080,128624295,273655375
14311,239,$CPLE4,2020-09-30,145031080,128624295,273655375
14311,240,$CPLE5,2010-12-31,145031080,128624295,273655375
14311,240,$CPLE5,2011-03-31,145031080,128624295,273655375
14311,240,$CPLE5,2011-06-30,145031080,128624295,273655375
14311,240,$CPLE5,2011-09-30,145031080,128624295,273655375
14311,240,$CPLE5,2011-12-31,145031080,128624295,273655375
14311,240,$CPLE5,2012-03-31,145031080,128624295,273655375
14311,240,$CPLE5,2012-06-30,145031080,128624295,273655375
14311,240,$CPLE5,2012-09-30,145031080,128624295,273655375
14311,240,$CPLE5,2012-12-31,145031080,128624295,273655375
14311,240,$CPLE5,2013-03-31,145031080,128624295,273655375
14311,240,$CPLE5,2013-06-30,145031080,128624295,273655375
14311,240,$CPLE5,2013-09-30,145031080,128624295,273655375
14311,240,$CPLE5,2013-12-31,145031080,128624295,273655375
14311,240,$CPLE5,2014-03-31,145031080,128624295,273655375
14311,240,$CPLE5,2014-06-30,145031080,128624295,273655375
14311,240,$CPLE5,2014-09-30,145031080,128624295,273655375
14311,240,$CPLE5,2014-12-31,145031080,128624295,273655375
14311,240,$CPLE5,2015-03-31,145031080,128624295,273655375
14311,240,$CPLE5,2015-06-30,145031080,128624295,273655375
14311,240,$CPLE5,2015-09-30,145031080,128624295,273655375
14311,240,$CPLE5,2015-12-31,145031080,128624295,273655375
14311,240,$CPLE5,2016-03-31,145031080,128624295,273655375
14311,240,$CPLE5,2016-06-30,145031080,128624295,273655375
14311,240,$CPLE5,2016-09-30,145031080,128624295,273655375
14311,240,$CPLE5,2016-12-31,145031080,128624295,273655375
14311,240,$CPLE5,2017-03-31,145031080,128624295,273655375
14311,240,$CPLE5,2017-06-30,145031080,128624295,273655375
14311,240,$CPLE5,2017-09-30,145031080,128624295,273655375
14311,240,$CPLE5,2017-12-31,145031080,128624295,273655375
14311,240,$CPLE5,2018-03-31,145031080,128624295,273655375
14311,240,$CPLE5,2018-06-30,145031080,128624295,273655375
14311,240,$CPLE5,2018-09-30,145031080,128624295,273655375
14311,240,$CPLE5,2018-12-31,145031080,128624295,273655375
14311,240,$CPLE5,2019-03-31,145031080,128624295,273655375
14311,240,$CPLE5,2019-06-30,145031080,128624295,273655375
14311,240,$CPLE5,2019-09-30,145031080,128624295,273655375
14311,240,$CPLE5,2019-12-31,145031080,128624295,273655375
14311,240,$CPLE5,2020-03-31,145031080,128624295,273655375
14311,240,$CPLE5,2020-06-30,145031080,128624295,273655375
14311,240,$CPLE5,2020-09-30,145031080,128624295,273655375
14320,244,$USIM3,2010-12-31,505260684,508525506,1013786190
14320,244,$USIM3,2011-03-31,505260684,508525506,1013786190
14320,244,$USIM3,2011-06-30,505260684,508525506,1013786190
14320,244,$USIM3,2011-09-30,505260684,508525506,1013786190
14320,244,$USIM3,2011-12-31,505260684,508525506,1013786190
14320,244,$USIM3,2012-03-31,505260684,508525506,1013786190
14320,244,$USIM3,2012-06-30,505260684,508525506,1013786190
14320,244,$USIM3,2012-09-30,505260684,508525506,1013786190
14320,244,$USIM3,2012-12-31,505260684,508525506,1013786190
14320,244,$USIM3,2013-03-31,505260684,508525506,1013786190
14320,244,$USIM3,2013-06-30,505260684,508525506,1013786190
14320,244,$USIM3,2013-09-30,505260684,508525506,1013786190
14320,244,$USIM3,2013-12-31,505260684,508525506,1013786190
14320,244,$USIM3,2014-03-31,505260684,508525506,1013786190
14320,244,$USIM3,2014-06-30,505260684,508525506,1013786190
14320,244,$USIM3,2014-09-30,505260684,508525506,1013786190
14320,244,$USIM3,2014-12-31,505260684,508525506,1013786190
14320,244,$USIM3,2015-03-31,505260684,508525506,1013786190
14320,244,$USIM3,2015-06-30,505260684,508525506,1013786190
14320,244,$USIM3,2015-09-30,505260684,508525506,1013786190
14320,244,$USIM3,2015-12-31,505260684,508525506,1013786190
14320,244,$USIM3,2016-03-31,505260684,508525506,1013786190
14320,244,$USIM3,2016-06-30,505260684,547818424,1053079108
14320,244,$USIM3,2016-09-30,705260684,547818424,1253079108
14320,244,$USIM3,2016-12-31,705260684,547818424,1253079108
14320,244,$USIM3,2017-03-31,705260684,547818424,1253079108
14320,244,$USIM3,2017-06-30,705260684,547818424,1253079108
14320,244,$USIM3,2017-09-30,705260684,547818424,1253079108
14320,244,$USIM3,2017-12-31,705260684,547818424,1253079108
14320,244,$USIM3,2018-03-31,705260684,547818424,1253079108
14320,244,$USIM3,2018-06-30,705260684,547818424,1253079108
14320,244,$USIM3,2018-09-30,705260684,547818424,1253079108
14320,244,$USIM3,2018-12-31,705260684,547818424,1253079108
14320,244,$USIM3,2019-03-31,705260684,547818424,1253079108
14320,244,$USIM3,2019-06-30,702734028,526767025,1229501053
14320,244,$USIM3,2019-09-30,705260684,547818424,1253079108
14320,244,$USIM3,2019-12-31,705260684,547818424,1253079108
14320,244,$USIM3,2020-03-31,705260684,547818424,1253079108
14320,244,$USIM3,2020-06-30,705260684,547818424,1253079108
14320,244,$USIM3,2020-09-30,705260684,547818424,1253079108
14320,246,$USIM6,2010-12-31,505260684,508525506,1013786190
14320,246,$USIM6,2011-03-31,505260684,508525506,1013786190
14320,246,$USIM6,2011-06-30,505260684,508525506,1013786190
14320,246,$USIM6,2011-09-30,505260684,508525506,1013786190
14320,246,$USIM6,2011-12-31,505260684,508525506,1013786190
14320,246,$USIM6,2012-03-31,505260684,508525506,1013786190
14320,246,$USIM6,2012-06-30,505260684,508525506,1013786190
14320,246,$USIM6,2012-09-30,505260684,508525506,1013786190
14320,246,$USIM6,2012-12-31,505260684,508525506,1013786190
14320,246,$USIM6,2013-03-31,505260684,508525506,1013786190
14320,246,$USIM6,2013-06-30,505260684,508525506,1013786190
14320,246,$USIM6,2013-09-30,505260684,508525506,1013786190
14320,246,$USIM6,2013-12-31,505260684,508525506,1013786190
14320,246,$USIM6,2014-03-31,505260684,508525506,1013786190
14320,246,$USIM6,2014-06-30,505260684,508525506,1013786190
14320,246,$USIM6,2014-09-30,505260684,508525506,1013786190
14320,246,$USIM6,2014-12-31,505260684,508525506,1013786190
14320,246,$USIM6,2015-03-31,505260684,508525506,1013786190
14320,246,$USIM6,2015-06-30,505260684,508525506,1013786190
14320,246,$USIM6,2015-09-30,505260684,508525506,1013786190
14320,246,$USIM6,2015-12-31,505260684,508525506,1013786190
14320,246,$USIM6,2016-03-31,505260684,508525506,1013786190
14320,246,$USIM6,2016-06-30,505260684,547818424,1053079108
14320,246,$USIM6,2016-09-30,705260684,547818424,1253079108
14320,246,$USIM6,2016-12-31,705260684,547818424,1253079108
14320,246,$USIM6,2017-03-31,705260684,547818424,1253079108
14320,246,$USIM6,2017-06-30,705260684,547818424,1253079108
14320,246,$USIM6,2017-09-30,705260684,547818424,1253079108
14320,246,$USIM6,2017-12-31,705260684,547818424,1253079108
14320,246,$USIM6,2018-03-31,705260684,547818424,1253079108
14320,246,$USIM6,2018-06-30,705260684,547818424,1253079108
14320,246,$USIM6,2018-09-30,705260684,547818424,1253079108
14320,246,$USIM6,2018-12-31,705260684,547818424,1253079108
14320,246,$USIM6,2019-03-31,705260684,547818424,1253079108
14320,246,$USIM6,2019-06-30,702734028,526767025,1229501053
14320,246,$USIM6,2019-09-30,705260684,547818424,1253079108
14320,246,$USIM6,2019-12-31,705260684,547818424,1253079108
14320,246,$USIM6,2020-03-31,705260684,547818424,1253079108
14320,246,$USIM6,2020-06-30,705260684,547818424,1253079108
14320,246,$USIM6,2020-09-30,705260684,547818424,1253079108
14320,247,$USIM5,2010-12-31,505260684,508525506,1013786190
14320,247,$USIM5,2011-03-31,505260684,508525506,1013786190
14320,247,$USIM5,2011-06-30,505260684,508525506,1013786190
14320,247,$USIM5,2011-09-30,505260684,508525506,1013786190
14320,247,$USIM5,2011-12-31,505260684,508525506,1013786190
14320,247,$USIM5,2012-03-31,505260684,508525506,1013786190
14320,247,$USIM5,2012-06-30,505260684,508525506,1013786190
14320,247,$USIM5,2012-09-30,505260684,508525506,1013786190
14320,247,$USIM5,2012-12-31,505260684,508525506,1013786190
14320,247,$USIM5,2013-03-31,505260684,508525506,1013786190
14320,247,$USIM5,2013-06-30,505260684,508525506,1013786190
14320,247,$USIM5,2013-09-30,505260684,508525506,1013786190
14320,247,$USIM5,2013-12-31,505260684,508525506,1013786190
14320,247,$USIM5,2014-03-31,505260684,508525506,1013786190
14320,247,$USIM5,2014-06-30,505260684,508525506,1013786190
14320,247,$USIM5,2014-09-30,505260684,508525506,1013786190
14320,247,$USIM5,2014-12-31,505260684,508525506,1013786190
14320,247,$USIM5,2015-03-31,505260684,508525506,1013786190
14320,247,$USIM5,2015-06-30,505260684,508525506,1013786190
14320,247,$USIM5,2015-09-30,505260684,508525506,1013786190
14320,247,$USIM5,2015-12-31,505260684,508525506,1013786190
14320,247,$USIM5,2016-03-31,505260684,508525506,1013786190
14320,247,$USIM5,2016-06-30,505260684,547818424,1053079108
14320,247,$USIM5,2016-09-30,705260684,547818424,1253079108
14320,247,$USIM5,2016-12-31,705260684,547818424,1253079108
14320,247,$USIM5,2017-03-31,705260684,547818424,1253079108
14320,247,$USIM5,2017-06-30,705260684,547818424,1253079108
14320,247,$USIM5,2017-09-30,705260684,547818424,1253079108
14320,247,$USIM5,2017-12-31,705260684,547818424,1253079108
14320,247,$USIM5,2018-03-31,705260684,547818424,1253079108
14320,247,$USIM5,2018-06-30,705260684,547818424,1253079108
14320,247,$USIM5,2018-09-30,705260684,547818424,1253079108
14320,247,$USIM5,2018-12-31,705260684,547818424,1253079108
14320,247,$USIM5,2019-03-31,705260684,547818424,1253079108
14320,247,$USIM5,2019-06-30,702734028,526767025,1229501053
14320,247,$USIM5,2019-09-30,705260684,547818424,1253079108
14320,247,$USIM5,2019-12-31,705260684,547818424,1253079108
14320,247,$USIM5,2020-03-31,705260684,547818424,1253079108
14320,247,$USIM5,2020-06-30,705260684,547818424,1253079108
14320,247,$USIM5,2020-09-30,705260684,547818424,1253079108
14346,232,$WHRL3,2010-12-31,1028701,474085,1502786
14346,232,$WHRL3,2011-03-31,1028701,474085,1502786
14346,232,$WHRL3,2011-06-30,1028701,474085,1502786
14346,232,$WHRL3,2011-09-30,1028701,474085,1502786
14346,232,$WHRL3,2011-12-31,1028701,474085,1502786
14346,232,$WHRL3,2012-03-31,1028701,474085,1502786
14346,232,$WHRL3,2012-06-30,1028701,474085,1502786
14346,232,$WHRL3,2012-09-30,1028701,474085,1502786
14346,232,$WHRL3,2012-12-31,1028701,474085,1502786
14346,232,$WHRL3,2013-03-31,1028701,474085,1502786
14346,232,$WHRL3,2013-06-30,1028701,474085,1502786
14346,232,$WHRL3,2013-09-30,1028701,474085,1502786
14346,232,$WHRL3,2013-12-31,1028701,474085,1502786
14346,232,$WHRL3,2014-03-31,1028701,474085,1502786
14346,232,$WHRL3,2014-06-30,1028701,474085,1502786
14346,232,$WHRL3,2014-09-30,1028701,474085,1502786
14346,232,$WHRL3,2014-12-31,1028701,474085,1502786
14346,232,$WHRL3,2015-03-31,1028701,474085,1502786
14346,232,$WHRL3,2015-06-30,1028701,474085,1502786
14346,232,$WHRL3,2015-09-30,1028701,474085,1502786
14346,232,$WHRL3,2015-12-31,1028701,474085,1502786
14346,232,$WHRL3,2016-03-31,1028701,474085,1502786
14346,232,$WHRL3,2016-06-30,1028701,474085,1502786
14346,232,$WHRL3,2016-09-30,1028701,474085,1502786
14346,232,$WHRL3,2016-12-31,1028701,474085,1502786
14346,232,$WHRL3,2017-03-31,1028701,474085,1502786
14346,232,$WHRL3,2017-06-30,1028701,474085,1502786
14346,232,$WHRL3,2017-09-30,1028701,474085,1502786
14346,232,$WHRL3,2017-12-31,1028701,474085,1502786
14346,232,$WHRL3,2018-03-31,1028701,474085,1502786
14346,232,$WHRL3,2018-06-30,1028701,474085,1502786
14346,232,$WHRL3,2018-09-30,1028701,474085,1502786
14346,232,$WHRL3,2018-12-31,1028701,474085,1502786
14346,232,$WHRL3,2019-03-31,1028701,474085,1502786
14346,232,$WHRL3,2019-06-30,1028701,474085,1502786
14346,232,$WHRL3,2019-09-30,1028701,474084,1502785
14346,232,$WHRL3,2019-12-31,1028701,474084,1502785
14346,232,$WHRL3,2020-03-31,1028701,474084,1502785
14346,232,$WHRL3,2020-06-30,1028701,474084,1502785
14346,232,$WHRL3,2020-09-30,1028701,474085,1502786
14346,233,$WHRL4,2010-12-31,1028701,474085,1502786
14346,233,$WHRL4,2011-03-31,1028701,474085,1502786
14346,233,$WHRL4,2011-06-30,1028701,474085,1502786
14346,233,$WHRL4,2011-09-30,1028701,474085,1502786
14346,233,$WHRL4,2011-12-31,1028701,474085,1502786
14346,233,$WHRL4,2012-03-31,1028701,474085,1502786
14346,233,$WHRL4,2012-06-30,1028701,474085,1502786
14346,233,$WHRL4,2012-09-30,1028701,474085,1502786
14346,233,$WHRL4,2012-12-31,1028701,474085,1502786
14346,233,$WHRL4,2013-03-31,1028701,474085,1502786
14346,233,$WHRL4,2013-06-30,1028701,474085,1502786
14346,233,$WHRL4,2013-09-30,1028701,474085,1502786
14346,233,$WHRL4,2013-12-31,1028701,474085,1502786
14346,233,$WHRL4,2014-03-31,1028701,474085,1502786
14346,233,$WHRL4,2014-06-30,1028701,474085,1502786
14346,233,$WHRL4,2014-09-30,1028701,474085,1502786
14346,233,$WHRL4,2014-12-31,1028701,474085,1502786
14346,233,$WHRL4,2015-03-31,1028701,474085,1502786
14346,233,$WHRL4,2015-06-30,1028701,474085,1502786
14346,233,$WHRL4,2015-09-30,1028701,474085,1502786
14346,233,$WHRL4,2015-12-31,1028701,474085,1502786
14346,233,$WHRL4,2016-03-31,1028701,474085,1502786
14346,233,$WHRL4,2016-06-30,1028701,474085,1502786
14346,233,$WHRL4,2016-09-30,1028701,474085,1502786
14346,233,$WHRL4,2016-12-31,1028701,474085,1502786
14346,233,$WHRL4,2017-03-31,1028701,474085,1502786
14346,233,$WHRL4,2017-06-30,1028701,474085,1502786
14346,233,$WHRL4,2017-09-30,1028701,474085,1502786
14346,233,$WHRL4,2017-12-31,1028701,474085,1502786
14346,233,$WHRL4,2018-03-31,1028701,474085,1502786
14346,233,$WHRL4,2018-06-30,1028701,474085,1502786
14346,233,$WHRL4,2018-09-30,1028701,474085,1502786
14346,233,$WHRL4,2018-12-31,1028701,474085,1502786
14346,233,$WHRL4,2019-03-31,1028701,474085,1502786
14346,233,$WHRL4,2019-06-30,1028701,474085,1502786
14346,233,$WHRL4,2019-09-30,1028701,474084,1502785
14346,233,$WHRL4,2019-12-31,1028701,474084,1502785
14346,233,$WHRL4,2020-03-31,1028701,474084,1502785
14346,233,$WHRL4,2020-06-30,1028701,474084,1502785
14346,233,$WHRL4,2020-09-30,1028701,474085,1502786
14362,226,$CEPE3,2010-12-31,66303,8309,74612
14362,226,$CEPE3,2011-03-31,66303,8309,74612
14362,226,$CEPE3,2011-06-30,66303,8309,74612
14362,226,$CEPE3,2011-09-30,66303,8309,74612
14362,226,$CEPE3,2011-12-31,66303,8309,74612
14362,226,$CEPE3,2012-03-31,66303,8309,74612
14362,226,$CEPE3,2012-06-30,66303,8309,74612
14362,226,$CEPE3,2012-09-30,66303,8309,74612
14362,226,$CEPE3,2012-12-31,66303,8309,74612
14362,226,$CEPE3,2013-03-31,66303,8309,74612
14362,226,$CEPE3,2013-06-30,66303,8309,74612
14362,226,$CEPE3,2013-09-30,66303,8309,74612
14362,226,$CEPE3,2013-12-31,66303,8309,74612
14362,226,$CEPE3,2014-03-31,66303,8309,74612
14362,226,$CEPE3,2014-06-30,66303,8309,74612
14362,226,$CEPE3,2014-09-30,66303,8309,74612
14362,226,$CEPE3,2014-12-31,66303,8309,74612
14362,226,$CEPE3,2015-03-31,66303,8309,74612
14362,226,$CEPE3,2015-06-30,66303,8309,74612
14362,226,$CEPE3,2015-09-30,66303,8309,74612
14362,226,$CEPE3,2015-12-31,66303,8309,74612
14362,226,$CEPE3,2016-03-31,66303,8309,74612
14362,226,$CEPE3,2016-06-30,66303,8309,74612
14362,226,$CEPE3,2016-09-30,66303,8309,74612
14362,226,$CEPE3,2016-12-31,66303,8309,74612
14362,226,$CEPE3,2017-03-31,66303,8309,74612
14362,226,$CEPE3,2017-06-30,66303,8309,74612
14362,226,$CEPE3,2017-09-30,66303,8309,74612
14362,226,$CEPE3,2017-12-31,66303,8309,74612
14362,226,$CEPE3,2018-03-31,66303,8309,74612
14362,226,$CEPE3,2018-06-30,66303,8309,74612
14362,226,$CEPE3,2018-09-30,66303,8309,74612
14362,226,$CEPE3,2018-12-31,66303,8309,74612
14362,226,$CEPE3,2019-03-31,66303,8309,74612
14362,226,$CEPE3,2019-06-30,66303,8309,74612
14362,226,$CEPE3,2019-09-30,66303,8309,74612
14362,226,$CEPE3,2019-12-31,66303,8309,74612
14362,226,$CEPE3,2020-03-31,66303,8309,74612
14362,226,$CEPE3,2020-06-30,66303,8309,74612
14362,226,$CEPE3,2020-09-30,66303,8309,74612
14362,227,$CEPE5,2010-12-31,66303,8309,74612
14362,227,$CEPE5,2011-03-31,66303,8309,74612
14362,227,$CEPE5,2011-06-30,66303,8309,74612
14362,227,$CEPE5,2011-09-30,66303,8309,74612
14362,227,$CEPE5,2011-12-31,66303,8309,74612
14362,227,$CEPE5,2012-03-31,66303,8309,74612
14362,227,$CEPE5,2012-06-30,66303,8309,74612
14362,227,$CEPE5,2012-09-30,66303,8309,74612
14362,227,$CEPE5,2012-12-31,66303,8309,74612
14362,227,$CEPE5,2013-03-31,66303,8309,74612
14362,227,$CEPE5,2013-06-30,66303,8309,74612
14362,227,$CEPE5,2013-09-30,66303,8309,74612
14362,227,$CEPE5,2013-12-31,66303,8309,74612
14362,227,$CEPE5,2014-03-31,66303,8309,74612
14362,227,$CEPE5,2014-06-30,66303,8309,74612
14362,227,$CEPE5,2014-09-30,66303,8309,74612
14362,227,$CEPE5,2014-12-31,66303,8309,74612
14362,227,$CEPE5,2015-03-31,66303,8309,74612
14362,227,$CEPE5,2015-06-30,66303,8309,74612
14362,227,$CEPE5,2015-09-30,66303,8309,74612
14362,227,$CEPE5,2015-12-31,66303,8309,74612
14362,227,$CEPE5,2016-03-31,66303,8309,74612
14362,227,$CEPE5,2016-06-30,66303,8309,74612
14362,227,$CEPE5,2016-09-30,66303,8309,74612
14362,227,$CEPE5,2016-12-31,66303,8309,74612
14362,227,$CEPE5,2017-03-31,66303,8309,74612
14362,227,$CEPE5,2017-06-30,66303,8309,74612
14362,227,$CEPE5,2017-09-30,66303,8309,74612
14362,227,$CEPE5,2017-12-31,66303,8309,74612
14362,227,$CEPE5,2018-03-31,66303,8309,74612
14362,227,$CEPE5,2018-06-30,66303,8309,74612
14362,227,$CEPE5,2018-09-30,66303,8309,74612
14362,227,$CEPE5,2018-12-31,66303,8309,74612
14362,227,$CEPE5,2019-03-31,66303,8309,74612
14362,227,$CEPE5,2019-06-30,66303,8309,74612
14362,227,$CEPE5,2019-09-30,66303,8309,74612
14362,227,$CEPE5,2019-12-31,66303,8309,74612
14362,227,$CEPE5,2020-03-31,66303,8309,74612
14362,227,$CEPE5,2020-06-30,66303,8309,74612
14362,227,$CEPE5,2020-09-30,66303,8309,74612
14362,228,$CEPE6,2010-12-31,66303,8309,74612
14362,228,$CEPE6,2011-03-31,66303,8309,74612
14362,228,$CEPE6,2011-06-30,66303,8309,74612
14362,228,$CEPE6,2011-09-30,66303,8309,74612
14362,228,$CEPE6,2011-12-31,66303,8309,74612
14362,228,$CEPE6,2012-03-31,66303,8309,74612
14362,228,$CEPE6,2012-06-30,66303,8309,74612
14362,228,$CEPE6,2012-09-30,66303,8309,74612
14362,228,$CEPE6,2012-12-31,66303,8309,74612
14362,228,$CEPE6,2013-03-31,66303,8309,74612
14362,228,$CEPE6,2013-06-30,66303,8309,74612
14362,228,$CEPE6,2013-09-30,66303,8309,74612
14362,228,$CEPE6,2013-12-31,66303,8309,74612
14362,228,$CEPE6,2014-03-31,66303,8309,74612
14362,228,$CEPE6,2014-06-30,66303,8309,74612
14362,228,$CEPE6,2014-09-30,66303,8309,74612
14362,228,$CEPE6,2014-12-31,66303,8309,74612
14362,228,$CEPE6,2015-03-31,66303,8309,74612
14362,228,$CEPE6,2015-06-30,66303,8309,74612
14362,228,$CEPE6,2015-09-30,66303,8309,74612
14362,228,$CEPE6,2015-12-31,66303,8309,74612
14362,228,$CEPE6,2016-03-31,66303,8309,74612
14362,228,$CEPE6,2016-06-30,66303,8309,74612
14362,228,$CEPE6,2016-09-30,66303,8309,74612
14362,228,$CEPE6,2016-12-31,66303,8309,74612
14362,228,$CEPE6,2017-03-31,66303,8309,74612
14362,228,$CEPE6,2017-06-30,66303,8309,74612
14362,228,$CEPE6,2017-09-30,66303,8309,74612
14362,228,$CEPE6,2017-12-31,66303,8309,74612
14362,228,$CEPE6,2018-03-31,66303,8309,74612
14362,228,$CEPE6,2018-06-30,66303,8309,74612
14362,228,$CEPE6,2018-09-30,66303,8309,74612
14362,228,$CEPE6,2018-12-31,66303,8309,74612
14362,228,$CEPE6,2019-03-31,66303,8309,74612
14362,228,$CEPE6,2019-06-30,66303,8309,74612
14362,228,$CEPE6,2019-09-30,66303,8309,74612
14362,228,$CEPE6,2019-12-31,66303,8309,74612
14362,228,$CEPE6,2020-03-31,66303,8309,74612
14362,228,$CEPE6,2020-06-30,66303,8309,74612
14362,228,$CEPE6,2020-09-30,66303,8309,74612
14443,236,$SBSP3,2010-12-31,227836,0,227836
14443,236,$SBSP3,2011-03-31,227836623,0,227836623
14443,236,$SBSP3,2011-06-30,227836623,0,227836623
14443,236,$SBSP3,2011-09-30,227836623,0,227836623
14443,236,$SBSP3,2011-12-31,227836,0,227836
14443,236,$SBSP3,2012-03-31,227836623,0,227836623
14443,236,$SBSP3,2012-06-30,227836623,0,227836623
14443,236,$SBSP3,2012-09-30,227836623,0,227836623
14443,236,$SBSP3,2012-12-31,227836623,0,227836623
14443,236,$SBSP3,2013-03-31,683509869,0,683509869
14443,236,$SBSP3,2013-06-30,683509869,0,683509869
14443,236,$SBSP3,2013-09-30,683509869,0,683509869
14443,236,$SBSP3,2013-12-31,683509869,0,683509869
14443,236,$SBSP3,2014-03-31,683509869,0,683509869
14443,236,$SBSP3,2014-06-30,683509869,0,683509869
14443,236,$SBSP3,2014-09-30,683509869,0,683509869
14443,236,$SBSP3,2014-12-31,683509869,0,683509869
14443,236,$SBSP3,2015-03-31,683509869,0,683509869
14443,236,$SBSP3,2015-06-30,683509869,0,683509869
14443,236,$SBSP3,2015-09-30,683509869,0,683509869
14443,236,$SBSP3,2015-12-31,683509869,0,683509869
14443,236,$SBSP3,2016-03-31,683509869,0,683509869
14443,236,$SBSP3,2016-06-30,683509869,0,683509869
14443,236,$SBSP3,2016-09-30,683509869,0,683509869
14443,236,$SBSP3,2016-12-31,683509869,0,683509869
14443,236,$SBSP3,2017-03-31,683509869,0,683509869
14443,236,$SBSP3,2017-06-30,683509869,0,683509869
14443,236,$SBSP3,2017-09-30,683509869,0,683509869
14443,236,$SBSP3,2017-12-31,683509869,0,683509869
14443,236,$SBSP3,2018-03-31,683509869,0,683509869
14443,236,$SBSP3,2018-06-30,683509869,0,683509869
14443,236,$SBSP3,2018-09-30,683509869,0,683509869
14443,236,$SBSP3,2018-12-31,683509869,0,683509869
14443,236,$SBSP3,2019-03-31,683509869,0,683509869
14443,236,$SBSP3,2019-06-30,683509869,0,683509869
14443,236,$SBSP3,2019-09-30,683509869,0,683509869
14443,236,$SBSP3,2019-12-31,683509869,0,683509869
14443,236,$SBSP3,2020-03-31,683509869,0,683509869
14443,236,$SBSP3,2020-06-30,683509869,0,683509869
14443,236,$SBSP3,2020-09-30,683509869,0,683509869
14451,253,$CEBR3,2010-12-31,4576,4607,9183
14451,253,$CEBR3,2011-03-31,4576,4607,9183
14451,253,$CEBR3,2011-06-30,4576,4607,9183
14451,253,$CEBR3,2011-09-30,4576,4607,9183
14451,253,$CEBR3,2011-12-31,4576432,4607026,9183458
14451,253,$CEBR3,2012-03-31,4576432,4607026,9183458
14451,253,$CEBR3,2012-06-30,4576432,4607026,9183458
14451,253,$CEBR3,2012-09-30,4576432,4607026,9183458
14451,253,$CEBR3,2012-12-31,4576432,4607026,9183458
14451,253,$CEBR3,2013-03-31,4576432,4607026,9183458
14451,253,$CEBR3,2013-06-30,4576432,4607026,9183458
14451,253,$CEBR3,2013-09-30,4576432,4607026,9183458
14451,253,$CEBR3,2013-12-31,4576432,4607026,9183458
14451,253,$CEBR3,2014-03-31,4576432,4607026,9183458
14451,253,$CEBR3,2014-06-30,4576432,4607026,9183458
14451,253,$CEBR3,2014-09-30,4576432,4607026,9183458
14451,253,$CEBR3,2014-12-31,4576432,4607026,9183458
14451,253,$CEBR3,2015-03-31,4576432,4607026,9183458
14451,253,$CEBR3,2015-06-30,4576432,4607026,9183458
14451,253,$CEBR3,2015-09-30,7184178,7232205,14416383
14451,253,$CEBR3,2015-12-31,7184187,7232196,14416383
14451,253,$CEBR3,2016-03-31,7184187,7232196,14416383
14451,253,$CEBR3,2016-06-30,7184187,7232196,14416383
14451,253,$CEBR3,2016-09-30,7184178,7232205,14416383
14451,253,$CEBR3,2016-12-31,7184178,7232205,14416383
14451,253,$CEBR3,2017-03-31,7184178,7232205,14416383
14451,253,$CEBR3,2017-06-30,7184187,7232196,14416383
14451,253,$CEBR3,2017-09-30,7184187,7232196,14416383
14451,253,$CEBR3,2017-12-31,7184178,7232205,14416383
14451,253,$CEBR3,2018-03-31,7184178,7232205,14416383
14451,253,$CEBR3,2018-06-30,7184178,7232205,14416383
14451,253,$CEBR3,2018-09-30,7184178,7232205,14416383
14451,253,$CEBR3,2018-12-31,7184178,7232205,14416383
14451,253,$CEBR3,2019-03-31,7184178,7232205,14416383
14451,253,$CEBR3,2019-06-30,7184178,7232205,14416383
14451,253,$CEBR3,2019-09-30,7184178,7232205,14416383
14451,253,$CEBR3,2019-12-31,7184178,7232205,14416383
14451,253,$CEBR3,2020-03-31,7184178,7232205,14416383
14451,253,$CEBR3,2020-06-30,7184178,7232205,14416383
14451,253,$CEBR3,2020-09-30,7184178,7232205,14416383
14451,254,$CEBR5,2010-12-31,4576,4607,9183
14451,254,$CEBR5,2011-03-31,4576,4607,9183
14451,254,$CEBR5,2011-06-30,4576,4607,9183
14451,254,$CEBR5,2011-09-30,4576,4607,9183
14451,254,$CEBR5,2011-12-31,4576432,4607026,9183458
14451,254,$CEBR5,2012-03-31,4576432,4607026,9183458
14451,254,$CEBR5,2012-06-30,4576432,4607026,9183458
14451,254,$CEBR5,2012-09-30,4576432,4607026,9183458
14451,254,$CEBR5,2012-12-31,4576432,4607026,9183458
14451,254,$CEBR5,2013-03-31,4576432,4607026,9183458
14451,254,$CEBR5,2013-06-30,4576432,4607026,9183458
14451,254,$CEBR5,2013-09-30,4576432,4607026,9183458
14451,254,$CEBR5,2013-12-31,4576432,4607026,9183458
14451,254,$CEBR5,2014-03-31,4576432,4607026,9183458
14451,254,$CEBR5,2014-06-30,4576432,4607026,9183458
14451,254,$CEBR5,2014-09-30,4576432,4607026,9183458
14451,254,$CEBR5,2014-12-31,4576432,4607026,9183458
14451,254,$CEBR5,2015-03-31,4576432,4607026,9183458
14451,254,$CEBR5,2015-06-30,4576432,4607026,9183458
14451,254,$CEBR5,2015-09-30,7184178,7232205,14416383
14451,254,$CEBR5,2015-12-31,7184187,7232196,14416383
14451,254,$CEBR5,2016-03-31,7184187,7232196,14416383
14451,254,$CEBR5,2016-06-30,7184187,7232196,14416383
14451,254,$CEBR5,2016-09-30,7184178,7232205,14416383
14451,254,$CEBR5,2016-12-31,7184178,7232205,14416383
14451,254,$CEBR5,2017-03-31,7184178,7232205,14416383
14451,254,$CEBR5,2017-06-30,7184187,7232196,14416383
14451,254,$CEBR5,2017-09-30,7184187,7232196,14416383
14451,254,$CEBR5,2017-12-31,7184178,7232205,14416383
14451,254,$CEBR5,2018-03-31,7184178,7232205,14416383
14451,254,$CEBR5,2018-06-30,7184178,7232205,14416383
14451,254,$CEBR5,2018-09-30,7184178,7232205,14416383
14451,254,$CEBR5,2018-12-31,7184178,7232205,14416383
14451,254,$CEBR5,2019-03-31,7184178,7232205,14416383
14451,254,$CEBR5,2019-06-30,7184178,7232205,14416383
14451,254,$CEBR5,2019-09-30,7184178,7232205,14416383
14451,254,$CEBR5,2019-12-31,7184178,7232205,14416383
14451,254,$CEBR5,2020-03-31,7184178,7232205,14416383
14451,254,$CEBR5,2020-06-30,7184178,7232205,14416383
14451,254,$CEBR5,2020-09-30,7184178,7232205,14416383
14451,255,$CEBR6,2010-12-31,4576,4607,9183
14451,255,$CEBR6,2011-03-31,4576,4607,9183
14451,255,$CEBR6,2011-06-30,4576,4607,9183
14451,255,$CEBR6,2011-09-30,4576,4607,9183
14451,255,$CEBR6,2011-12-31,4576432,4607026,9183458
14451,255,$CEBR6,2012-03-31,4576432,4607026,9183458
14451,255,$CEBR6,2012-06-30,4576432,4607026,9183458
14451,255,$CEBR6,2012-09-30,4576432,4607026,9183458
14451,255,$CEBR6,2012-12-31,4576432,4607026,9183458
14451,255,$CEBR6,2013-03-31,4576432,4607026,9183458
14451,255,$CEBR6,2013-06-30,4576432,4607026,9183458
14451,255,$CEBR6,2013-09-30,4576432,4607026,9183458
14451,255,$CEBR6,2013-12-31,4576432,4607026,9183458
14451,255,$CEBR6,2014-03-31,4576432,4607026,9183458
14451,255,$CEBR6,2014-06-30,4576432,4607026,9183458
14451,255,$CEBR6,2014-09-30,4576432,4607026,9183458
14451,255,$CEBR6,2014-12-31,4576432,4607026,9183458
14451,255,$CEBR6,2015-03-31,4576432,4607026,9183458
14451,255,$CEBR6,2015-06-30,4576432,4607026,9183458
14451,255,$CEBR6,2015-09-30,7184178,7232205,14416383
14451,255,$CEBR6,2015-12-31,7184187,7232196,14416383
14451,255,$CEBR6,2016-03-31,7184187,7232196,14416383
14451,255,$CEBR6,2016-06-30,7184187,7232196,14416383
14451,255,$CEBR6,2016-09-30,7184178,7232205,14416383
14451,255,$CEBR6,2016-12-31,7184178,7232205,14416383
14451,255,$CEBR6,2017-03-31,7184178,7232205,14416383
14451,255,$CEBR6,2017-06-30,7184187,7232196,14416383
14451,255,$CEBR6,2017-09-30,7184187,7232196,14416383
14451,255,$CEBR6,2017-12-31,7184178,7232205,14416383
14451,255,$CEBR6,2018-03-31,7184178,7232205,14416383
14451,255,$CEBR6,2018-06-30,7184178,7232205,14416383
14451,255,$CEBR6,2018-09-30,7184178,7232205,14416383
14451,255,$CEBR6,2018-12-31,7184178,7232205,14416383
14451,255,$CEBR6,2019-03-31,7184178,7232205,14416383
14451,255,$CEBR6,2019-06-30,7184178,7232205,14416383
14451,255,$CEBR6,2019-09-30,7184178,7232205,14416383
14451,255,$CEBR6,2019-12-31,7184178,7232205,14416383
14451,255,$CEBR6,2020-03-31,7184178,7232205,14416383
14451,255,$CEBR6,2020-06-30,7184178,7232205,14416383
14451,255,$CEBR6,2020-09-30,7184178,7232205,14416383
14460,265,$CYRE3,2010-12-31,423004,0,423004
14460,265,$CYRE3,2011-03-31,423004,0,423004
14460,265,$CYRE3,2011-06-30,423004,0,423004
14460,265,$CYRE3,2011-09-30,423004,0,423004
14460,265,$CYRE3,2011-12-31,423004,0,423004
14460,265,$CYRE3,2012-03-31,423004,0,423004
14460,265,$CYRE3,2012-06-30,416659,0,416659
14460,265,$CYRE3,2012-09-30,416659,0,416659
14460,265,$CYRE3,2012-12-31,416659,0,416659
14460,265,$CYRE3,2013-03-31,416659,0,416659
14460,265,$CYRE3,2013-06-30,416659,0,416659
14460,265,$CYRE3,2013-09-30,416659,0,416659
14460,265,$CYRE3,2013-12-31,416659,0,416659
14460,265,$CYRE3,2014-03-31,416859,0,416859
14460,265,$CYRE3,2014-06-30,399743,0,399743
14460,265,$CYRE3,2014-09-30,399743,0,399743
14460,265,$CYRE3,2014-12-31,399743,0,399743
14460,265,$CYRE3,2015-03-31,399743,0,399743
14460,265,$CYRE3,2015-06-30,399743,0,399743
14460,265,$CYRE3,2015-09-30,399743,0,399743
14460,265,$CYRE3,2015-12-31,399743,0,399743
14460,265,$CYRE3,2016-03-31,399743,0,399743
14460,265,$CYRE3,2016-06-30,399743,0,399743
14460,265,$CYRE3,2016-09-30,399743,0,399743
14460,265,$CYRE3,2016-12-31,399743,0,399743
14460,265,$CYRE3,2017-03-31,399743,0,399743
14460,265,$CYRE3,2017-06-30,399743,0,399743
14460,265,$CYRE3,2017-09-30,399743,0,399743
14460,265,$CYRE3,2017-12-31,399743,0,399743
14460,265,$CYRE3,2018-03-31,399743,0,399743
14460,265,$CYRE3,2018-06-30,399743,0,399743
14460,265,$CYRE3,2018-09-30,399743,0,399743
14460,265,$CYRE3,2018-12-31,399815,0,399815
14460,265,$CYRE3,2019-03-31,399743,0,399743
14460,265,$CYRE3,2019-06-30,399743,0,399743
14460,265,$CYRE3,2019-09-30,399743,0,399743
14460,265,$CYRE3,2019-12-31,399743,0,399743
14460,265,$CYRE3,2020-03-31,399743,0,399743
14460,265,$CYRE3,2020-06-30,399743,0,399743
14460,265,$CYRE3,2020-09-30,399743,0,399743
14524,250,$CEEB3,2010-12-31,109304,78873,188177
14524,250,$CEEB3,2011-03-31,109304,78873,188177
14524,250,$CEEB3,2011-06-30,109304,78873,188177
14524,250,$CEEB3,2011-09-30,109304,78873,188177
14524,250,$CEEB3,2011-12-31,109304,78873,188177
14524,250,$CEEB3,2012-03-31,109304,78873,188177
14524,250,$CEEB3,2012-06-30,109304,78873,188177
14524,250,$CEEB3,2012-09-30,109304,78873,188177
14524,250,$CEEB3,2012-12-31,109304,78873,188177
14524,250,$CEEB3,2013-03-31,109304,78873,188177
14524,250,$CEEB3,2013-06-30,109304,78873,188177
14524,250,$CEEB3,2013-09-30,109304,78873,188177
14524,250,$CEEB3,2013-12-31,109304,78873,188177
14524,250,$CEEB3,2014-03-31,109304,78873,188177
14524,250,$CEEB3,2014-06-30,109304,78873,188177
14524,250,$CEEB3,2014-09-30,109304,78873,188177
14524,250,$CEEB3,2014-12-31,109304,78873,188177
14524,250,$CEEB3,2015-03-31,109304,78873,188177
14524,250,$CEEB3,2015-06-30,109304,78873,188177
14524,250,$CEEB3,2015-09-30,109304,78873,188177
14524,250,$CEEB3,2015-12-31,109304,78873,188177
14524,250,$CEEB3,2016-03-31,109304,78873,188177
14524,250,$CEEB3,2016-06-30,109304,78873,188177
14524,250,$CEEB3,2016-09-30,109304,78873,188177
14524,250,$CEEB3,2016-12-31,109304,78873,188177
14524,250,$CEEB3,2017-03-31,109304,78873,188177
14524,250,$CEEB3,2017-06-30,109304,78873,188177
14524,250,$CEEB3,2017-09-30,109304,78873,188177
14524,250,$CEEB3,2017-12-31,118498,85512,204010
14524,250,$CEEB3,2018-03-31,135762,98178,233940
14524,250,$CEEB3,2018-06-30,135762,98178,233940
14524,250,$CEEB3,2018-09-30,151997,110098,262095
14524,250,$CEEB3,2018-12-31,151997,110098,262095
14524,250,$CEEB3,2019-03-31,151997,110098,262095
14524,250,$CEEB3,2019-06-30,151997,110098,262095
14524,250,$CEEB3,2019-09-30,151997,110098,262095
14524,250,$CEEB3,2019-12-31,151997,110098,262095
14524,250,$CEEB3,2020-03-31,151997,110098,262095
14524,250,$CEEB3,2020-06-30,151997,110098,262095
14524,250,$CEEB3,2020-09-30,151997,110098,262095
14524,251,$CEEB5,2010-12-31,109304,78873,188177
14524,251,$CEEB5,2011-03-31,109304,78873,188177
14524,251,$CEEB5,2011-06-30,109304,78873,188177
14524,251,$CEEB5,2011-09-30,109304,78873,188177
14524,251,$CEEB5,2011-12-31,109304,78873,188177
14524,251,$CEEB5,2012-03-31,109304,78873,188177
14524,251,$CEEB5,2012-06-30,109304,78873,188177
14524,251,$CEEB5,2012-09-30,109304,78873,188177
14524,251,$CEEB5,2012-12-31,109304,78873,188177
14524,251,$CEEB5,2013-03-31,109304,78873,188177
14524,251,$CEEB5,2013-06-30,109304,78873,188177
14524,251,$CEEB5,2013-09-30,109304,78873,188177
14524,251,$CEEB5,2013-12-31,109304,78873,188177
14524,251,$CEEB5,2014-03-31,109304,78873,188177
14524,251,$CEEB5,2014-06-30,109304,78873,188177
14524,251,$CEEB5,2014-09-30,109304,78873,188177
14524,251,$CEEB5,2014-12-31,109304,78873,188177
14524,251,$CEEB5,2015-03-31,109304,78873,188177
14524,251,$CEEB5,2015-06-30,109304,78873,188177
14524,251,$CEEB5,2015-09-30,109304,78873,188177
14524,251,$CEEB5,2015-12-31,109304,78873,188177
14524,251,$CEEB5,2016-03-31,109304,78873,188177
14524,251,$CEEB5,2016-06-30,109304,78873,188177
14524,251,$CEEB5,2016-09-30,109304,78873,188177
14524,251,$CEEB5,2016-12-31,109304,78873,188177
14524,251,$CEEB5,2017-03-31,109304,78873,188177
14524,251,$CEEB5,2017-06-30,109304,78873,188177
14524,251,$CEEB5,2017-09-30,109304,78873,188177
14524,251,$CEEB5,2017-12-31,118498,85512,204010
14524,251,$CEEB5,2018-03-31,135762,98178,233940
14524,251,$CEEB5,2018-06-30,135762,98178,233940
14524,251,$CEEB5,2018-09-30,151997,110098,262095
14524,251,$CEEB5,2018-12-31,151997,110098,262095
14524,251,$CEEB5,2019-03-31,151997,110098,262095
14524,251,$CEEB5,2019-06-30,151997,110098,262095
14524,251,$CEEB5,2019-09-30,151997,110098,262095
14524,251,$CEEB5,2019-12-31,151997,110098,262095
14524,251,$CEEB5,2020-03-31,151997,110098,262095
14524,251,$CEEB5,2020-06-30,151997,110098,262095
14524,251,$CEEB5,2020-09-30,151997,110098,262095
14524,252,$CEEB6,2010-12-31,109304,78873,188177
14524,252,$CEEB6,2011-03-31,109304,78873,188177
14524,252,$CEEB6,2011-06-30,109304,78873,188177
14524,252,$CEEB6,2011-09-30,109304,78873,188177
14524,252,$CEEB6,2011-12-31,109304,78873,188177
14524,252,$CEEB6,2012-03-31,109304,78873,188177
14524,252,$CEEB6,2012-06-30,109304,78873,188177
14524,252,$CEEB6,2012-09-30,109304,78873,188177
14524,252,$CEEB6,2012-12-31,109304,78873,188177
14524,252,$CEEB6,2013-03-31,109304,78873,188177
14524,252,$CEEB6,2013-06-30,109304,78873,188177
14524,252,$CEEB6,2013-09-30,109304,78873,188177
14524,252,$CEEB6,2013-12-31,109304,78873,188177
14524,252,$CEEB6,2014-03-31,109304,78873,188177
14524,252,$CEEB6,2014-06-30,109304,78873,188177
14524,252,$CEEB6,2014-09-30,109304,78873,188177
14524,252,$CEEB6,2014-12-31,109304,78873,188177
14524,252,$CEEB6,2015-03-31,109304,78873,188177
14524,252,$CEEB6,2015-06-30,109304,78873,188177
14524,252,$CEEB6,2015-09-30,109304,78873,188177
14524,252,$CEEB6,2015-12-31,109304,78873,188177
14524,252,$CEEB6,2016-03-31,109304,78873,188177
14524,252,$CEEB6,2016-06-30,109304,78873,188177
14524,252,$CEEB6,2016-09-30,109304,78873,188177
14524,252,$CEEB6,2016-12-31,109304,78873,188177
14524,252,$CEEB6,2017-03-31,109304,78873,188177
14524,252,$CEEB6,2017-06-30,109304,78873,188177
14524,252,$CEEB6,2017-09-30,109304,78873,188177
14524,252,$CEEB6,2017-12-31,118498,85512,204010
14524,252,$CEEB6,2018-03-31,135762,98178,233940
14524,252,$CEEB6,2018-06-30,135762,98178,233940
14524,252,$CEEB6,2018-09-30,151997,110098,262095
14524,252,$CEEB6,2018-12-31,151997,110098,262095
14524,252,$CEEB6,2019-03-31,151997,110098,262095
14524,252,$CEEB6,2019-06-30,151997,110098,262095
14524,252,$CEEB6,2019-09-30,151997,110098,262095
14524,252,$CEEB6,2019-12-31,151997,110098,262095
14524,252,$CEEB6,2020-03-31,151997,110098,262095
14524,252,$CEEB6,2020-06-30,151997,110098,262095
14524,252,$CEEB6,2020-09-30,151997,110098,262095
14605,440,$ENMT3,2010-12-31,41018,77835,118853
14605,440,$ENMT3,2011-03-31,41018,77835,118853
14605,440,$ENMT3,2011-06-30,41018,77835,118853
14605,440,$ENMT3,2011-09-30,41018,77835,118853
14605,440,$ENMT3,2011-12-31,41018,77835,118853
14605,440,$ENMT3,2012-03-31,41018,77835,118853
14605,440,$ENMT3,2012-06-30,41018,77835,118853
14605,440,$ENMT3,2012-09-30,41018,77835,118853
14605,440,$ENMT3,2012-12-31,41018,77835,118853
14605,440,$ENMT3,2013-03-31,41018,77835,118853
14605,440,$ENMT3,2013-06-30,41018,77835,118853
14605,440,$ENMT3,2013-09-30,41018,77835,118853
14605,440,$ENMT3,2013-12-31,41018,77835,118853
14605,440,$ENMT3,2014-03-31,41018,77835,118853
14605,440,$ENMT3,2014-06-30,58782,111546,170328
14605,440,$ENMT3,2014-09-30,58782,111546,170328
14605,440,$ENMT3,2014-12-31,58782,111546,170328
14605,440,$ENMT3,2015-03-31,58782,111546,170328
14605,440,$ENMT3,2015-06-30,58782,111546,170328
14605,440,$ENMT3,2015-09-30,58782,111546,170328
14605,440,$ENMT3,2015-12-31,58782489,111546028,170328517
14605,440,$ENMT3,2016-03-31,58782489,111546028,170328517
14605,440,$ENMT3,2016-06-30,58782,111546,170328
14605,440,$ENMT3,2016-09-30,58782489,111546028,170328517
14605,440,$ENMT3,2016-12-31,73478111,139432535,212910646
14605,440,$ENMT3,2017-03-31,73478111,139432535,212910646
14605,440,$ENMT3,2017-06-30,73478111,139432535,212910646
14605,440,$ENMT3,2017-09-30,73478111,139432535,212910646
14605,440,$ENMT3,2017-12-31,73478111,139432535,212910646
14605,440,$ENMT3,2018-03-31,73478111,139432535,212910646
14605,440,$ENMT3,2018-06-30,73478111,139432535,212910646
14605,440,$ENMT3,2018-09-30,73478111,139432535,212910646
14605,440,$ENMT3,2018-12-31,73478111,139432535,212910646
14605,440,$ENMT3,2019-03-31,73478111,139432535,212910646
14605,440,$ENMT3,2019-06-30,73478111,139432535,212910646
14605,440,$ENMT3,2019-09-30,73478111,139432535,212910646
14605,440,$ENMT3,2019-12-31,73478111,139432535,212910646
14605,440,$ENMT3,2020-03-31,73478111,139432535,212910646
14605,440,$ENMT3,2020-06-30,75529774,143412165,218941939
14605,440,$ENMT3,2020-09-30,75529774,143412165,218941939
14605,441,$ENMT4,2010-12-31,41018,77835,118853
14605,441,$ENMT4,2011-03-31,41018,77835,118853
14605,441,$ENMT4,2011-06-30,41018,77835,118853
14605,441,$ENMT4,2011-09-30,41018,77835,118853
14605,441,$ENMT4,2011-12-31,41018,77835,118853
14605,441,$ENMT4,2012-03-31,41018,77835,118853
14605,441,$ENMT4,2012-06-30,41018,77835,118853
14605,441,$ENMT4,2012-09-30,41018,77835,118853
14605,441,$ENMT4,2012-12-31,41018,77835,118853
14605,441,$ENMT4,2013-03-31,41018,77835,118853
14605,441,$ENMT4,2013-06-30,41018,77835,118853
14605,441,$ENMT4,2013-09-30,41018,77835,118853
14605,441,$ENMT4,2013-12-31,41018,77835,118853
14605,441,$ENMT4,2014-03-31,41018,77835,118853
14605,441,$ENMT4,2014-06-30,58782,111546,170328
14605,441,$ENMT4,2014-09-30,58782,111546,170328
14605,441,$ENMT4,2014-12-31,58782,111546,170328
14605,441,$ENMT4,2015-03-31,58782,111546,170328
14605,441,$ENMT4,2015-06-30,58782,111546,170328
14605,441,$ENMT4,2015-09-30,58782,111546,170328
14605,441,$ENMT4,2015-12-31,58782489,111546028,170328517
14605,441,$ENMT4,2016-03-31,58782489,111546028,170328517
14605,441,$ENMT4,2016-06-30,58782,111546,170328
14605,441,$ENMT4,2016-09-30,58782489,111546028,170328517
14605,441,$ENMT4,2016-12-31,73478111,139432535,212910646
14605,441,$ENMT4,2017-03-31,73478111,139432535,212910646
14605,441,$ENMT4,2017-06-30,73478111,139432535,212910646
14605,441,$ENMT4,2017-09-30,73478111,139432535,212910646
14605,441,$ENMT4,2017-12-31,73478111,139432535,212910646
14605,441,$ENMT4,2018-03-31,73478111,139432535,212910646
14605,441,$ENMT4,2018-06-30,73478111,139432535,212910646
14605,441,$ENMT4,2018-09-30,73478111,139432535,212910646
14605,441,$ENMT4,2018-12-31,73478111,139432535,212910646
14605,441,$ENMT4,2019-03-31,73478111,139432535,212910646
14605,441,$ENMT4,2019-06-30,73478111,139432535,212910646
14605,441,$ENMT4,2019-09-30,73478111,139432535,212910646
14605,441,$ENMT4,2019-12-31,73478111,139432535,212910646
14605,441,$ENMT4,2020-03-31,73478111,139432535,212910646
14605,441,$ENMT4,2020-06-30,75529774,143412165,218941939
14605,441,$ENMT4,2020-09-30,75529774,143412165,218941939
14664,256,$SHUL3,2010-12-31,27267,36550,63817
14664,256,$SHUL3,2011-03-31,27267,36550,63817
14664,256,$SHUL3,2011-06-30,27267,36550,63817
14664,256,$SHUL3,2011-09-30,27267,36550,63817
14664,256,$SHUL3,2011-12-31,27266565,36550360,63816925
14664,256,$SHUL3,2012-03-31,27266565,36550360,63816925
14664,256,$SHUL3,2012-06-30,27266565,36550360,63816925
14664,256,$SHUL3,2012-09-30,27266565,36550360,63816925
14664,256,$SHUL3,2012-12-31,27266565,36550360,63816925
14664,256,$SHUL3,2013-03-31,27266565,36550360,63816925
14664,256,$SHUL3,2013-06-30,27266565,36550360,63816925
14664,256,$SHUL3,2013-09-30,27266565,36550360,63816925
14664,256,$SHUL3,2013-12-31,27266565,36550360,63816925
14664,256,$SHUL3,2014-03-31,27266565,36550360,63816925
14664,256,$SHUL3,2014-06-30,27266565,36550360,63816925
14664,256,$SHUL3,2014-09-30,27266565,36550360,63816925
14664,256,$SHUL3,2014-12-31,27266565,36550360,63816925
14664,256,$SHUL3,2015-03-31,27266565,36550360,63816925
14664,256,$SHUL3,2015-06-30,27266565,36550360,63816925
14664,256,$SHUL3,2015-09-30,27266565,36550360,63816925
14664,256,$SHUL3,2015-12-31,27266565,36550360,63816925
14664,256,$SHUL3,2016-03-31,27266565,36550360,63816925
14664,256,$SHUL3,2016-06-30,27266565,36550360,63816925
14664,256,$SHUL3,2016-09-30,27266565,36550360,63816925
14664,256,$SHUL3,2016-12-31,27266565,36550360,63816925
14664,256,$SHUL3,2017-03-31,27266565,36550360,63816925
14664,256,$SHUL3,2017-06-30,27266565,36550360,63816925
14664,256,$SHUL3,2017-09-30,27266565,36550360,63816925
14664,256,$SHUL3,2017-12-31,27266565,36550360,63816925
14664,256,$SHUL3,2018-03-31,27266565,36550360,63816925
14664,256,$SHUL3,2018-06-30,27266565,36550360,63816925
14664,256,$SHUL3,2018-09-30,27266565,36550360,63816925
14664,256,$SHUL3,2018-12-31,38173191,51170504,89343695
14664,256,$SHUL3,2019-03-31,38173191,51170504,89343695
14664,256,$SHUL3,2019-06-30,38173191,51170504,89343695
14664,256,$SHUL3,2019-09-30,38173191,51170504,89343695
14664,256,$SHUL3,2019-12-31,38173191,51170504,89343695
14664,256,$SHUL3,2020-03-31,38173191,51170504,89343695
14664,256,$SHUL3,2020-06-30,38173191,51170504,89343695
14664,256,$SHUL3,2020-09-30,38173191,51170504,89343695
14664,257,$SHUL4,2010-12-31,27267,36550,63817
14664,257,$SHUL4,2011-03-31,27267,36550,63817
14664,257,$SHUL4,2011-06-30,27267,36550,63817
14664,257,$SHUL4,2011-09-30,27267,36550,63817
14664,257,$SHUL4,2011-12-31,27266565,36550360,63816925
14664,257,$SHUL4,2012-03-31,27266565,36550360,63816925
14664,257,$SHUL4,2012-06-30,27266565,36550360,63816925
14664,257,$SHUL4,2012-09-30,27266565,36550360,63816925
14664,257,$SHUL4,2012-12-31,27266565,36550360,63816925
14664,257,$SHUL4,2013-03-31,27266565,36550360,63816925
14664,257,$SHUL4,2013-06-30,27266565,36550360,63816925
14664,257,$SHUL4,2013-09-30,27266565,36550360,63816925
14664,257,$SHUL4,2013-12-31,27266565,36550360,63816925
14664,257,$SHUL4,2014-03-31,27266565,36550360,63816925
14664,257,$SHUL4,2014-06-30,27266565,36550360,63816925
14664,257,$SHUL4,2014-09-30,27266565,36550360,63816925
14664,257,$SHUL4,2014-12-31,27266565,36550360,63816925
14664,257,$SHUL4,2015-03-31,27266565,36550360,63816925
14664,257,$SHUL4,2015-06-30,27266565,36550360,63816925
14664,257,$SHUL4,2015-09-30,27266565,36550360,63816925
14664,257,$SHUL4,2015-12-31,27266565,36550360,63816925
14664,257,$SHUL4,2016-03-31,27266565,36550360,63816925
14664,257,$SHUL4,2016-06-30,27266565,36550360,63816925
14664,257,$SHUL4,2016-09-30,27266565,36550360,63816925
14664,257,$SHUL4,2016-12-31,27266565,36550360,63816925
14664,257,$SHUL4,2017-03-31,27266565,36550360,63816925
14664,257,$SHUL4,2017-06-30,27266565,36550360,63816925
14664,257,$SHUL4,2017-09-30,27266565,36550360,63816925
14664,257,$SHUL4,2017-12-31,27266565,36550360,63816925
14664,257,$SHUL4,2018-03-31,27266565,36550360,63816925
14664,257,$SHUL4,2018-06-30,27266565,36550360,63816925
14664,257,$SHUL4,2018-09-30,27266565,36550360,63816925
14664,257,$SHUL4,2018-12-31,38173191,51170504,89343695
14664,257,$SHUL4,2019-03-31,38173191,51170504,89343695
14664,257,$SHUL4,2019-06-30,38173191,51170504,89343695
14664,257,$SHUL4,2019-09-30,38173191,51170504,89343695
14664,257,$SHUL4,2019-12-31,38173191,51170504,89343695
14664,257,$SHUL4,2020-03-31,38173191,51170504,89343695
14664,257,$SHUL4,2020-06-30,38173191,51170504,89343695
14664,257,$SHUL4,2020-09-30,38173191,51170504,89343695
14761,261,$HGTX3,2010-12-31,162722,0,162722
14761,261,$HGTX3,2011-03-31,162722,0,162722
14761,261,$HGTX3,2011-06-30,163430,0,163430
14761,261,$HGTX3,2011-09-30,163430,0,163430
14761,261,$HGTX3,2011-12-31,163430,0,163430
14761,261,$HGTX3,2012-03-31,163444,0,163444
14761,261,$HGTX3,2012-06-30,164224,0,164224
14761,261,$HGTX3,2012-09-30,164224,0,164224
14761,261,$HGTX3,2012-12-31,164224,0,164224
14761,261,$HGTX3,2013-03-31,164224,0,164224
14761,261,$HGTX3,2013-06-30,164611,0,164611
14761,261,$HGTX3,2013-09-30,164611,0,164611
14761,261,$HGTX3,2013-12-31,164611,0,164611
14761,261,$HGTX3,2014-03-31,164611,0,164611
14761,261,$HGTX3,2014-06-30,164611,0,164611
14761,261,$HGTX3,2014-09-30,164611,0,164611
14761,261,$HGTX3,2014-12-31,164611,0,164611
14761,261,$HGTX3,2015-03-31,164611,0,164611
14761,261,$HGTX3,2015-06-30,163771,0,163771
14761,261,$HGTX3,2015-09-30,163771,0,163771
14761,261,$HGTX3,2015-12-31,163771,0,163771
14761,261,$HGTX3,2016-03-31,163771,0,163771
14761,261,$HGTX3,2016-06-30,161228,0,161228
14761,261,$HGTX3,2016-09-30,161228,0,161228
14761,261,$HGTX3,2016-12-31,161228,0,161228
14761,261,$HGTX3,2017-03-31,161228,0,161228
14761,261,$HGTX3,2017-06-30,161280,0,161280
14761,261,$HGTX3,2017-09-30,161844,0,161844
14761,261,$HGTX3,2017-12-31,161844,0,161844
14761,261,$HGTX3,2018-03-31,161844,0,161844
14761,261,$HGTX3,2018-06-30,161844,0,161844
14761,261,$HGTX3,2018-09-30,161844,0,161844
14761,261,$HGTX3,2018-12-31,161844,0,161844
14761,261,$HGTX3,2019-03-31,161844,0,161844
14761,261,$HGTX3,2019-06-30,162115,0,162115
14761,261,$HGTX3,2019-09-30,162534,0,162534
14761,261,$HGTX3,2019-12-31,162534,0,162534
14761,261,$HGTX3,2020-03-31,162534,0,162534
14761,261,$HGTX3,2020-06-30,162534,0,162534
14761,261,$HGTX3,2020-09-30,162534,0,162534
14818,248,$CMFA3,2010-12-31,126243,240000,366243
14818,248,$CMFA3,2011-03-31,126243,240000,366243
14818,248,$CMFA3,2011-06-30,226243,440000,666243
14818,248,$CMFA3,2011-09-30,226243,440000,666243
14818,248,$CMFA3,2011-12-31,226243,440000,666243
14818,248,$CMFA3,2012-03-31,226243,440000,666243
14818,248,$CMFA3,2012-06-30,226243,440000,666243
14818,248,$CMFA3,2012-09-30,226243,440000,666243
14818,248,$CMFA3,2012-12-31,255466,510777,766243
14818,248,$CMFA3,2013-03-31,255466,510777,766243
14818,248,$CMFA3,2013-06-30,255466,510777,766243
14818,248,$CMFA3,2013-09-30,255466,510777,766243
14818,248,$CMFA3,2013-12-31,255466,510777,766243
14818,248,$CMFA3,2014-03-31,355466,710777,1066243
14818,248,$CMFA3,2014-06-30,355466,710777,1066243
14818,248,$CMFA3,2014-09-30,355466,710777,1066243
14818,248,$CMFA3,2014-12-31,355466,710777,1066243
14818,248,$CMFA3,2015-03-31,355466,710777,1066243
14818,248,$CMFA3,2015-06-30,355466,710777,1066243
14818,248,$CMFA3,2015-09-30,355466,710777,1066243
14818,248,$CMFA3,2015-12-31,355466,710777,1066243
14818,248,$CMFA3,2016-03-31,388801,777442,1166243
14818,248,$CMFA3,2016-06-30,388801,777442,1166243
14818,248,$CMFA3,2016-09-30,3698406,7396652,11095058
14818,248,$CMFA3,2016-12-31,3698406,7396652,11095058
14818,248,$CMFA3,2017-03-31,3698406,7396652,11095058
14818,248,$CMFA3,2017-06-30,3698406,7396652,11095058
14818,248,$CMFA3,2017-09-30,7008011,14015862,21023873
14818,248,$CMFA3,2017-12-31,7008011,14015862,21023873
14818,248,$CMFA3,2018-03-31,7008011,14015862,21023873
14818,248,$CMFA3,2018-06-30,7008011,14015862,21023873
14818,248,$CMFA3,2018-09-30,7008011,14015862,21023873
14818,248,$CMFA3,2018-12-31,7008011,14015862,21023873
14818,248,$CMFA3,2019-03-31,10317616,20635072,30952688
14818,248,$CMFA3,2019-06-30,10317616,20635072,30952688
14818,248,$CMFA3,2019-09-30,10317616,20635072,30952688
14818,248,$CMFA3,2019-12-31,10317616,20635072,30952688
14818,248,$CMFA3,2020-03-31,12799820,25599480,38399300
14818,248,$CMFA3,2020-06-30,12799820,25599480,38399300
14818,248,$CMFA3,2020-09-30,12799820,25599480,38399300
14818,249,$CMFA4,2010-12-31,126243,240000,366243
14818,249,$CMFA4,2011-03-31,126243,240000,366243
14818,249,$CMFA4,2011-06-30,226243,440000,666243
14818,249,$CMFA4,2011-09-30,226243,440000,666243
14818,249,$CMFA4,2011-12-31,226243,440000,666243
14818,249,$CMFA4,2012-03-31,226243,440000,666243
14818,249,$CMFA4,2012-06-30,226243,440000,666243
14818,249,$CMFA4,2012-09-30,226243,440000,666243
14818,249,$CMFA4,2012-12-31,255466,510777,766243
14818,249,$CMFA4,2013-03-31,255466,510777,766243
14818,249,$CMFA4,2013-06-30,255466,510777,766243
14818,249,$CMFA4,2013-09-30,255466,510777,766243
14818,249,$CMFA4,2013-12-31,255466,510777,766243
14818,249,$CMFA4,2014-03-31,355466,710777,1066243
14818,249,$CMFA4,2014-06-30,355466,710777,1066243
14818,249,$CMFA4,2014-09-30,355466,710777,1066243
14818,249,$CMFA4,2014-12-31,355466,710777,1066243
14818,249,$CMFA4,2015-03-31,355466,710777,1066243
14818,249,$CMFA4,2015-06-30,355466,710777,1066243
14818,249,$CMFA4,2015-09-30,355466,710777,1066243
14818,249,$CMFA4,2015-12-31,355466,710777,1066243
14818,249,$CMFA4,2016-03-31,388801,777442,1166243
14818,249,$CMFA4,2016-06-30,388801,777442,1166243
14818,249,$CMFA4,2016-09-30,3698406,7396652,11095058
14818,249,$CMFA4,2016-12-31,3698406,7396652,11095058
14818,249,$CMFA4,2017-03-31,3698406,7396652,11095058
14818,249,$CMFA4,2017-06-30,3698406,7396652,11095058
14818,249,$CMFA4,2017-09-30,7008011,14015862,21023873
14818,249,$CMFA4,2017-12-31,7008011,14015862,21023873
14818,249,$CMFA4,2018-03-31,7008011,14015862,21023873
14818,249,$CMFA4,2018-06-30,7008011,14015862,21023873
14818,249,$CMFA4,2018-09-30,7008011,14015862,21023873
14818,249,$CMFA4,2018-12-31,7008011,14015862,21023873
14818,249,$CMFA4,2019-03-31,10317616,20635072,30952688
14818,249,$CMFA4,2019-06-30,10317616,20635072,30952688
14818,249,$CMFA4,2019-09-30,10317616,20635072,30952688
14818,249,$CMFA4,2019-12-31,10317616,20635072,30952688
14818,249,$CMFA4,2020-03-31,12799820,25599480,38399300
14818,249,$CMFA4,2020-06-30,12799820,25599480,38399300
14818,249,$CMFA4,2020-09-30,12799820,25599480,38399300
14826,269,$PCAR3,2010-12-31,99680,158094,257774
14826,269,$PCAR3,2011-03-31,99679,158094,257773
14826,269,$PCAR3,2011-06-30,99680,160280,259960
14826,269,$PCAR3,2011-09-30,99680,160539,260219
14826,269,$PCAR3,2011-12-31,99680,160559,260239
14826,269,$PCAR3,2012-03-31,99680,160595,260275
14826,269,$PCAR3,2012-06-30,99680,163368,263048
14826,269,$PCAR3,2012-09-30,99680,163376,263056
14826,269,$PCAR3,2012-12-31,99680,163730,263410
14826,269,$PCAR3,2013-03-31,99680,163771,263451
14826,269,$PCAR3,2013-06-30,99680,164612,264292
14826,269,$PCAR3,2013-09-30,99680,164638,264318
14826,269,$PCAR3,2013-12-31,99680,164773,264453
14826,269,$PCAR3,2014-03-31,99680,165243,264923
14826,269,$PCAR3,2014-06-30,99680,165458,265138
14826,269,$PCAR3,2014-09-30,99680,165539,265219
14826,269,$PCAR3,2014-12-31,99680,165603,265283
14826,269,$PCAR3,2015-03-31,99680,165635,265315
14826,269,$PCAR3,2015-06-30,99680,165982,265662
14826,269,$PCAR3,2015-09-30,99680,166017,265697
14826,269,$PCAR3,2015-12-31,99680,166022,265702
14826,269,$PCAR3,2016-03-31,99680,166032,265712
14826,269,$PCAR3,2016-06-30,99680,166044,265724
14826,269,$PCAR3,2016-09-30,99680,166087,265767
14826,269,$PCAR3,2016-12-31,99680,166396,266076
14826,269,$PCAR3,2017-03-31,99680,166506,266186
14826,269,$PCAR3,2017-06-30,99680,166568,266248
14826,269,$PCAR3,2017-09-30,99680,166772,266452
14826,269,$PCAR3,2017-12-31,99680,166899,266579
14826,269,$PCAR3,2018-03-31,99680,166907,266587
14826,269,$PCAR3,2018-06-30,99680,166950,266630
14826,269,$PCAR3,2018-09-30,99680,167119,266799
14826,269,$PCAR3,2018-12-31,99680,167165,266845
14826,269,$PCAR3,2019-03-31,99680,167174,266854
14826,269,$PCAR3,2019-06-30,99680,167399,267079
14826,269,$PCAR3,2019-09-30,99680,168086,267766
14826,269,$PCAR3,2019-12-31,99680,168317,267997
14826,269,$PCAR3,2020-03-31,268046,0,268046
14826,269,$PCAR3,2020-06-30,268049,0,268049
14826,269,$PCAR3,2020-09-30,268336,0,268336
14826,270,$PCAR4,2010-12-31,99680,158094,257774
14826,270,$PCAR4,2011-03-31,99679,158094,257773
14826,270,$PCAR4,2011-06-30,99680,160280,259960
14826,270,$PCAR4,2011-09-30,99680,160539,260219
14826,270,$PCAR4,2011-12-31,99680,160559,260239
14826,270,$PCAR4,2012-03-31,99680,160595,260275
14826,270,$PCAR4,2012-06-30,99680,163368,263048
14826,270,$PCAR4,2012-09-30,99680,163376,263056
14826,270,$PCAR4,2012-12-31,99680,163730,263410
14826,270,$PCAR4,2013-03-31,99680,163771,263451
14826,270,$PCAR4,2013-06-30,99680,164612,264292
14826,270,$PCAR4,2013-09-30,99680,164638,264318
14826,270,$PCAR4,2013-12-31,99680,164773,264453
14826,270,$PCAR4,2014-03-31,99680,165243,264923
14826,270,$PCAR4,2014-06-30,99680,165458,265138
14826,270,$PCAR4,2014-09-30,99680,165539,265219
14826,270,$PCAR4,2014-12-31,99680,165603,265283
14826,270,$PCAR4,2015-03-31,99680,165635,265315
14826,270,$PCAR4,2015-06-30,99680,165982,265662
14826,270,$PCAR4,2015-09-30,99680,166017,265697
14826,270,$PCAR4,2015-12-31,99680,166022,265702
14826,270,$PCAR4,2016-03-31,99680,166032,265712
14826,270,$PCAR4,2016-06-30,99680,166044,265724
14826,270,$PCAR4,2016-09-30,99680,166087,265767
14826,270,$PCAR4,2016-12-31,99680,166396,266076
14826,270,$PCAR4,2017-03-31,99680,166506,266186
14826,270,$PCAR4,2017-06-30,99680,166568,266248
14826,270,$PCAR4,2017-09-30,99680,166772,266452
14826,270,$PCAR4,2017-12-31,99680,166899,266579
14826,270,$PCAR4,2018-03-31,99680,166907,266587
14826,270,$PCAR4,2018-06-30,99680,166950,266630
14826,270,$PCAR4,2018-09-30,99680,167119,266799
14826,270,$PCAR4,2018-12-31,99680,167165,266845
14826,270,$PCAR4,2019-03-31,99680,167174,266854
14826,270,$PCAR4,2019-06-30,99680,167399,267079
14826,270,$PCAR4,2019-09-30,99680,168086,267766
14826,270,$PCAR4,2019-12-31,99680,168317,267997
14826,270,$PCAR4,2020-03-31,268046,0,268046
14826,270,$PCAR4,2020-06-30,268049,0,268049
14826,270,$PCAR4,2020-09-30,268336,0,268336
14869,258,$COCE3,2010-12-31,48067937,29787362,77855299
14869,258,$COCE3,2011-03-31,48067937,29787362,77855299
14869,258,$COCE3,2011-06-30,48067937,29787362,77855299
14869,258,$COCE3,2011-09-30,48067937,29787362,77855299
14869,258,$COCE3,2011-12-31,48067937,29787362,77855299
14869,258,$COCE3,2012-03-31,48067937,29787362,77855299
14869,258,$COCE3,2012-06-30,48067937,29787362,77855299
14869,258,$COCE3,2012-09-30,48067937,29787362,77855299
14869,258,$COCE3,2012-12-31,48067937,29787362,77855299
14869,258,$COCE3,2013-03-31,48067937,29787362,77855299
14869,258,$COCE3,2013-06-30,48067937,29787362,77855299
14869,258,$COCE3,2013-09-30,48067937,29787362,77855299
14869,258,$COCE3,2013-12-31,48067937,29787362,77855299
14869,258,$COCE3,2014-03-31,48067937,29787362,77855299
14869,258,$COCE3,2014-06-30,48067937,29787362,77855299
14869,258,$COCE3,2014-09-30,48067937,29787362,77855299
14869,258,$COCE3,2014-12-31,48067937,29787362,77855299
14869,258,$COCE3,2015-03-31,48067937,29787362,77855299
14869,258,$COCE3,2015-06-30,48067937,29787362,77855299
14869,258,$COCE3,2015-09-30,48067937,29787362,77855299
14869,258,$COCE3,2015-12-31,48067937,29787362,77855299
14869,258,$COCE3,2016-03-31,48067937,29787362,77855299
14869,258,$COCE3,2016-06-30,48067937,29787362,77855299
14869,258,$COCE3,2016-09-30,48067937,29787362,77855299
14869,258,$COCE3,2016-12-31,48067937,29787362,77855299
14869,258,$COCE3,2017-03-31,48067937,29787362,77855299
14869,258,$COCE3,2017-06-30,48067937,29787362,77855299
14869,258,$COCE3,2017-09-30,48067937,29787362,77855299
14869,258,$COCE3,2017-12-31,48067937,29787362,77855299
14869,258,$COCE3,2018-03-31,48067937,29787362,77855299
14869,258,$COCE3,2018-06-30,48067937,29787362,77855299
14869,258,$COCE3,2018-09-30,48067937,29787362,77855299
14869,258,$COCE3,2018-12-31,48067937,29787362,77855299
14869,258,$COCE3,2019-03-31,48067937,29787362,77855299
14869,258,$COCE3,2019-06-30,48067937,29787362,77855299
14869,258,$COCE3,2019-09-30,48067937,29787362,77855299
14869,258,$COCE3,2019-12-31,48067937,29787362,77855299
14869,258,$COCE3,2020-03-31,48067937,29787362,77855299
14869,258,$COCE3,2020-06-30,48067937,29787362,77855299
14869,258,$COCE3,2020-09-30,48067937,29787362,77855299
14869,259,$COCE5,2010-12-31,48067937,29787362,77855299
14869,259,$COCE5,2011-03-31,48067937,29787362,77855299
14869,259,$COCE5,2011-06-30,48067937,29787362,77855299
14869,259,$COCE5,2011-09-30,48067937,29787362,77855299
14869,259,$COCE5,2011-12-31,48067937,29787362,77855299
14869,259,$COCE5,2012-03-31,48067937,29787362,77855299
14869,259,$COCE5,2012-06-30,48067937,29787362,77855299
14869,259,$COCE5,2012-09-30,48067937,29787362,77855299
14869,259,$COCE5,2012-12-31,48067937,29787362,77855299
14869,259,$COCE5,2013-03-31,48067937,29787362,77855299
14869,259,$COCE5,2013-06-30,48067937,29787362,77855299
14869,259,$COCE5,2013-09-30,48067937,29787362,77855299
14869,259,$COCE5,2013-12-31,48067937,29787362,77855299
14869,259,$COCE5,2014-03-31,48067937,29787362,77855299
14869,259,$COCE5,2014-06-30,48067937,29787362,77855299
14869,259,$COCE5,2014-09-30,48067937,29787362,77855299
14869,259,$COCE5,2014-12-31,48067937,29787362,77855299
14869,259,$COCE5,2015-03-31,48067937,29787362,77855299
14869,259,$COCE5,2015-06-30,48067937,29787362,77855299
14869,259,$COCE5,2015-09-30,48067937,29787362,77855299
14869,259,$COCE5,2015-12-31,48067937,29787362,77855299
14869,259,$COCE5,2016-03-31,48067937,29787362,77855299
14869,259,$COCE5,2016-06-30,48067937,29787362,77855299
14869,259,$COCE5,2016-09-30,48067937,29787362,77855299
14869,259,$COCE5,2016-12-31,48067937,29787362,77855299
14869,259,$COCE5,2017-03-31,48067937,29787362,77855299
14869,259,$COCE5,2017-06-30,48067937,29787362,77855299
14869,259,$COCE5,2017-09-30,48067937,29787362,77855299
14869,259,$COCE5,2017-12-31,48067937,29787362,77855299
14869,259,$COCE5,2018-03-31,48067937,29787362,77855299
14869,259,$COCE5,2018-06-30,48067937,29787362,77855299
14869,259,$COCE5,2018-09-30,48067937,29787362,77855299
14869,259,$COCE5,2018-12-31,48067937,29787362,77855299
14869,259,$COCE5,2019-03-31,48067937,29787362,77855299
14869,259,$COCE5,2019-06-30,48067937,29787362,77855299
14869,259,$COCE5,2019-09-30,48067937,29787362,77855299
14869,259,$COCE5,2019-12-31,48067937,29787362,77855299
14869,259,$COCE5,2020-03-31,48067937,29787362,77855299
14869,259,$COCE5,2020-06-30,48067937,29787362,77855299
14869,259,$COCE5,2020-09-30,48067937,29787362,77855299
14966,445,$00000,2010-12-31,29118116,0,29118116
14966,445,$00000,2011-03-31,32683241,0,32683241
14966,445,$00000,2011-06-30,29188116,0,29188116
14966,445,$00000,2011-09-30,29118116,0,29118116
14966,445,$00000,2011-12-31,29188116,0,29188116
14966,445,$00000,2012-03-31,32683241,0,32683241
14966,445,$00000,2012-06-30,32683241,0,32683241
14966,445,$00000,2012-09-30,29188116,0,29188116
14966,445,$00000,2012-12-31,29188116,0,29188116
14966,445,$00000,2013-03-31,29188116,0,29188116
14966,445,$00000,2013-06-30,29188116,0,29188116
14966,445,$00000,2013-09-30,29118116,0,29118116
14966,445,$00000,2013-12-31,29188116,0,29188116
14966,445,$00000,2014-03-31,29188116,0,29188116
14966,445,$00000,2014-06-30,29188116,0,29188116
14966,445,$00000,2014-09-30,29188116,0,29188116
14966,445,$00000,2014-12-31,29188116,0,29188116
14966,445,$00000,2015-03-31,29188116,0,29188116
14966,445,$00000,2015-06-30,29188116,0,29188116
14966,445,$00000,2015-09-30,29188116,0,29188116
14966,445,$00000,2015-12-31,29188116,0,29188116
14966,445,$00000,2016-03-31,29188116,0,29188116
14966,445,$00000,2016-06-30,29188116,0,29188116
14966,445,$00000,2016-09-30,29188116,0,29188116
14966,445,$00000,2016-12-31,29188116,0,29188116
14966,445,$00000,2017-03-31,29188116,0,29188116
14966,445,$00000,2017-06-30,29188116,0,29188116
14966,445,$00000,2017-09-30,29188116,0,29188116
14966,445,$00000,2017-12-31,29188116,0,29188116
14966,445,$00000,2018-03-31,29188116,0,29188116
14966,445,$00000,2018-06-30,29188116,0,29188116
14966,445,$00000,2018-09-30,29188116,0,29188116
14966,445,$00000,2018-12-31,29188116,0,29188116
14966,445,$00000,2019-03-31,29188116,0,29188116
14966,445,$00000,2019-06-30,29188116,0,29188116
14966,445,$00000,2019-09-30,29188116,0,29188116
14966,445,$00000,2019-12-31,29188116,0,29188116
14966,445,$00000,2020-03-31,29188116,0,29188116
14966,445,$00000,2020-06-30,29188116,0,29188116
14966,445,$00000,2020-09-30,29188116,0,29188116
15083,446,$LOAR11,2010-12-31,16083215,14842442,30925657
15083,446,$LOAR11,2011-03-31,16083215,14842442,30925657
15083,446,$LOAR11,2011-06-30,16083,14842,30925
15083,446,$LOAR11,2011-09-30,16083215,14842442,30925657
15083,446,$LOAR11,2011-12-31,16083215,14842442,30925657
15083,446,$LOAR11,2012-03-31,16083,14842,30925
15083,446,$LOAR11,2012-06-30,16083,14842,30925
15083,446,$LOAR11,2012-09-30,16083215,14842442,30925657
15083,446,$LOAR11,2012-12-31,16083215,14842442,30925657
15083,446,$LOAR11,2013-03-31,16083,14842,30925
15083,446,$LOAR11,2013-06-30,16083,14842,30925
15083,446,$LOAR11,2013-09-30,16083,14842,30925
15083,446,$LOAR11,2013-12-31,16083215,14842442,30925657
15083,446,$LOAR11,2014-03-31,16083,14842,30925
15083,446,$LOAR11,2014-06-30,16083,14842,30925
15083,446,$LOAR11,2014-09-30,16083,14842,30925
15083,446,$LOAR11,2014-12-31,16083215,14842442,30925657
15083,446,$LOAR11,2015-03-31,16083,14842,30925
15083,446,$LOAR11,2015-06-30,16083,14842,30925
15083,446,$LOAR11,2015-09-30,16083,14842,30925
15083,446,$LOAR11,2015-12-31,16083,14842,30925
15083,446,$LOAR11,2016-03-31,16083,14842,30925
15083,446,$LOAR11,2016-06-30,16083,14842,30925
15083,446,$LOAR11,2016-09-30,16083,14842,30925
15083,446,$LOAR11,2016-12-31,16083,14842,30925
15083,446,$LOAR11,2017-03-31,16083,14842,30925
15083,446,$LOAR11,2017-06-30,16083,14842,30925
15083,446,$LOAR11,2017-09-30,16083,14842,30925
15083,446,$LOAR11,2017-12-31,16083,14842,30925
15083,446,$LOAR11,2018-03-31,16083,14842,30925
15083,446,$LOAR11,2018-06-30,16083,14842,30925
15083,446,$LOAR11,2018-09-30,16083,14842,30925
15083,446,$LOAR11,2018-12-31,16083,14842,30925
15083,446,$LOAR11,2019-03-31,16083,14842,30925
15083,446,$LOAR11,2019-06-30,16083,14842,30925
15083,446,$LOAR11,2019-09-30,16083,14842,30925
15083,446,$LOAR11,2019-12-31,16083,14842,30925
15091,447,$007424,2010-12-31,247128,36158,283286
15091,447,$007424,2011-03-31,247128,36158,283286
15091,447,$007424,2011-06-30,247128,35567,282695
15091,447,$007424,2011-09-30,247128,35567,282695
15091,447,$007424,2011-12-31,247128,34977,282105
15091,447,$007424,2012-03-31,247128,34977,282105
15091,447,$007424,2012-06-30,247128,34505,281633
15091,447,$007424,2012-09-30,247128,34505,281633
15091,447,$007424,2012-12-31,247128,34035,281163
15091,447,$007424,2013-03-31,247128,34035,281163
15091,447,$007424,2013-06-30,247128,33491,280619
15091,447,$007424,2013-09-30,247128,33491,280619
15091,447,$007424,2013-12-31,247128,28386,275514
15091,447,$007424,2014-03-31,247128,28386,275514
15091,447,$007424,2014-06-30,247128,31514,278642
15091,447,$007424,2014-09-30,247128,31514,278642
15091,447,$007424,2014-12-31,247128,30081,277209
15091,447,$007424,2015-03-31,247128,30081,277209
15091,447,$007424,2015-06-30,247128,29234,276362
15091,447,$007424,2015-09-30,247128,29234,276362
15091,447,$007424,2015-12-31,247128,28386,275514
15091,447,$007424,2016-03-31,247128,28386,275514
15091,447,$007424,2016-06-30,247128,28386,275514
15091,447,$007424,2016-09-30,247128,28386,275514
15091,447,$007424,2016-12-31,247128,28386,275514
15091,447,$007424,2017-03-31,247128,28386,275514
15091,447,$007424,2017-06-30,247128,28386,275514
15091,447,$007424,2017-09-30,247128,28386,275514
15091,447,$007424,2017-12-31,247128,28386,275514
15091,447,$007424,2018-03-31,247128,28386,275514
15091,447,$007424,2018-06-30,247128,28386,275514
15091,447,$007424,2018-09-30,247128,28386,275514
15091,447,$007424,2018-12-31,247128,28386,275514
15091,447,$007424,2019-03-31,247128,28386,275514
15091,447,$007424,2019-06-30,247128,28386,275514
15091,447,$007424,2019-09-30,215495,0,215495
15091,447,$007424,2019-12-31,215495,0,215495
15091,447,$007424,2020-03-31,215495,0,215495
15091,447,$007424,2020-06-30,215495,0,215495
15091,447,$007424,2020-09-30,215495,0,215495
15253,271,$ENGI3,2010-12-31,522604,577253,1099857
15253,271,$ENGI3,2011-03-31,522604,577253,1099857
15253,271,$ENGI3,2011-06-30,522604,577253,1099857
15253,271,$ENGI3,2011-09-30,522604,577253,1099857
15253,271,$ENGI3,2011-12-31,522604,577253,1099857
15253,271,$ENGI3,2012-03-31,522604,577253,1099857
15253,271,$ENGI3,2012-06-30,522604096,577253459,1099857555
15253,271,$ENGI3,2012-09-30,522604096,577253459,1099857555
15253,271,$ENGI3,2012-12-31,522604,577253,1099857
15253,271,$ENGI3,2013-03-31,522604096,577253459,1099857555
15253,271,$ENGI3,2013-06-30,592714397,652976492,1245690889
15253,271,$ENGI3,2013-09-30,592714397,652976492,1245690889
15253,271,$ENGI3,2013-12-31,592714,652976,1245690
15253,271,$ENGI3,2014-03-31,592714397,652976492,1245690889
15253,271,$ENGI3,2014-06-30,592714397,652976492,1245690889
15253,271,$ENGI3,2014-09-30,592714397,652976492,1245690889
15253,271,$ENGI3,2014-12-31,592714,652976,1245690
15253,271,$ENGI3,2015-03-31,592714397,652976492,1245690889
15253,271,$ENGI3,2015-06-30,592714397,652976492,1245690889
15253,271,$ENGI3,2015-09-30,592714397,652976492,1245690889
15253,271,$ENGI3,2015-12-31,641553,695047,1336600
15253,271,$ENGI3,2016-03-31,641553423,695046557,1336599980
15253,271,$ENGI3,2016-06-30,641553423,695046557,1336599980
15253,271,$ENGI3,2016-09-30,720210378,1009616927,1729827305
15253,271,$ENGI3,2016-12-31,720210,1009617,1729827
15253,271,$ENGI3,2017-03-31,720210378,1009616927,1729827305
15253,271,$ENGI3,2017-06-30,720210378,1009616927,1729827305
15253,271,$ENGI3,2017-09-30,720210378,1009616927,1729827305
15253,271,$ENGI3,2017-12-31,720210,1009617,1729827
15253,271,$ENGI3,2018-03-31,720210378,1009616927,1729827305
15253,271,$ENGI3,2018-06-30,720210378,1009616927,1729827305
15253,271,$ENGI3,2018-09-30,720210378,1009616927,1729827305
15253,271,$ENGI3,2018-12-31,755993938,1058567972,1814561910
15253,271,$ENGI3,2019-03-31,755993938,1058567972,1814561910
15253,271,$ENGI3,2019-06-30,755993938,1058567972,1814561910
15253,271,$ENGI3,2019-09-30,755993938,1058567972,1814561910
15253,271,$ENGI3,2019-12-31,755993938,1058567972,1814561910
15253,271,$ENGI3,2020-03-31,755993938,1058567972,1814561910
15253,271,$ENGI3,2020-06-30,755993938,1058567972,1814561910
15253,271,$ENGI3,2020-09-30,755993938,1058567972,1814561910
15253,272,$ENGI4,2010-12-31,522604,577253,1099857
15253,272,$ENGI4,2011-03-31,522604,577253,1099857
15253,272,$ENGI4,2011-06-30,522604,577253,1099857
15253,272,$ENGI4,2011-09-30,522604,577253,1099857
15253,272,$ENGI4,2011-12-31,522604,577253,1099857
15253,272,$ENGI4,2012-03-31,522604,577253,1099857
15253,272,$ENGI4,2012-06-30,522604096,577253459,1099857555
15253,272,$ENGI4,2012-09-30,522604096,577253459,1099857555
15253,272,$ENGI4,2012-12-31,522604,577253,1099857
15253,272,$ENGI4,2013-03-31,522604096,577253459,1099857555
15253,272,$ENGI4,2013-06-30,592714397,652976492,1245690889
15253,272,$ENGI4,2013-09-30,592714397,652976492,1245690889
15253,272,$ENGI4,2013-12-31,592714,652976,1245690
15253,272,$ENGI4,2014-03-31,592714397,652976492,1245690889
15253,272,$ENGI4,2014-06-30,592714397,652976492,1245690889
15253,272,$ENGI4,2014-09-30,592714397,652976492,1245690889
15253,272,$ENGI4,2014-12-31,592714,652976,1245690
15253,272,$ENGI4,2015-03-31,592714397,652976492,1245690889
15253,272,$ENGI4,2015-06-30,592714397,652976492,1245690889
15253,272,$ENGI4,2015-09-30,592714397,652976492,1245690889
15253,272,$ENGI4,2015-12-31,641553,695047,1336600
15253,272,$ENGI4,2016-03-31,641553423,695046557,1336599980
15253,272,$ENGI4,2016-06-30,641553423,695046557,1336599980
15253,272,$ENGI4,2016-09-30,720210378,1009616927,1729827305
15253,272,$ENGI4,2016-12-31,720210,1009617,1729827
15253,272,$ENGI4,2017-03-31,720210378,1009616927,1729827305
15253,272,$ENGI4,2017-06-30,720210378,1009616927,1729827305
15253,272,$ENGI4,2017-09-30,720210378,1009616927,1729827305
15253,272,$ENGI4,2017-12-31,720210,1009617,1729827
15253,272,$ENGI4,2018-03-31,720210378,1009616927,1729827305
15253,272,$ENGI4,2018-06-30,720210378,1009616927,1729827305
15253,272,$ENGI4,2018-09-30,720210378,1009616927,1729827305
15253,272,$ENGI4,2018-12-31,755993938,1058567972,1814561910
15253,272,$ENGI4,2019-03-31,755993938,1058567972,1814561910
15253,272,$ENGI4,2019-06-30,755993938,1058567972,1814561910
15253,272,$ENGI4,2019-09-30,755993938,1058567972,1814561910
15253,272,$ENGI4,2019-12-31,755993938,1058567972,1814561910
15253,272,$ENGI4,2020-03-31,755993938,1058567972,1814561910
15253,272,$ENGI4,2020-06-30,755993938,1058567972,1814561910
15253,272,$ENGI4,2020-09-30,755993938,1058567972,1814561910
15253,601,$ENGI11,2010-12-31,522604,577253,1099857
15253,601,$ENGI11,2011-03-31,522604,577253,1099857
15253,601,$ENGI11,2011-06-30,522604,577253,1099857
15253,601,$ENGI11,2011-09-30,522604,577253,1099857
15253,601,$ENGI11,2011-12-31,522604,577253,1099857
15253,601,$ENGI11,2012-03-31,522604,577253,1099857
15253,601,$ENGI11,2012-06-30,522604096,577253459,1099857555
15253,601,$ENGI11,2012-09-30,522604096,577253459,1099857555
15253,601,$ENGI11,2012-12-31,522604,577253,1099857
15253,601,$ENGI11,2013-03-31,522604096,577253459,1099857555
15253,601,$ENGI11,2013-06-30,592714397,652976492,1245690889
15253,601,$ENGI11,2013-09-30,592714397,652976492,1245690889
15253,601,$ENGI11,2013-12-31,592714,652976,1245690
15253,601,$ENGI11,2014-03-31,592714397,652976492,1245690889
15253,601,$ENGI11,2014-06-30,592714397,652976492,1245690889
15253,601,$ENGI11,2014-09-30,592714397,652976492,1245690889
15253,601,$ENGI11,2014-12-31,592714,652976,1245690
15253,601,$ENGI11,2015-03-31,592714397,652976492,1245690889
15253,601,$ENGI11,2015-06-30,592714397,652976492,1245690889
15253,601,$ENGI11,2015-09-30,592714397,652976492,1245690889
15253,601,$ENGI11,2015-12-31,641553,695047,1336600
15253,601,$ENGI11,2016-03-31,641553423,695046557,1336599980
15253,601,$ENGI11,2016-06-30,641553423,695046557,1336599980
15253,601,$ENGI11,2016-09-30,720210378,1009616927,1729827305
15253,601,$ENGI11,2016-12-31,720210,1009617,1729827
15253,601,$ENGI11,2017-03-31,720210378,1009616927,1729827305
15253,601,$ENGI11,2017-06-30,720210378,1009616927,1729827305
15253,601,$ENGI11,2017-09-30,720210378,1009616927,1729827305
15253,601,$ENGI11,2017-12-31,720210,1009617,1729827
15253,601,$ENGI11,2018-03-31,720210378,1009616927,1729827305
15253,601,$ENGI11,2018-06-30,720210378,1009616927,1729827305
15253,601,$ENGI11,2018-09-30,720210378,1009616927,1729827305
15253,601,$ENGI11,2018-12-31,755993938,1058567972,1814561910
15253,601,$ENGI11,2019-03-31,755993938,1058567972,1814561910
15253,601,$ENGI11,2019-06-30,755993938,1058567972,1814561910
15253,601,$ENGI11,2019-09-30,755993938,1058567972,1814561910
15253,601,$ENGI11,2019-12-31,755993938,1058567972,1814561910
15253,601,$ENGI11,2020-03-31,755993938,1058567972,1814561910
15253,601,$ENGI11,2020-06-30,755993938,1058567972,1814561910
15253,601,$ENGI11,2020-09-30,755993938,1058567972,1814561910
15369,263,$VSPT3,2010-12-31,210197577031,66665,210197643696
15369,263,$VSPT3,2011-03-31,210197577031,66665,210197643696
15369,263,$VSPT3,2011-06-30,210197577031,66665,210197643696
15369,263,$VSPT3,2011-09-30,210197577031,66665,210197643696
15369,263,$VSPT3,2011-12-31,210197577031,66665,210197643696
15369,263,$VSPT3,2012-03-31,210197577031,66665,210197643696
15369,263,$VSPT3,2012-06-30,210197577031,66665,210197643696
15369,263,$VSPT3,2012-09-30,210197577031,66665,210197643696
15369,263,$VSPT3,2012-12-31,210197577031,66665,210197643696
15369,263,$VSPT3,2013-03-31,210197577031,66665,210197643696
15369,263,$VSPT3,2013-06-30,210197577031,66665,210197643696
15369,263,$VSPT3,2013-09-30,210197577031,66665,210197643696
15369,263,$VSPT3,2013-12-31,210197577031,66665,210197643696
15369,263,$VSPT3,2014-03-31,210197577031,66665,210197643696
15369,263,$VSPT3,2014-06-30,210197577031,66665,210197643696
15369,263,$VSPT3,2014-09-30,210197577031,66665,210197643696
15369,263,$VSPT3,2014-12-31,210197577031,66665,210197643696
15369,263,$VSPT3,2015-03-31,210197577031,66665,210197643696
15369,263,$VSPT3,2015-06-30,210197577031,66665,210197643696
15369,263,$VSPT3,2015-09-30,210197577031,66665,210197643696
15369,263,$VSPT3,2015-12-31,210197577031,66665,210197643696
15369,263,$VSPT3,2016-03-31,210197577031,66665,210197643696
15369,263,$VSPT3,2016-06-30,210197577031,66665,210197643696
15369,263,$VSPT3,2016-09-30,210197577031,66665,210197643696
15369,263,$VSPT3,2016-12-31,367645433927,66665,367645500592
15369,263,$VSPT3,2017-03-31,367645433927,66665,367645500592
15369,263,$VSPT3,2017-06-30,367645433926,66665,367645500591
15369,263,$VSPT3,2017-09-30,367645433926,66665,367645500591
15369,263,$VSPT3,2017-12-31,110293641,19,110293660
15369,263,$VSPT3,2018-03-31,110293641,19,110293660
15369,263,$VSPT3,2018-06-30,112303527,19,112303546
15369,263,$VSPT3,2018-09-30,112303527,19,112303546
15369,263,$VSPT3,2018-12-31,112303527,19,112303546
15369,263,$VSPT3,2019-03-31,112303527,19,112303546
15369,263,$VSPT3,2019-06-30,125445701,19,125445720
15369,263,$VSPT3,2019-09-30,125445701,19,125445720
15369,263,$VSPT3,2019-12-31,125445701,19,125445720
15369,263,$VSPT3,2020-03-31,125445701,19,125445720
15369,263,$VSPT3,2020-06-30,125445701,19,125445720
15369,263,$VSPT3,2020-09-30,125445701,19,125445720
15369,264,$VSPT4,2010-12-31,210197577031,66665,210197643696
15369,264,$VSPT4,2011-03-31,210197577031,66665,210197643696
15369,264,$VSPT4,2011-06-30,210197577031,66665,210197643696
15369,264,$VSPT4,2011-09-30,210197577031,66665,210197643696
15369,264,$VSPT4,2011-12-31,210197577031,66665,210197643696
15369,264,$VSPT4,2012-03-31,210197577031,66665,210197643696
15369,264,$VSPT4,2012-06-30,210197577031,66665,210197643696
15369,264,$VSPT4,2012-09-30,210197577031,66665,210197643696
15369,264,$VSPT4,2012-12-31,210197577031,66665,210197643696
15369,264,$VSPT4,2013-03-31,210197577031,66665,210197643696
15369,264,$VSPT4,2013-06-30,210197577031,66665,210197643696
15369,264,$VSPT4,2013-09-30,210197577031,66665,210197643696
15369,264,$VSPT4,2013-12-31,210197577031,66665,210197643696
15369,264,$VSPT4,2014-03-31,210197577031,66665,210197643696
15369,264,$VSPT4,2014-06-30,210197577031,66665,210197643696
15369,264,$VSPT4,2014-09-30,210197577031,66665,210197643696
15369,264,$VSPT4,2014-12-31,210197577031,66665,210197643696
15369,264,$VSPT4,2015-03-31,210197577031,66665,210197643696
15369,264,$VSPT4,2015-06-30,210197577031,66665,210197643696
15369,264,$VSPT4,2015-09-30,210197577031,66665,210197643696
15369,264,$VSPT4,2015-12-31,210197577031,66665,210197643696
15369,264,$VSPT4,2016-03-31,210197577031,66665,210197643696
15369,264,$VSPT4,2016-06-30,210197577031,66665,210197643696
15369,264,$VSPT4,2016-09-30,210197577031,66665,210197643696
15369,264,$VSPT4,2016-12-31,367645433927,66665,367645500592
15369,264,$VSPT4,2017-03-31,367645433927,66665,367645500592
15369,264,$VSPT4,2017-06-30,367645433926,66665,367645500591
15369,264,$VSPT4,2017-09-30,367645433926,66665,367645500591
15369,264,$VSPT4,2017-12-31,110293641,19,110293660
15369,264,$VSPT4,2018-03-31,110293641,19,110293660
15369,264,$VSPT4,2018-06-30,112303527,19,112303546
15369,264,$VSPT4,2018-09-30,112303527,19,112303546
15369,264,$VSPT4,2018-12-31,112303527,19,112303546
15369,264,$VSPT4,2019-03-31,112303527,19,112303546
15369,264,$VSPT4,2019-06-30,125445701,19,125445720
15369,264,$VSPT4,2019-09-30,125445701,19,125445720
15369,264,$VSPT4,2019-12-31,125445701,19,125445720
15369,264,$VSPT4,2020-03-31,125445701,19,125445720
15369,264,$VSPT4,2020-06-30,125445701,19,125445720
15369,264,$VSPT4,2020-09-30,125445701,19,125445720
15423,260,$ATOM3,2010-12-31,88485,0,88485
15423,260,$ATOM3,2011-03-31,88485,0,88485
15423,260,$ATOM3,2011-06-30,88485,0,88485
15423,260,$ATOM3,2011-09-30,88485,0,88485
15423,260,$ATOM3,2011-12-31,88485,0,88485
15423,260,$ATOM3,2012-03-31,88485,0,88485
15423,260,$ATOM3,2012-06-30,88485,0,88485
15423,260,$ATOM3,2012-09-30,88485,0,88485
15423,260,$ATOM3,2012-12-31,88485,0,88485
15423,260,$ATOM3,2013-03-31,88485,0,88485
15423,260,$ATOM3,2013-06-30,88485,0,88485
15423,260,$ATOM3,2013-09-30,88485,0,88485
15423,260,$ATOM3,2013-12-31,313485,0,313485
15423,260,$ATOM3,2014-03-31,313485,0,313485
15423,260,$ATOM3,2014-06-30,313485,0,313485
15423,260,$ATOM3,2014-09-30,313485,0,313485
15423,260,$ATOM3,2014-12-31,313485,0,313485
15423,260,$ATOM3,2015-03-31,313485,0,313485
15423,260,$ATOM3,2015-06-30,313485,0,313485
15423,260,$ATOM3,2015-09-30,313485,0,313485
15423,260,$ATOM3,2015-12-31,313485,0,313485
15423,260,$ATOM3,2016-03-31,313485,0,313485
15423,260,$ATOM3,2016-06-30,62697,0,62697
15423,260,$ATOM3,2016-09-30,20898,0,20898
15423,260,$ATOM3,2016-12-31,20898,0,20898
15423,260,$ATOM3,2017-03-31,20898,0,20898
15423,260,$ATOM3,2017-06-30,20898,0,20898
15423,260,$ATOM3,2017-09-30,20898,0,20898
15423,260,$ATOM3,2017-12-31,20898,0,20898
15423,260,$ATOM3,2018-03-31,20898,0,20898
15423,260,$ATOM3,2018-06-30,20898,0,20898
15423,260,$ATOM3,2018-09-30,20898,0,20898
15423,260,$ATOM3,2018-12-31,20898,0,20898
15423,260,$ATOM3,2019-03-31,20898,0,20898
15423,260,$ATOM3,2019-06-30,20898,0,20898
15423,260,$ATOM3,2019-09-30,20898,0,20898
15423,260,$ATOM3,2019-12-31,20898,0,20898
15423,260,$ATOM3,2020-03-31,20898,0,20898
15423,260,$ATOM3,2020-06-30,20898,0,20898
15423,260,$ATOM3,2020-09-30,20898,0,20898
15458,267,$1545-8,2010-12-31,49912,99766,149678
15458,267,$1545-8,2011-03-31,49912,99766,149678
15458,267,$1545-8,2011-06-30,49912,99766,149678
15458,267,$1545-8,2011-09-30,49912,99766,149678
15458,267,$1545-8,2011-12-31,49912,99766,149678
15458,267,$1545-8,2012-03-31,49912,99766,149678
15458,267,$1545-8,2012-06-30,49912,99766,149678
15458,267,$1545-8,2012-09-30,49912,99766,149678
15458,267,$1545-8,2012-12-31,49912,99766,149678
15458,267,$1545-8,2013-03-31,49912,99766,149678
15458,267,$1545-8,2013-06-30,49912,99766,149678
15458,267,$1545-8,2013-09-30,49912,99766,149678
15458,267,$1545-8,2013-12-31,49912,99766,149678
15458,267,$1545-8,2014-03-31,49912,99766,149678
15458,267,$1545-8,2014-06-30,49912,99766,149678
15458,267,$1545-8,2014-09-30,49912,99766,149678
15458,267,$1545-8,2014-12-31,49912,99766,149678
15458,267,$1545-8,2015-03-31,49912,99766,149678
15458,267,$1545-8,2015-06-30,49912,99766,149678
15458,267,$1545-8,2015-09-30,49912,99766,149678
15458,267,$1545-8,2015-12-31,1996,3991,5987
15458,267,$1545-8,2016-03-31,1996,3991,5987
15458,267,$1545-8,2016-06-30,1996,3991,5987
15458,267,$1545-8,2016-09-30,1996,3991,5987
15458,267,$1545-8,2016-12-31,5120,10239,15359
15458,267,$1545-8,2017-03-31,5120,10239,15359
15458,267,$1545-8,2017-06-30,5120,10239,15359
15458,267,$1545-8,2017-09-30,12409,2950,15359
15458,267,$1545-8,2017-12-31,12409,2950,15359
15458,267,$1545-8,2018-03-31,12409,2950,15359
15458,267,$1545-8,2018-06-30,12409,2950,15359
15458,267,$1545-8,2018-09-30,12409,2950,15359
15458,267,$1545-8,2018-12-31,15359,0,15359
15458,267,$1545-8,2019-03-31,15359,0,15359
15458,267,$1545-8,2019-06-30,15359,0,15359
15458,267,$1545-8,2019-09-30,15359,0,15359
15458,267,$1545-8,2019-12-31,14487,0,14487
15458,267,$1545-8,2020-03-31,14487,0,14487
15458,267,$1545-8,2020-06-30,14487,0,14487
15458,267,$1545-8,2020-09-30,14860,0,14860
15539,451,$NEOE,2010-12-31,5850636,0,5850636
15539,451,$NEOE,2011-03-31,5850636,0,5850636
15539,451,$NEOE,2011-06-30,5850636,0,5850636
15539,451,$NEOE,2011-09-30,5850636,0,5850636
15539,451,$NEOE,2011-12-31,5850636,0,5850636
15539,451,$NEOE,2012-03-31,5850636,0,5850636
15539,451,$NEOE,2012-06-30,5850636,0,5850636
15539,451,$NEOE,2012-09-30,5850636,0,5850636
15539,451,$NEOE,2012-12-31,5850636,0,5850636
15539,451,$NEOE,2013-03-31,5850636,0,5850636
15539,451,$NEOE,2013-06-30,5850636,0,5850636
15539,451,$NEOE,2013-09-30,5850636,0,5850636
15539,451,$NEOE,2013-12-31,5850636,0,5850636
15539,451,$NEOE,2014-03-31,5850636,0,5850636
15539,451,$NEOE,2014-06-30,5850636,0,5850636
15539,451,$NEOE,2014-09-30,5850636,0,5850636
15539,451,$NEOE,2014-12-31,5850636,0,5850636
15539,451,$NEOE,2015-03-31,5850636,0,5850636
15539,451,$NEOE,2015-06-30,5850636,0,5850636
15539,451,$NEOE,2015-09-30,5850636,0,5850636
15539,451,$NEOE,2015-12-31,5850636,0,5850636
15539,451,$NEOE,2016-03-31,5850636,0,5850636
15539,451,$NEOE,2016-06-30,5850636,0,5850636
15539,451,$NEOE,2016-09-30,5850636,0,5850636
15539,451,$NEOE,2016-12-31,779590,0,779590
15539,451,$NEOE,2017-03-31,5850636,0,5850636
15539,451,$NEOE,2017-06-30,5850636,0,5850636
15539,451,$NEOE,2017-09-30,7504760,0,7504760
15539,451,$NEOE,2017-12-31,1154167,0,1154167
15539,451,$NEOE,2018-03-31,1213797,0,1213797
15539,451,$NEOE,2018-06-30,1213797,0,1213797
15539,451,$NEOE,2018-09-30,1213797,0,1213797
15539,451,$NEOE,2018-12-31,1213797,0,1213797
15539,451,$NEOE,2019-03-31,1213797,0,1213797
15539,451,$NEOE,2019-06-30,1213797,0,1213797
15539,451,$NEOE,2019-09-30,1213797,0,1213797
15539,451,$NEOE,2019-12-31,1213797,0,1213797
15539,451,$NEOE,2020-03-31,1213797,0,1213797
15539,451,$NEOE,2020-06-30,1213797,0,1213797
15539,451,$NEOE,2020-09-30,1213797,0,1213797
15539,453,$NEOE3,2010-12-31,5850636,0,5850636
15539,453,$NEOE3,2011-03-31,5850636,0,5850636
15539,453,$NEOE3,2011-06-30,5850636,0,5850636
15539,453,$NEOE3,2011-09-30,5850636,0,5850636
15539,453,$NEOE3,2011-12-31,5850636,0,5850636
15539,453,$NEOE3,2012-03-31,5850636,0,5850636
15539,453,$NEOE3,2012-06-30,5850636,0,5850636
15539,453,$NEOE3,2012-09-30,5850636,0,5850636
15539,453,$NEOE3,2012-12-31,5850636,0,5850636
15539,453,$NEOE3,2013-03-31,5850636,0,5850636
15539,453,$NEOE3,2013-06-30,5850636,0,5850636
15539,453,$NEOE3,2013-09-30,5850636,0,5850636
15539,453,$NEOE3,2013-12-31,5850636,0,5850636
15539,453,$NEOE3,2014-03-31,5850636,0,5850636
15539,453,$NEOE3,2014-06-30,5850636,0,5850636
15539,453,$NEOE3,2014-09-30,5850636,0,5850636
15539,453,$NEOE3,2014-12-31,5850636,0,5850636
15539,453,$NEOE3,2015-03-31,5850636,0,5850636
15539,453,$NEOE3,2015-06-30,5850636,0,5850636
15539,453,$NEOE3,2015-09-30,5850636,0,5850636
15539,453,$NEOE3,2015-12-31,5850636,0,5850636
15539,453,$NEOE3,2016-03-31,5850636,0,5850636
15539,453,$NEOE3,2016-06-30,5850636,0,5850636
15539,453,$NEOE3,2016-09-30,5850636,0,5850636
15539,453,$NEOE3,2016-12-31,779590,0,779590
15539,453,$NEOE3,2017-03-31,5850636,0,5850636
15539,453,$NEOE3,2017-06-30,5850636,0,5850636
15539,453,$NEOE3,2017-09-30,7504760,0,7504760
15539,453,$NEOE3,2017-12-31,1154167,0,1154167
15539,453,$NEOE3,2018-03-31,1213797,0,1213797
15539,453,$NEOE3,2018-06-30,1213797,0,1213797
15539,453,$NEOE3,2018-09-30,1213797,0,1213797
15539,453,$NEOE3,2018-12-31,1213797,0,1213797
15539,453,$NEOE3,2019-03-31,1213797,0,1213797
15539,453,$NEOE3,2019-06-30,1213797,0,1213797
15539,453,$NEOE3,2019-09-30,1213797,0,1213797
15539,453,$NEOE3,2019-12-31,1213797,0,1213797
15539,453,$NEOE3,2020-03-31,1213797,0,1213797
15539,453,$NEOE3,2020-06-30,1213797,0,1213797
15539,453,$NEOE3,2020-09-30,1213797,0,1213797
15636,448,$CGAS3,2010-12-31,93911,25912,119823
15636,448,$CGAS3,2011-03-31,93911,25912,119823
15636,448,$CGAS3,2011-06-30,93911,25912,119823
15636,448,$CGAS3,2011-09-30,93911,25912,119823
15636,448,$CGAS3,2011-12-31,93911,25912,119823
15636,448,$CGAS3,2012-03-31,93911,25912,119823
15636,448,$CGAS3,2012-06-30,93911,25912,119823
15636,448,$CGAS3,2012-09-30,93911,25912,119823
15636,448,$CGAS3,2012-12-31,93911,25912,119823
15636,448,$CGAS3,2013-03-31,93911,25912,119823
15636,448,$CGAS3,2013-06-30,93911,25912,119823
15636,448,$CGAS3,2013-09-30,93911,25912,119823
15636,448,$CGAS3,2013-12-31,93911,25912,119823
15636,448,$CGAS3,2014-03-31,93911,25912,119823
15636,448,$CGAS3,2014-06-30,95516,26355,121871
15636,448,$CGAS3,2014-09-30,95516,26355,121871
15636,448,$CGAS3,2014-12-31,95516,26355,121871
15636,448,$CGAS3,2015-03-31,95516,26355,121871
15636,448,$CGAS3,2015-06-30,97192,26817,124009
15636,448,$CGAS3,2015-09-30,97192,26817,124009
15636,448,$CGAS3,2015-12-31,97192,26817,124009
15636,448,$CGAS3,2016-03-31,97192,26817,124009
15636,448,$CGAS3,2016-06-30,99782,27531,127313
15636,448,$CGAS3,2016-09-30,99782,27531,127313
15636,448,$CGAS3,2016-12-31,99782,27531,127313
15636,448,$CGAS3,2017-03-31,99782,27531,127313
15636,448,$CGAS3,2017-06-30,101917,28121,130038
15636,448,$CGAS3,2017-09-30,101917,28121,130038
15636,448,$CGAS3,2017-12-31,101917264,28121015,130038279
15636,448,$CGAS3,2018-03-31,101917264,28121015,130038279
15636,448,$CGAS3,2018-06-30,103472982,28550269,132023251
15636,448,$CGAS3,2018-09-30,103472982,28550269,132023251
15636,448,$CGAS3,2018-12-31,103472982,28550269,132023251
15636,448,$CGAS3,2019-03-31,103862768,28657819,132520587
15636,448,$CGAS3,2019-06-30,103862768,28657819,132520587
15636,448,$CGAS3,2019-09-30,103862768,28657819,132520587
15636,448,$CGAS3,2019-12-31,103862768,28657819,132520587
15636,448,$CGAS3,2020-03-31,103862768,28657819,132520587
15636,448,$CGAS3,2020-06-30,103862768,28657819,132520587
15636,448,$CGAS3,2020-09-30,103862768,28657819,132520587
15636,449,$CGAS5,2010-12-31,93911,25912,119823
15636,449,$CGAS5,2011-03-31,93911,25912,119823
15636,449,$CGAS5,2011-06-30,93911,25912,119823
15636,449,$CGAS5,2011-09-30,93911,25912,119823
15636,449,$CGAS5,2011-12-31,93911,25912,119823
15636,449,$CGAS5,2012-03-31,93911,25912,119823
15636,449,$CGAS5,2012-06-30,93911,25912,119823
15636,449,$CGAS5,2012-09-30,93911,25912,119823
15636,449,$CGAS5,2012-12-31,93911,25912,119823
15636,449,$CGAS5,2013-03-31,93911,25912,119823
15636,449,$CGAS5,2013-06-30,93911,25912,119823
15636,449,$CGAS5,2013-09-30,93911,25912,119823
15636,449,$CGAS5,2013-12-31,93911,25912,119823
15636,449,$CGAS5,2014-03-31,93911,25912,119823
15636,449,$CGAS5,2014-06-30,95516,26355,121871
15636,449,$CGAS5,2014-09-30,95516,26355,121871
15636,449,$CGAS5,2014-12-31,95516,26355,121871
15636,449,$CGAS5,2015-03-31,95516,26355,121871
15636,449,$CGAS5,2015-06-30,97192,26817,124009
15636,449,$CGAS5,2015-09-30,97192,26817,124009
15636,449,$CGAS5,2015-12-31,97192,26817,124009
15636,449,$CGAS5,2016-03-31,97192,26817,124009
15636,449,$CGAS5,2016-06-30,99782,27531,127313
15636,449,$CGAS5,2016-09-30,99782,27531,127313
15636,449,$CGAS5,2016-12-31,99782,27531,127313
15636,449,$CGAS5,2017-03-31,99782,27531,127313
15636,449,$CGAS5,2017-06-30,101917,28121,130038
15636,449,$CGAS5,2017-09-30,101917,28121,130038
15636,449,$CGAS5,2017-12-31,101917264,28121015,130038279
15636,449,$CGAS5,2018-03-31,101917264,28121015,130038279
15636,449,$CGAS5,2018-06-30,103472982,28550269,132023251
15636,449,$CGAS5,2018-09-30,103472982,28550269,132023251
15636,449,$CGAS5,2018-12-31,103472982,28550269,132023251
15636,449,$CGAS5,2019-03-31,103862768,28657819,132520587
15636,449,$CGAS5,2019-06-30,103862768,28657819,132520587
15636,449,$CGAS5,2019-09-30,103862768,28657819,132520587
15636,449,$CGAS5,2019-12-31,103862768,28657819,132520587
15636,449,$CGAS5,2020-03-31,103862768,28657819,132520587
15636,449,$CGAS5,2020-06-30,103862768,28657819,132520587
15636,449,$CGAS5,2020-09-30,103862768,28657819,132520587
15784,262,$LIPR3,2010-12-31,11765,0,11765
15784,262,$LIPR3,2011-03-31,11765,0,11765
15784,262,$LIPR3,2011-06-30,11765,0,11765
15784,262,$LIPR3,2011-09-30,11764,0,11764
15784,262,$LIPR3,2011-12-31,11764,0,11764
15784,262,$LIPR3,2012-03-31,11764,0,11764
15784,262,$LIPR3,2012-06-30,11764,0,11764
15784,262,$LIPR3,2012-09-30,11764,0,11764
15784,262,$LIPR3,2012-12-31,11764,0,11764
15784,262,$LIPR3,2013-03-31,11764,0,11764
15784,262,$LIPR3,2013-06-30,11764,0,11764
15784,262,$LIPR3,2013-09-30,11764,0,11764
15784,262,$LIPR3,2013-12-31,11764,0,11764
15784,262,$LIPR3,2014-03-30,11764,0,11764
15784,262,$LIPR3,2014-06-30,11764,0,11764
15784,262,$LIPR3,2014-09-30,11764,0,11764
15784,262,$LIPR3,2014-12-31,11764,0,11764
15784,262,$LIPR3,2015-03-31,11764,0,11764
15784,262,$LIPR3,2015-06-30,11764,0,11764
15784,262,$LIPR3,2015-09-30,11764,0,11764
15784,262,$LIPR3,2015-12-31,11764,0,11764
15784,262,$LIPR3,2016-03-31,11764,0,11764
15784,262,$LIPR3,2016-06-30,11764,0,11764
15784,262,$LIPR3,2016-09-30,11764,0,11764
15784,262,$LIPR3,2016-12-31,11764,0,11764
15784,262,$LIPR3,2017-03-31,11764,0,11764
15784,262,$LIPR3,2017-06-30,11764,0,11764
15784,262,$LIPR3,2017-09-30,11764,0,11764
15784,262,$LIPR3,2017-12-31,11764,0,11764
15784,262,$LIPR3,2018-03-31,11764,0,11764
15784,262,$LIPR3,2018-06-30,11764,0,11764
15784,262,$LIPR3,2018-09-30,11764,0,11764
15784,262,$LIPR3,2018-12-31,11764,0,11764
15784,262,$LIPR3,2019-03-31,11764,0,11764
15784,262,$LIPR3,2019-06-30,11764,0,11764
15784,262,$LIPR3,2019-09-30,11764,0,11764
15784,262,$LIPR3,2019-12-31,11764,0,11764
15784,262,$LIPR3,2020-03-31,11764,0,11764
15784,262,$LIPR3,2020-06-30,11764,0,11764
15784,262,$LIPR3,2020-09-30,11764,0,11764
16101,280,$GAFS3,2010-12-31,431515,0,431515
16101,280,$GAFS3,2011-03-31,431984,0,431984
16101,280,$GAFS3,2011-06-30,432137,0,432137
16101,280,$GAFS3,2011-09-30,432515,0,432515
16101,280,$GAFS3,2011-12-31,432099,0,432099
16101,280,$GAFS3,2012-03-31,432099,0,432099
16101,280,$GAFS3,2012-06-30,432872,0,432872
16101,280,$GAFS3,2012-09-30,432872,0,432872
16101,280,$GAFS3,2012-12-31,433230,0,433230
16101,280,$GAFS3,2013-03-31,431629,0,431629
16101,280,$GAFS3,2013-06-30,435099,0,435099
16101,280,$GAFS3,2013-09-30,435380,0,435380
16101,280,$GAFS3,2013-12-31,435559,0,435559
16101,280,$GAFS3,2014-03-31,435559,0,435559
16101,280,$GAFS3,2014-06-30,435559,0,435559
16101,280,$GAFS3,2014-09-30,435559,0,435559
16101,280,$GAFS3,2014-12-31,408066,0,408066
16101,280,$GAFS3,2015-03-31,378066,0,378066
16101,280,$GAFS3,2015-06-30,378066,0,378066
16101,280,$GAFS3,2015-09-30,378066,0,378066
16101,280,$GAFS3,2015-12-31,378066,0,378066
16101,280,$GAFS3,2016-03-31,378066,0,378066
16101,280,$GAFS3,2016-06-30,378066,0,378066
16101,280,$GAFS3,2016-09-30,378066,0,378066
16101,280,$GAFS3,2016-12-31,378066,0,378066
16101,280,$GAFS3,2017-03-31,28040,0,28040
16101,280,$GAFS3,2017-06-30,28040,0,28040
16101,280,$GAFS3,2017-09-30,28040,0,28040
16101,280,$GAFS3,2017-12-31,28040,0,28040
16101,280,$GAFS3,2018-03-31,44758,0,44758
16101,280,$GAFS3,2018-06-30,44758,0,44758
16101,280,$GAFS3,2018-09-30,44758,0,44758
16101,280,$GAFS3,2018-12-31,43728,0,43728
16101,280,$GAFS3,2019-03-31,43358,0,43358
16101,280,$GAFS3,2019-06-30,71032,0,71032
16101,280,$GAFS3,2019-09-30,71032,0,71032
16101,280,$GAFS3,2019-12-31,120000,0,120000
16101,280,$GAFS3,2020-03-31,120000,0,120000
16101,280,$GAFS3,2020-06-30,120000,0,120000
16101,280,$GAFS3,2020-09-30,290732,0,290732
16284,450,$QVQP3B,2010-12-31,176263,0,176263
16284,450,$QVQP3B,2011-03-31,176261901,0,176261901
16284,450,$QVQP3B,2011-06-30,176261901,0,176261901
16284,450,$QVQP3B,2011-09-30,176261901,0,176261901
16284,450,$QVQP3B,2011-12-31,176262,0,176262
16284,450,$QVQP3B,2012-03-31,176261901,0,176261901
16284,450,$QVQP3B,2012-06-30,176261901,0,176261901
16284,450,$QVQP3B,2012-09-30,176261901,0,176261901
16284,450,$QVQP3B,2012-12-31,176262,0,176262
16284,450,$QVQP3B,2013-03-31,176262,0,176262
16284,450,$QVQP3B,2013-06-30,176262,0,176262
16284,450,$QVQP3B,2013-09-30,176262,0,176262
16284,450,$QVQP3B,2013-12-31,176262,0,176262
16284,450,$QVQP3B,2014-03-31,176262,0,176262
16284,450,$QVQP3B,2014-06-30,176262,0,176262
16284,450,$QVQP3B,2014-09-30,176262,0,176262
16284,450,$QVQP3B,2014-12-31,176262,0,176262
16284,450,$QVQP3B,2015-03-31,176262,0,176262
16284,450,$QVQP3B,2015-06-30,176262,0,176262
16284,450,$QVQP3B,2015-09-30,176262,0,176262
16284,450,$QVQP3B,2015-12-31,176262,0,176262
16284,450,$QVQP3B,2016-03-31,176262,0,176262
16284,450,$QVQP3B,2016-06-30,176262,0,176262
16284,450,$QVQP3B,2016-09-30,176262,0,176262
16284,450,$QVQP3B,2016-12-31,176262,0,176262
16284,450,$QVQP3B,2017-03-31,176262,0,176262
16284,450,$QVQP3B,2017-06-30,176262,0,176262
16284,450,$QVQP3B,2017-09-30,176262,0,176262
16284,450,$QVQP3B,2017-12-31,186262,0,186262
16284,450,$QVQP3B,2018-03-31,196262,0,196262
16284,450,$QVQP3B,2018-06-30,196262,0,196262
16284,450,$QVQP3B,2018-09-30,196262,0,196262
16284,450,$QVQP3B,2018-12-31,196262,0,196262
16284,450,$QVQP3B,2019-03-31,206262,0,206262
16284,450,$QVQP3B,2019-06-30,206262,0,206262
16284,450,$QVQP3B,2019-09-30,206262,0,206262
16284,450,$QVQP3B,2019-12-31,206261901,0,206261901
16284,450,$QVQP3B,2020-03-31,228361901,0,228361901
16284,450,$QVQP3B,2020-06-30,228361901,0,228361901
16284,450,$QVQP3B,2020-09-30,228360991,0,228360991
16292,284,$BRFS3,2010-12-31,872473246,0,872473246
16292,284,$BRFS3,2011-03-31,872473246,0,872473246
16292,284,$BRFS3,2011-06-30,872473246,0,872473246
16292,284,$BRFS3,2011-09-30,872473246,0,872473246
16292,284,$BRFS3,2011-12-31,872473246,0,872473246
16292,284,$BRFS3,2012-03-31,872473246,0,872473246
16292,284,$BRFS3,2012-06-30,872473246,0,872473246
16292,284,$BRFS3,2012-09-30,872473246,0,872473246
16292,284,$BRFS3,2012-12-31,872473246,0,872473246
16292,284,$BRFS3,2013-03-31,872473246,0,872473246
16292,284,$BRFS3,2013-06-30,872473246,0,872473246
16292,284,$BRFS3,2013-09-30,872473246,0,872473246
16292,284,$BRFS3,2013-12-31,872473246,0,872473246
16292,284,$BRFS3,2014-03-31,872473246,0,872473246
16292,284,$BRFS3,2014-06-30,872473246,0,872473246
16292,284,$BRFS3,2014-09-30,872473246,0,872473246
16292,284,$BRFS3,2014-12-31,872473246,0,872473246
16292,284,$BRFS3,2015-03-31,872473246,0,872473246
16292,284,$BRFS3,2015-06-30,872473246,0,872473246
16292,284,$BRFS3,2015-09-30,872473246,0,872473246
16292,284,$BRFS3,2015-12-31,872473246,0,872473246
16292,284,$BRFS3,2016-03-31,812473246,0,812473246
16292,284,$BRFS3,2016-06-30,812473246,0,812473246
16292,284,$BRFS3,2016-09-30,812473246,0,812473246
16292,284,$BRFS3,2016-12-31,812473246,0,812473246
16292,284,$BRFS3,2017-03-31,812473246,0,812473246
16292,284,$BRFS3,2017-06-30,812473246,0,812473246
16292,284,$BRFS3,2017-09-30,812473246,0,812473246
16292,284,$BRFS3,2017-12-31,812473246,0,812473246
16292,284,$BRFS3,2018-03-31,812473246,0,812473246
16292,284,$BRFS3,2018-06-30,812473246,0,812473246
16292,284,$BRFS3,2018-09-30,812473246,0,812473246
16292,284,$BRFS3,2018-12-31,812473246,0,812473246
16292,284,$BRFS3,2019-03-31,812473246,0,812473246
16292,284,$BRFS3,2019-06-30,812473246,0,812473246
16292,284,$BRFS3,2019-09-30,812473246,0,812473246
16292,284,$BRFS3,2019-12-31,812473246,0,812473246
16292,284,$BRFS3,2020-03-31,812473246,0,812473246
16292,284,$BRFS3,2020-06-30,812473246,0,812473246
16292,284,$BRFS3,2020-09-30,812473246,0,812473246
16306,281,$RSID3,2010-12-31,266436388,0,266436388
16306,281,$RSID3,2011-03-31,266436388,0,266436388
16306,281,$RSID3,2011-06-30,268339296,0,268339296
16306,281,$RSID3,2011-09-30,268339296,0,268339296
16306,281,$RSID3,2011-12-31,268339296,0,268339296
16306,281,$RSID3,2012-03-31,268339296,0,268339296
16306,281,$RSID3,2012-06-30,268339296,0,268339296
16306,281,$RSID3,2012-09-30,268608464,0,268608464
16306,281,$RSID3,2012-12-31,417555563,0,417555563
16306,281,$RSID3,2013-03-31,426756464,0,426756464
16306,281,$RSID3,2013-06-30,428473420,0,428473420
16306,281,$RSID3,2013-09-30,428473420,0,428473420
16306,281,$RSID3,2013-12-31,428473420,0,428473420
16306,281,$RSID3,2014-03-31,428833420,0,428833420
16306,281,$RSID3,2014-06-30,428833420,0,428833420
16306,281,$RSID3,2014-09-30,428833420,0,428833420
16306,281,$RSID3,2014-12-31,85766684,0,85766684
16306,281,$RSID3,2015-03-31,85766684,0,85766684
16306,281,$RSID3,2015-06-30,85766684,0,85766684
16306,281,$RSID3,2015-09-30,85766684,0,85766684
16306,281,$RSID3,2015-12-31,85766684,0,85766684
16306,281,$RSID3,2016-03-31,17153337,0,17153337
16306,281,$RSID3,2016-06-30,17153337,0,17153337
16306,281,$RSID3,2016-09-30,17153337,0,17153337
16306,281,$RSID3,2016-12-31,17153337,0,17153337
16306,281,$RSID3,2017-03-31,17153337,0,17153337
16306,281,$RSID3,2017-06-30,17153337,0,17153337
16306,281,$RSID3,2017-09-30,17153337,0,17153337
16306,281,$RSID3,2017-12-31,17153337,0,17153337
16306,281,$RSID3,2018-03-31,17153337,0,17153337
16306,281,$RSID3,2018-06-30,17153337,0,17153337
16306,281,$RSID3,2018-09-30,17153337,0,17153337
16306,281,$RSID3,2018-12-31,17153337,0,17153337
16306,281,$RSID3,2019-03-31,17153337,0,17153337
16306,281,$RSID3,2019-06-30,17153337,0,17153337
16306,281,$RSID3,2019-09-30,17153337,0,17153337
16306,281,$RSID3,2019-12-31,17153337,0,17153337
16306,281,$RSID3,2020-03-31,17153337,0,17153337
16306,281,$RSID3,2020-06-30,17153337,0,17153337
16306,281,$RSID3,2020-09-30,17153337,0,17153337
16438,452,$OPTS3B,2010-12-31,48582043,0,48582043
16438,452,$OPTS3B,2011-03-31,48582043,0,48582043
16438,452,$OPTS3B,2011-06-30,48582043,0,48582043
16438,452,$OPTS3B,2011-09-30,48582043,0,48582043
16438,452,$OPTS3B,2011-12-31,48582043,0,48582043
16438,452,$OPTS3B,2012-03-31,48582043,0,48582043
16438,452,$OPTS3B,2012-06-30,48582043,0,48582043
16438,452,$OPTS3B,2012-09-30,48582043,0,48582043
16438,452,$OPTS3B,2012-12-31,48582043,0,48582043
16438,452,$OPTS3B,2013-03-31,48582043,0,48582043
16438,452,$OPTS3B,2013-06-30,48582043,0,48582043
16438,452,$OPTS3B,2013-09-30,48582043,0,48582043
16438,452,$OPTS3B,2013-12-31,48582043,0,48582043
16438,452,$OPTS3B,2014-03-31,48582043,0,48582043
16438,452,$OPTS3B,2014-06-30,45582043,0,45582043
16438,452,$OPTS3B,2014-09-30,45582043,0,45582043
16438,452,$OPTS3B,2014-12-31,83596903,0,83596903
16438,452,$OPTS3B,2015-03-31,83596903,0,83596903
16438,452,$OPTS3B,2015-06-30,83596903,0,83596903
16438,452,$OPTS3B,2015-09-30,83596903,0,83596903
16438,452,$OPTS3B,2015-12-31,83596903,0,83596903
16438,452,$OPTS3B,2016-03-31,83596903,0,83596903
16438,452,$OPTS3B,2016-06-30,83596903,0,83596903
16438,452,$OPTS3B,2016-09-30,83596903,0,83596903
16438,452,$OPTS3B,2016-12-31,83596903,0,83596903
16438,452,$OPTS3B,2017-03-31,83596903,0,83596903
16438,452,$OPTS3B,2017-06-30,83596903,0,83596903
16438,452,$OPTS3B,2017-09-30,83596903,0,83596903
16438,452,$OPTS3B,2017-12-31,83596903,0,83596903
16438,452,$OPTS3B,2018-03-31,83596903,0,83596903
16438,452,$OPTS3B,2018-06-30,83596903,0,83596903
16438,452,$OPTS3B,2018-09-30,83596903,0,83596903
16438,452,$OPTS3B,2018-12-31,83596903,0,83596903
16438,452,$OPTS3B,2019-03-31,83596903,0,83596903
16438,452,$OPTS3B,2019-06-30,83596903,0,83596903
16438,452,$OPTS3B,2019-09-30,83596903,0,83596903
16438,452,$OPTS3B,2019-12-31,83596903,0,83596903
16438,452,$OPTS3B,2020-03-31,83596903,0,83596903
16438,452,$OPTS3B,2020-06-30,83596903,0,83596903
16438,452,$OPTS3B,2020-09-30,83596903,0,83596903
16497,277,$ECPR3,2010-12-31,1026,874,1900
16497,277,$ECPR3,2011-03-31,1026,874,1900
16497,277,$ECPR3,2011-06-30,1026,874,1900
16497,277,$ECPR3,2011-09-30,1026,874,1900
16497,277,$ECPR3,2011-12-31,1026,874,1900
16497,277,$ECPR3,2012-03-31,1026,874,1900
16497,277,$ECPR3,2012-06-30,1026,874,1900
16497,277,$ECPR3,2012-09-30,1026,874,1900
16497,277,$ECPR3,2012-12-31,1026,874,1900
16497,277,$ECPR3,2013-03-31,1026,874,1900
16497,277,$ECPR3,2013-06-30,1026,874,1900
16497,277,$ECPR3,2013-09-30,1026,874,1900
16497,277,$ECPR3,2013-12-31,1026,874,1900
16497,277,$ECPR3,2014-03-31,1026,874,1900
16497,277,$ECPR3,2014-06-30,1026,874,1900
16497,277,$ECPR3,2014-09-30,1026,874,1900
16497,277,$ECPR3,2014-12-31,1026,874,1900
16497,277,$ECPR3,2015-03-31,1026,874,1900
16497,277,$ECPR3,2015-06-30,1026,874,1900
16497,277,$ECPR3,2015-09-30,1026,874,1900
16497,277,$ECPR3,2015-12-31,1026,874,1900
16497,277,$ECPR3,2016-03-31,1026,874,1900
16497,277,$ECPR3,2016-06-30,1026,874,1900
16497,277,$ECPR3,2016-09-30,1026,874,1900
16497,277,$ECPR3,2016-12-31,1026,874,1900
16497,277,$ECPR3,2017-03-31,1026,874,1900
16497,277,$ECPR3,2017-06-30,1026,874,1900
16497,277,$ECPR3,2017-09-30,1026,874,1900
16497,277,$ECPR3,2017-12-31,1026,874,1900
16497,277,$ECPR3,2018-03-31,1026,874,1900
16497,277,$ECPR3,2018-06-30,1026,874,1900
16497,277,$ECPR3,2018-09-30,1026,874,1900
16497,277,$ECPR3,2018-12-31,1026,874,1900
16497,277,$ECPR3,2019-03-31,1026,874,1900
16497,277,$ECPR3,2019-06-30,1026,874,1900
16497,277,$ECPR3,2019-09-30,1026,874,1900
16497,277,$ECPR3,2019-12-31,1026,874,1900
16497,277,$ECPR3,2020-03-31,1026,874,1900
16497,277,$ECPR3,2020-06-30,1026,874,1900
16497,277,$ECPR3,2020-09-30,1026,874,1900
16497,278,$ECPR4,2010-12-31,1026,874,1900
16497,278,$ECPR4,2011-03-31,1026,874,1900
16497,278,$ECPR4,2011-06-30,1026,874,1900
16497,278,$ECPR4,2011-09-30,1026,874,1900
16497,278,$ECPR4,2011-12-31,1026,874,1900
16497,278,$ECPR4,2012-03-31,1026,874,1900
16497,278,$ECPR4,2012-06-30,1026,874,1900
16497,278,$ECPR4,2012-09-30,1026,874,1900
16497,278,$ECPR4,2012-12-31,1026,874,1900
16497,278,$ECPR4,2013-03-31,1026,874,1900
16497,278,$ECPR4,2013-06-30,1026,874,1900
16497,278,$ECPR4,2013-09-30,1026,874,1900
16497,278,$ECPR4,2013-12-31,1026,874,1900
16497,278,$ECPR4,2014-03-31,1026,874,1900
16497,278,$ECPR4,2014-06-30,1026,874,1900
16497,278,$ECPR4,2014-09-30,1026,874,1900
16497,278,$ECPR4,2014-12-31,1026,874,1900
16497,278,$ECPR4,2015-03-31,1026,874,1900
16497,278,$ECPR4,2015-06-30,1026,874,1900
16497,278,$ECPR4,2015-09-30,1026,874,1900
16497,278,$ECPR4,2015-12-31,1026,874,1900
16497,278,$ECPR4,2016-03-31,1026,874,1900
16497,278,$ECPR4,2016-06-30,1026,874,1900
16497,278,$ECPR4,2016-09-30,1026,874,1900
16497,278,$ECPR4,2016-12-31,1026,874,1900
16497,278,$ECPR4,2017-03-31,1026,874,1900
16497,278,$ECPR4,2017-06-30,1026,874,1900
16497,278,$ECPR4,2017-09-30,1026,874,1900
16497,278,$ECPR4,2017-12-31,1026,874,1900
16497,278,$ECPR4,2018-03-31,1026,874,1900
16497,278,$ECPR4,2018-06-30,1026,874,1900
16497,278,$ECPR4,2018-09-30,1026,874,1900
16497,278,$ECPR4,2018-12-31,1026,874,1900
16497,278,$ECPR4,2019-03-31,1026,874,1900
16497,278,$ECPR4,2019-06-30,1026,874,1900
16497,278,$ECPR4,2019-09-30,1026,874,1900
16497,278,$ECPR4,2019-12-31,1026,874,1900
16497,278,$ECPR4,2020-03-31,1026,874,1900
16497,278,$ECPR4,2020-06-30,1026,874,1900
16497,278,$ECPR4,2020-09-30,1026,874,1900
16560,454,$BNPA3B,2010-12-31,66729,0,66729
16560,454,$BNPA3B,2011-03-31,66729,0,66729
16560,454,$BNPA3B,2011-06-30,66729,0,66729
16560,454,$BNPA3B,2011-09-30,66729,0,66729
16560,454,$BNPA3B,2011-12-31,66729,0,66729
16560,454,$BNPA3B,2012-03-31,66728878,0,66728878
16560,454,$BNPA3B,2012-06-30,66729,0,66729
16560,454,$BNPA3B,2012-09-30,66729,0,66729
16560,454,$BNPA3B,2012-12-31,66729,0,66729
16560,454,$BNPA3B,2013-03-31,66729,0,66729
16560,454,$BNPA3B,2013-06-30,66729,0,66729
16560,454,$BNPA3B,2013-09-30,66729,0,66729
16560,454,$BNPA3B,2013-12-31,66729,0,66729
16560,454,$BNPA3B,2014-03-31,66729,0,66729
16560,454,$BNPA3B,2014-06-30,66729,0,66729
16560,454,$BNPA3B,2014-09-30,66729,0,66729
16560,454,$BNPA3B,2014-12-31,66729,0,66729
16560,454,$BNPA3B,2015-03-31,66729,0,66729
16560,454,$BNPA3B,2015-06-30,66729,0,66729
16560,454,$BNPA3B,2015-09-30,66729,0,66729
16560,454,$BNPA3B,2015-12-31,66729,0,66729
16560,454,$BNPA3B,2016-03-31,66729,0,66729
16560,454,$BNPA3B,2016-06-30,66729,0,66729
16560,454,$BNPA3B,2016-09-30,66729,0,66729
16560,454,$BNPA3B,2016-12-31,66729,0,66729
16560,454,$BNPA3B,2017-03-31,66729,0,66729
16560,454,$BNPA3B,2017-06-30,66729,0,66729
16560,454,$BNPA3B,2017-09-30,66729,0,66729
16560,454,$BNPA3B,2017-12-31,66729,0,66729
16560,454,$BNPA3B,2018-03-31,66729,0,66729
16560,454,$BNPA3B,2018-06-30,66729,0,66729
16560,454,$BNPA3B,2018-09-30,66729,0,66729
16586,455,$OPSE3B,2010-12-31,33723324,0,33723324
16586,455,$OPSE3B,2011-03-31,33798324,0,33798324
16586,455,$OPSE3B,2011-06-30,33798324,0,33798324
16586,455,$OPSE3B,2011-09-30,33798324,0,33798324
16586,455,$OPSE3B,2011-12-31,33798324,0,33798324
16586,455,$OPSE3B,2012-03-31,33878324,0,33878324
16586,455,$OPSE3B,2012-06-30,33878324,0,33878324
16586,455,$OPSE3B,2012-09-30,33878324,0,33878324
16586,455,$OPSE3B,2012-12-31,41378324,0,41378324
16586,455,$OPSE3B,2013-03-31,41378324,0,41378324
16586,455,$OPSE3B,2013-06-30,41378324,0,41378324
16586,455,$OPSE3B,2013-09-30,41378324,0,41378324
16586,455,$OPSE3B,2013-12-31,41378324,0,41378324
16586,455,$OPSE3B,2014-03-31,51378324,0,51378324
16586,455,$OPSE3B,2014-06-30,51378324,0,51378324
16586,455,$OPSE3B,2014-09-30,51378324,0,51378324
16586,455,$OPSE3B,2014-12-31,51378324,0,51378324
16586,455,$OPSE3B,2015-03-31,59878324,0,59878324
16586,455,$OPSE3B,2015-06-30,59878324,0,59878324
16586,455,$OPSE3B,2015-09-30,59878324,0,59878324
16586,455,$OPSE3B,2015-12-31,59878324,0,59878324
16586,455,$OPSE3B,2016-03-31,70178324,0,70178324
16586,455,$OPSE3B,2016-06-30,70178324,0,70178324
16586,455,$OPSE3B,2016-09-30,70178324,0,70178324
16586,455,$OPSE3B,2016-12-31,70178324,0,70178324
16586,455,$OPSE3B,2017-03-31,81178324,0,81178324
16586,455,$OPSE3B,2017-06-30,81178324,0,81178324
16586,455,$OPSE3B,2017-09-30,81178324,0,81178324
16586,455,$OPSE3B,2017-12-31,81178324,0,81178324
16586,455,$OPSE3B,2018-03-31,93178324,0,93178324
16586,455,$OPSE3B,2018-06-30,93178324,0,93178324
16586,455,$OPSE3B,2018-09-30,93178324,0,93178324
16586,455,$OPSE3B,2018-12-31,93178324,0,93178324
16586,455,$OPSE3B,2019-03-31,106178324,0,106178324
16586,455,$OPSE3B,2019-06-30,106178324,0,106178324
16586,455,$OPSE3B,2019-09-30,106178324,0,106178324
16586,455,$OPSE3B,2019-12-31,126178324,0,126178324
16586,455,$OPSE3B,2020-03-31,126178324,0,126178324
16586,455,$OPSE3B,2020-06-30,126178324,0,126178324
16586,455,$OPSE3B,2020-09-30,126178324,0,126178324
16608,456,$ENMA3B,2010-12-31,161319,2865,164184
16608,456,$ENMA3B,2011-03-31,161318939,2864960,164183899
16608,456,$ENMA3B,2011-06-30,161318939,2864960,164183899
16608,456,$ENMA3B,2011-09-30,161318939,2864960,164183899
16608,456,$ENMA3B,2011-12-31,161318939,2864960,164183899
16608,456,$ENMA3B,2012-03-31,161318939,2864960,164183899
16608,456,$ENMA3B,2012-06-30,161318939,2864960,164183899
16608,456,$ENMA3B,2012-09-30,161318939,2864960,164183899
16608,456,$ENMA3B,2012-12-31,161318939,2864960,164183899
16608,456,$ENMA3B,2013-03-31,161318939,2864960,164183899
16608,456,$ENMA3B,2013-06-30,161318939,2864960,164183899
16608,456,$ENMA3B,2013-09-30,161318939,2864960,164183899
16608,456,$ENMA3B,2013-12-31,161318939,2864960,164183899
16608,456,$ENMA3B,2014-03-31,161318939,2864960,164183899
16608,456,$ENMA3B,2014-06-30,161318939,2864960,164183899
16608,456,$ENMA3B,2014-09-30,161318939,2864960,164183899
16608,456,$ENMA3B,2014-12-31,161318939,2864960,164183899
16608,456,$ENMA3B,2015-03-31,161318939,2864960,164183899
16608,456,$ENMA3B,2015-06-30,161318939,2864960,164183899
16608,456,$ENMA3B,2015-09-30,161318939,2864960,164183899
16608,456,$ENMA3B,2015-12-31,161318939,2864960,164183899
16608,456,$ENMA3B,2016-03-31,161318939,2864960,164183899
16608,456,$ENMA3B,2016-06-30,161318939,2864960,164183899
16608,456,$ENMA3B,2016-09-30,161318939,2864960,164183899
16608,456,$ENMA3B,2016-12-31,161318939,2864960,164183899
16608,456,$ENMA3B,2017-03-31,161318939,2864960,164183899
16608,456,$ENMA3B,2017-06-30,161318939,2864960,164183899
16608,456,$ENMA3B,2017-09-30,161318939,2864960,164183899
16608,456,$ENMA3B,2017-12-31,161318939,2864960,164183899
16608,456,$ENMA3B,2018-03-31,161318939,2864960,164183899
16608,456,$ENMA3B,2018-06-30,161318939,2864960,164183899
16608,456,$ENMA3B,2018-09-30,161318939,2864960,164183899
16608,456,$ENMA3B,2018-12-31,161318939,2864960,164183899
16608,456,$ENMA3B,2019-03-31,161318939,2864960,164183899
16608,456,$ENMA3B,2019-06-30,161318939,2864960,164183899
16608,456,$ENMA3B,2019-09-30,161318939,2864960,164183899
16608,456,$ENMA3B,2019-12-31,161318939,2864960,164183899
16608,456,$ENMA3B,2020-03-31,161318939,2864960,164183899
16608,456,$ENMA3B,2020-06-30,161318939,2864960,164183899
16608,456,$ENMA3B,2020-09-30,161318939,2864960,164183899
16616,268,$CEGR3,2010-12-31,51927546,0,51927546
16616,268,$CEGR3,2011-03-31,51927546,0,51927546
16616,268,$CEGR3,2011-06-30,51927546,0,51927546
16616,268,$CEGR3,2011-09-30,51927546,0,51927546
16616,268,$CEGR3,2011-12-31,51927546,0,51927546
16616,268,$CEGR3,2012-03-31,51927546,0,51927546
16616,268,$CEGR3,2012-06-30,51927546,0,51927546
16616,268,$CEGR3,2012-09-30,51927546,0,51927546
16616,268,$CEGR3,2012-12-31,51927546,0,51927546
16616,268,$CEGR3,2013-03-31,51927546,0,51927546
16616,268,$CEGR3,2013-06-30,51927546,0,51927546
16616,268,$CEGR3,2013-09-30,51927546,0,51927546
16616,268,$CEGR3,2013-12-31,51927546,0,51927546
16616,268,$CEGR3,2014-03-31,51927546,0,51927546
16616,268,$CEGR3,2014-06-30,51927546,0,51927546
16616,268,$CEGR3,2014-09-30,51927546,0,51927546
16616,268,$CEGR3,2014-12-31,51927546,0,51927546
16616,268,$CEGR3,2015-03-31,51927546,0,51927546
16616,268,$CEGR3,2015-06-30,51927546,0,51927546
16616,268,$CEGR3,2015-09-30,51927546,0,51927546
16616,268,$CEGR3,2015-12-31,51927546,0,51927546
16616,268,$CEGR3,2016-03-31,51927546,0,51927546
16616,268,$CEGR3,2016-06-30,259638,0,259638
16616,268,$CEGR3,2016-09-30,259638,0,259638
16616,268,$CEGR3,2016-12-31,259638,0,259638
16616,268,$CEGR3,2017-03-31,259638,0,259638
16616,268,$CEGR3,2017-06-30,259638,0,259638
16616,268,$CEGR3,2017-09-30,259638,0,259638
16616,268,$CEGR3,2017-12-31,259638,0,259638
16616,268,$CEGR3,2018-03-31,259638,0,259638
16616,268,$CEGR3,2018-06-30,259638,0,259638
16616,268,$CEGR3,2018-09-30,259638,0,259638
16616,268,$CEGR3,2018-12-31,259638,0,259638
16616,268,$CEGR3,2019-03-31,259638,0,259638
16616,268,$CEGR3,2019-06-30,259638,0,259638
16616,268,$CEGR3,2019-09-30,259638,0,259638
16616,268,$CEGR3,2019-12-31,259638,0,259638
16616,268,$CEGR3,2020-03-31,259638,0,259638
16616,268,$CEGR3,2020-06-30,259638,0,259638
16616,268,$CEGR3,2020-09-30,259638,0,259638
16624,457,$UPKP3B,2010-12-31,52437,0,52437
16624,457,$UPKP3B,2011-03-31,52437,0,52437
16624,457,$UPKP3B,2011-06-30,52437,0,52437
16624,457,$UPKP3B,2011-09-30,52437,0,52437
16624,457,$UPKP3B,2011-12-31,52437,0,52437
16624,457,$UPKP3B,2012-03-31,52437,0,52437
16624,457,$UPKP3B,2012-06-30,52437,0,52437
16624,457,$UPKP3B,2012-09-30,52437,0,52437
16624,457,$UPKP3B,2012-12-31,52437,0,52437
16624,457,$UPKP3B,2013-03-31,52437,0,52437
16624,457,$UPKP3B,2013-06-30,52437,0,52437
16624,457,$UPKP3B,2013-09-30,52437,0,52437
16624,457,$UPKP3B,2013-12-31,52437,0,52437
16624,457,$UPKP3B,2014-03-31,52437,0,52437
16624,457,$UPKP3B,2014-06-30,52437,0,52437
16624,457,$UPKP3B,2014-09-30,52437,0,52437
16624,457,$UPKP3B,2014-12-31,52437,0,52437
16624,457,$UPKP3B,2015-03-31,52437,0,52437
16624,457,$UPKP3B,2015-06-30,52437,0,52437
16624,457,$UPKP3B,2015-09-30,52437,0,52437
16624,457,$UPKP3B,2015-12-31,52437,0,52437
16624,457,$UPKP3B,2016-03-31,52437,0,52437
16624,457,$UPKP3B,2016-06-30,52437,0,52437
16624,457,$UPKP3B,2016-09-30,52437,0,52437
16624,457,$UPKP3B,2016-12-31,52437,0,52437
16624,457,$UPKP3B,2017-03-31,52437,0,52437
16624,457,$UPKP3B,2017-06-30,52437,0,52437
16624,457,$UPKP3B,2017-09-30,52437,0,52437
16624,457,$UPKP3B,2017-12-31,52437,0,52437
16624,457,$UPKP3B,2018-03-31,52437,0,52437
16624,457,$UPKP3B,2018-06-30,52437,0,52437
16624,457,$UPKP3B,2018-09-30,52437,0,52437
16624,457,$UPKP3B,2018-12-31,52437,0,52437
16624,457,$UPKP3B,2019-03-31,52437,0,52437
16624,457,$UPKP3B,2019-06-30,52437,0,52437
16624,457,$UPKP3B,2019-09-30,52437,0,52437
16624,457,$UPKP3B,2019-12-31,52437,0,52437
16624,457,$UPKP3B,2020-03-31,52437,0,52437
16624,457,$UPKP3B,2020-06-30,52437,0,52437
16624,457,$UPKP3B,2020-09-30,52437,0,52437
16632,274,$GPCP3,2010-12-31,104425,0,104425
16632,274,$GPCP3,2011-03-31,104425,0,104425
16632,274,$GPCP3,2011-06-30,104425,0,104425
16632,274,$GPCP3,2011-09-30,104425,0,104425
16632,274,$GPCP3,2011-12-31,358849702,0,358849702
16632,274,$GPCP3,2012-03-31,358849702,0,358849702
16632,274,$GPCP3,2012-06-30,358849702,0,358849702
16632,274,$GPCP3,2012-09-30,358849702,0,358849702
16632,274,$GPCP3,2012-12-31,358849702,0,358849702
16632,274,$GPCP3,2013-03-31,358849702,0,358849702
16632,274,$GPCP3,2013-06-30,358849702,0,358849702
16632,274,$GPCP3,2013-09-30,358849702,0,358849702
16632,274,$GPCP3,2013-12-31,358849702,0,358849702
16632,274,$GPCP3,2014-03-31,358849702,0,358849702
16632,274,$GPCP3,2014-06-30,358849702,0,358849702
16632,274,$GPCP3,2014-09-30,358849702,0,358849702
16632,274,$GPCP3,2014-12-31,358849702,0,358849702
16632,274,$GPCP3,2015-03-31,358849702,0,358849702
16632,274,$GPCP3,2015-06-30,358849702,0,358849702
16632,274,$GPCP3,2015-09-30,358849702,0,358849702
16632,274,$GPCP3,2015-12-31,358849702,0,358849702
16632,274,$GPCP3,2016-03-31,358849702,0,358849702
16632,274,$GPCP3,2016-06-30,5882782,0,5882782
16632,274,$GPCP3,2016-09-30,5882782,0,5882782
16632,274,$GPCP3,2016-12-31,5882782,0,5882782
16632,274,$GPCP3,2017-03-31,5882782,384787,6267569
16632,274,$GPCP3,2017-06-30,5882782,384787,6267569
16632,274,$GPCP3,2017-09-30,5882782,384787,6267569
16632,274,$GPCP3,2017-12-31,5882782,384787,6267569
16632,274,$GPCP3,2018-03-31,5882782,384787,6267569
16632,274,$GPCP3,2018-06-30,5882782,384787,6267569
16632,274,$GPCP3,2018-09-30,5882782,384787,6267569
16632,274,$GPCP3,2018-12-31,5882782,384787,6267569
16632,274,$GPCP3,2019-03-31,5882782,384787,6267569
16632,274,$GPCP3,2019-06-30,5882782,384787,6267569
16632,274,$GPCP3,2019-09-30,5882782,384787,6267569
16632,274,$GPCP3,2019-12-31,5882782,384787,6267569
16632,274,$GPCP3,2020-03-31,5882782,384787,6267569
16632,274,$GPCP3,2020-06-30,5882782,384787,6267569
16632,274,$GPCP3,2020-09-30,29413910,1923935,31337845
16632,279,$GPCP4,2010-12-31,104425,0,104425
16632,279,$GPCP4,2011-03-31,104425,0,104425
16632,279,$GPCP4,2011-06-30,104425,0,104425
16632,279,$GPCP4,2011-09-30,104425,0,104425
16632,279,$GPCP4,2011-12-31,358849702,0,358849702
16632,279,$GPCP4,2012-03-31,358849702,0,358849702
16632,279,$GPCP4,2012-06-30,358849702,0,358849702
16632,279,$GPCP4,2012-09-30,358849702,0,358849702
16632,279,$GPCP4,2012-12-31,358849702,0,358849702
16632,279,$GPCP4,2013-03-31,358849702,0,358849702
16632,279,$GPCP4,2013-06-30,358849702,0,358849702
16632,279,$GPCP4,2013-09-30,358849702,0,358849702
16632,279,$GPCP4,2013-12-31,358849702,0,358849702
16632,279,$GPCP4,2014-03-31,358849702,0,358849702
16632,279,$GPCP4,2014-06-30,358849702,0,358849702
16632,279,$GPCP4,2014-09-30,358849702,0,358849702
16632,279,$GPCP4,2014-12-31,358849702,0,358849702
16632,279,$GPCP4,2015-03-31,358849702,0,358849702
16632,279,$GPCP4,2015-06-30,358849702,0,358849702
16632,279,$GPCP4,2015-09-30,358849702,0,358849702
16632,279,$GPCP4,2015-12-31,358849702,0,358849702
16632,279,$GPCP4,2016-03-31,358849702,0,358849702
16632,279,$GPCP4,2016-06-30,5882782,0,5882782
16632,279,$GPCP4,2016-09-30,5882782,0,5882782
16632,279,$GPCP4,2016-12-31,5882782,0,5882782
16632,279,$GPCP4,2017-03-31,5882782,384787,6267569
16632,279,$GPCP4,2017-06-30,5882782,384787,6267569
16632,279,$GPCP4,2017-09-30,5882782,384787,6267569
16632,279,$GPCP4,2017-12-31,5882782,384787,6267569
16632,279,$GPCP4,2018-03-31,5882782,384787,6267569
16632,279,$GPCP4,2018-06-30,5882782,384787,6267569
16632,279,$GPCP4,2018-09-30,5882782,384787,6267569
16632,279,$GPCP4,2018-12-31,5882782,384787,6267569
16632,279,$GPCP4,2019-03-31,5882782,384787,6267569
16632,279,$GPCP4,2019-06-30,5882782,384787,6267569
16632,279,$GPCP4,2019-09-30,5882782,384787,6267569
16632,279,$GPCP4,2019-12-31,5882782,384787,6267569
16632,279,$GPCP4,2020-03-31,5882782,384787,6267569
16632,279,$GPCP4,2020-06-30,5882782,384787,6267569
16632,279,$GPCP4,2020-09-30,29413910,1923935,31337845
16659,282,$PSSA3,2010-12-31,327642,0,327642
16659,282,$PSSA3,2011-03-31,327642,0,327642
16659,282,$PSSA3,2011-06-30,327642,0,327642
16659,282,$PSSA3,2011-09-30,327642,0,327642
16659,282,$PSSA3,2011-12-31,327642,0,327642
16659,282,$PSSA3,2012-03-31,324669,0,324669
16659,282,$PSSA3,2012-06-30,324669,0,324669
16659,282,$PSSA3,2012-09-30,324669,0,324669
16659,282,$PSSA3,2012-12-31,324669,0,324669
16659,282,$PSSA3,2013-03-31,323293,0,323293
16659,282,$PSSA3,2013-06-30,323293,0,323293
16659,282,$PSSA3,2013-09-30,323293,0,323293
16659,282,$PSSA3,2013-12-31,323293,0,323293
16659,282,$PSSA3,2014-03-31,323293,0,323293
16659,282,$PSSA3,2014-06-30,323293,0,323293
16659,282,$PSSA3,2014-09-30,323293,0,323293
16659,282,$PSSA3,2014-12-31,323293,0,323293
16659,282,$PSSA3,2015-03-31,323293,0,323293
16659,282,$PSSA3,2015-06-30,323293,0,323293
16659,282,$PSSA3,2015-09-30,323293,0,323293
16659,282,$PSSA3,2015-12-31,323293,0,323293
16659,282,$PSSA3,2016-03-31,323293,0,323293
16659,282,$PSSA3,2016-06-30,323293,0,323293
16659,282,$PSSA3,2016-09-30,323293,0,323293
16659,282,$PSSA3,2016-12-31,323293,0,323293
16659,282,$PSSA3,2017-03-31,323293,0,323293
16659,282,$PSSA3,2017-06-30,323293,0,323293
16659,282,$PSSA3,2017-09-30,323293,0,323293
16659,282,$PSSA3,2017-12-31,323293,0,323293
16659,282,$PSSA3,2018-03-31,323293,0,323293
16659,282,$PSSA3,2018-06-30,323293,0,323293
16659,282,$PSSA3,2018-09-30,323293,0,323293
16659,282,$PSSA3,2018-12-31,323293,0,323293
16659,282,$PSSA3,2019-03-31,323263,0,323263
16659,282,$PSSA3,2019-06-30,323293,0,323293
16659,282,$PSSA3,2019-09-30,323293,0,323293
16659,282,$PSSA3,2019-12-31,323293,0,323293
16659,282,$PSSA3,2020-03-31,323293,0,323293
16659,282,$PSSA3,2020-06-30,323293,0,323293
16659,282,$PSSA3,2020-09-30,323293,0,323293
16705,458,$ALEF3B,2010-12-31,21394000,0,21394000
16705,458,$ALEF3B,2011-03-31,21394000,0,21394000
16705,458,$ALEF3B,2011-06-30,21394000,0,21394000
16705,458,$ALEF3B,2011-09-30,21394000,0,21394000
16705,458,$ALEF3B,2011-12-31,21394000,0,21394000
16705,458,$ALEF3B,2012-03-31,21474000,0,21474000
16705,458,$ALEF3B,2012-06-30,21474000,0,21474000
16705,458,$ALEF3B,2012-09-30,21474000,0,21474000
16705,458,$ALEF3B,2012-12-31,26474000,0,26474000
16705,458,$ALEF3B,2013-03-31,26474000,0,26474000
16705,458,$ALEF3B,2013-06-30,26474000,0,26474000
16705,458,$ALEF3B,2013-09-30,26474000,0,26474000
16705,458,$ALEF3B,2013-12-31,26474000,0,26474000
16705,458,$ALEF3B,2014-03-31,36474000,0,36474000
16705,458,$ALEF3B,2014-06-30,36474000,0,36474000
16705,458,$ALEF3B,2014-09-30,36474000,0,36474000
16705,458,$ALEF3B,2014-12-31,36474000,0,36474000
16705,458,$ALEF3B,2015-03-31,44474000,0,44474000
16705,458,$ALEF3B,2015-06-30,44474000,0,44474000
16705,458,$ALEF3B,2015-09-30,44474000,0,44474000
16705,458,$ALEF3B,2015-12-31,44474000,0,44474000
16705,458,$ALEF3B,2016-03-31,54674000,0,54674000
16705,458,$ALEF3B,2016-06-30,54674000,0,54674000
16705,458,$ALEF3B,2016-09-30,54674000,0,54674000
16705,458,$ALEF3B,2016-12-31,54674000,0,54674000
16705,458,$ALEF3B,2017-03-31,65674000,0,65674000
16705,458,$ALEF3B,2017-06-30,65674000,0,65674000
16705,458,$ALEF3B,2017-09-30,65674000,0,65674000
16705,458,$ALEF3B,2017-12-31,65674000,0,65674000
16705,458,$ALEF3B,2018-03-31,78674000,0,78674000
16705,458,$ALEF3B,2018-06-30,78674000,0,78674000
16705,458,$ALEF3B,2018-09-30,78674000,0,78674000
16705,458,$ALEF3B,2018-12-31,78674000,0,78674000
16705,458,$ALEF3B,2019-03-31,98674000,0,98674000
16705,458,$ALEF3B,2019-06-30,98674000,0,98674000
16705,458,$ALEF3B,2019-09-30,98674000,0,98674000
16705,458,$ALEF3B,2019-12-31,98674000,0,98674000
16705,458,$ALEF3B,2020-03-31,116574000,0,116574000
16705,458,$ALEF3B,2020-06-30,116574000,0,116574000
16705,458,$ALEF3B,2020-09-30,116574000,0,116574000
16861,275,$CASN3,2010-12-31,351280,351280,702560
16861,275,$CASN3,2011-03-31,351280,351280,702560
16861,275,$CASN3,2011-06-30,351280,351280,702560
16861,275,$CASN3,2011-09-30,351280,351280,702560
16861,275,$CASN3,2011-12-31,357547216,357547216,715094432
16861,275,$CASN3,2012-03-31,357547216,357547216,715094432
16861,275,$CASN3,2012-06-30,357547216,357547216,715094432
16861,275,$CASN3,2012-09-30,357547216,357547216,715094432
16861,275,$CASN3,2012-12-31,357547216,357547216,715094432
16861,275,$CASN3,2013-03-31,357547216,357547216,715094432
16861,275,$CASN3,2013-06-30,357547216,357547216,715094432
16861,275,$CASN3,2013-09-30,357547216,357547216,715094432
16861,275,$CASN3,2013-12-31,357547216,357547216,715094432
16861,275,$CASN3,2014-03-31,357547216,357547216,715094432
16861,275,$CASN3,2014-06-30,357547216,357547216,715094432
16861,275,$CASN3,2014-09-30,357547216,357547216,715094432
16861,275,$CASN3,2014-12-31,357547216,357547216,715094432
16861,275,$CASN3,2015-03-31,357547216,357547216,715094432
16861,275,$CASN3,2015-06-30,357547216,357547216,715094432
16861,275,$CASN3,2015-09-30,357547216,357547216,715094432
16861,275,$CASN3,2015-12-31,357547216,357547216,715094432
16861,275,$CASN3,2016-03-31,357547216,357547216,715094432
16861,275,$CASN3,2016-06-30,357547216,357547216,715094432
16861,275,$CASN3,2016-09-30,357547216,357547216,715094432
16861,275,$CASN3,2016-12-31,357547216,357547216,715094432
16861,275,$CASN3,2017-03-31,357547216,357547216,715094432
16861,275,$CASN3,2017-06-30,357547216,357547216,715094432
16861,275,$CASN3,2017-09-30,357547216,357547216,715094432
16861,275,$CASN3,2017-12-31,357547216,357547216,715094432
16861,275,$CASN3,2018-03-31,357547216,357547216,715094432
16861,275,$CASN3,2018-06-30,357547216,357547216,715094432
16861,275,$CASN3,2018-09-30,357547216,357547216,715094432
16861,275,$CASN3,2018-12-31,357547216,357547216,715094432
16861,275,$CASN3,2019-03-31,357547216,357547216,715094432
16861,275,$CASN3,2019-06-30,357547216,357547216,715094432
16861,275,$CASN3,2019-09-30,357547216,357547216,715094432
16861,275,$CASN3,2019-12-31,357547216,357547216,715094432
16861,275,$CASN3,2020-03-31,357547216,357547216,715094432
16861,275,$CASN3,2020-06-30,357547216,357547216,715094432
16861,275,$CASN3,2020-09-30,375538169,375792673,751330842
16861,276,$CASN4,2010-12-31,351280,351280,702560
16861,276,$CASN4,2011-03-31,351280,351280,702560
16861,276,$CASN4,2011-06-30,351280,351280,702560
16861,276,$CASN4,2011-09-30,351280,351280,702560
16861,276,$CASN4,2011-12-31,357547216,357547216,715094432
16861,276,$CASN4,2012-03-31,357547216,357547216,715094432
16861,276,$CASN4,2012-06-30,357547216,357547216,715094432
16861,276,$CASN4,2012-09-30,357547216,357547216,715094432
16861,276,$CASN4,2012-12-31,357547216,357547216,715094432
16861,276,$CASN4,2013-03-31,357547216,357547216,715094432
16861,276,$CASN4,2013-06-30,357547216,357547216,715094432
16861,276,$CASN4,2013-09-30,357547216,357547216,715094432
16861,276,$CASN4,2013-12-31,357547216,357547216,715094432
16861,276,$CASN4,2014-03-31,357547216,357547216,715094432
16861,276,$CASN4,2014-06-30,357547216,357547216,715094432
16861,276,$CASN4,2014-09-30,357547216,357547216,715094432
16861,276,$CASN4,2014-12-31,357547216,357547216,715094432
16861,276,$CASN4,2015-03-31,357547216,357547216,715094432
16861,276,$CASN4,2015-06-30,357547216,357547216,715094432
16861,276,$CASN4,2015-09-30,357547216,357547216,715094432
16861,276,$CASN4,2015-12-31,357547216,357547216,715094432
16861,276,$CASN4,2016-03-31,357547216,357547216,715094432
16861,276,$CASN4,2016-06-30,357547216,357547216,715094432
16861,276,$CASN4,2016-09-30,357547216,357547216,715094432
16861,276,$CASN4,2016-12-31,357547216,357547216,715094432
16861,276,$CASN4,2017-03-31,357547216,357547216,715094432
16861,276,$CASN4,2017-06-30,357547216,357547216,715094432
16861,276,$CASN4,2017-09-30,357547216,357547216,715094432
16861,276,$CASN4,2017-12-31,357547216,357547216,715094432
16861,276,$CASN4,2018-03-31,357547216,357547216,715094432
16861,276,$CASN4,2018-06-30,357547216,357547216,715094432
16861,276,$CASN4,2018-09-30,357547216,357547216,715094432
16861,276,$CASN4,2018-12-31,357547216,357547216,715094432
16861,276,$CASN4,2019-03-31,357547216,357547216,715094432
16861,276,$CASN4,2019-06-30,357547216,357547216,715094432
16861,276,$CASN4,2019-09-30,357547216,357547216,715094432
16861,276,$CASN4,2019-12-31,357547216,357547216,715094432
16861,276,$CASN4,2020-03-31,357547216,357547216,715094432
16861,276,$CASN4,2020-06-30,357547216,357547216,715094432
16861,276,$CASN4,2020-09-30,375538169,375792673,751330842
16942,459,$OPHE3B,2010-12-31,861681921,0,861681921
16942,459,$OPHE3B,2011-03-31,861682,0,861682
16942,459,$OPHE3B,2011-06-30,862901,0,862901
16942,459,$OPHE3B,2011-09-30,862901,0,862901
16942,459,$OPHE3B,2011-12-31,862603827,0,862603827
16942,459,$OPHE3B,2012-03-31,862603827,0,862603827
16942,459,$OPHE3B,2012-06-30,862603827,0,862603827
16942,459,$OPHE3B,2012-09-30,882703827,0,882703827
16942,459,$OPHE3B,2012-12-31,882703827,0,882703827
16942,459,$OPHE3B,2013-03-31,882703827,0,882703827
16942,459,$OPHE3B,2013-06-30,882703827,0,882703827
16942,459,$OPHE3B,2013-09-30,882703827,0,882703827
16942,459,$OPHE3B,2013-12-31,882703827,0,882703827
16942,459,$OPHE3B,2014-03-31,882703827,0,882703827
16942,459,$OPHE3B,2014-06-30,896703827,0,896703827
16942,459,$OPHE3B,2014-09-30,896703827,0,896703827
16942,459,$OPHE3B,2014-12-31,896703827,0,896703827
16942,459,$OPHE3B,2015-03-31,1206703827,0,1206703827
16942,459,$OPHE3B,2015-06-30,1206703827,0,1206703827
16942,459,$OPHE3B,2015-09-30,1206703827,0,1206703827
16942,459,$OPHE3B,2015-12-31,1206703827,0,1206703827
16942,459,$OPHE3B,2016-03-31,1206703827,0,1206703827
16942,459,$OPHE3B,2016-06-30,1206703827,0,1206703827
16942,459,$OPHE3B,2016-09-30,1206703827,0,1206703827
16942,459,$OPHE3B,2016-12-31,1206703827,0,1206703827
16942,459,$OPHE3B,2017-03-31,1206703827,0,1206703827
16942,459,$OPHE3B,2017-06-30,1206703827,0,1206703827
16942,459,$OPHE3B,2017-09-30,1206703827,0,1206703827
16942,459,$OPHE3B,2017-12-31,1206703827,0,1206703827
16942,459,$OPHE3B,2018-03-31,1206703827,0,1206703827
16942,459,$OPHE3B,2018-06-30,1206703827,0,1206703827
16942,459,$OPHE3B,2018-09-30,1206703827,0,1206703827
16942,459,$OPHE3B,2018-12-31,1206703827,0,1206703827
16942,459,$OPHE3B,2019-03-31,1206703827,0,1206703827
16942,459,$OPHE3B,2019-06-30,1206703827,0,1206703827
16942,459,$OPHE3B,2019-09-30,1816703827,0,1816703827
16942,459,$OPHE3B,2019-12-31,1816703827,0,1816703827
16942,459,$OPHE3B,2020-03-31,1816703827,0,1816703827
16942,459,$OPHE3B,2020-06-30,1816703827,0,1816703827
16942,459,$OPHE3B,2020-09-30,1816703827,0,1816703827
16993,283,$EMAE4,2010-12-31,14705,22242,36947
16993,283,$EMAE4,2011-03-31,14705,22242,36947
16993,283,$EMAE4,2011-06-30,14705,22242,36947
16993,283,$EMAE4,2011-09-30,14705,22242,36947
16993,283,$EMAE4,2011-12-31,14705,22242,36947
16993,283,$EMAE4,2012-03-31,14705,22242,36947
16993,283,$EMAE4,2012-06-30,14705,22242,36947
16993,283,$EMAE4,2012-09-30,14705,22242,36947
16993,283,$EMAE4,2012-12-31,14705,22242,36947
16993,283,$EMAE4,2013-03-31,14705,22242,36947
16993,283,$EMAE4,2013-06-30,14705,22242,36947
16993,283,$EMAE4,2013-09-30,14705,22242,36947
16993,283,$EMAE4,2013-12-31,14705,22242,36947
16993,283,$EMAE4,2014-03-31,14705,22242,36947
16993,283,$EMAE4,2014-06-30,14705,22242,36947
16993,283,$EMAE4,2014-09-30,14705,22242,36947
16993,283,$EMAE4,2014-12-31,14705,22242,36947
16993,283,$EMAE4,2015-03-31,14705,22242,36947
16993,283,$EMAE4,2015-06-30,14705,22242,36947
16993,283,$EMAE4,2015-09-30,14705,22242,36947
16993,283,$EMAE4,2015-12-31,14705,22242,36947
16993,283,$EMAE4,2016-03-31,14705,22242,36947
16993,283,$EMAE4,2016-06-30,14705,22242,36947
16993,283,$EMAE4,2016-09-30,14705,22242,36947
16993,283,$EMAE4,2016-12-31,14705,22242,36947
16993,283,$EMAE4,2017-03-31,14705,22242,36947
16993,283,$EMAE4,2017-06-30,14705,22242,36947
16993,283,$EMAE4,2017-09-30,14705,22242,36947
16993,283,$EMAE4,2017-12-31,14705,22242,36947
16993,283,$EMAE4,2018-03-31,14705,22242,36947
16993,283,$EMAE4,2018-06-30,14705,22242,36947
16993,283,$EMAE4,2018-09-30,14705,22242,36947
16993,283,$EMAE4,2018-12-31,14705,22242,36947
16993,283,$EMAE4,2019-03-31,14705,22242,36947
16993,283,$EMAE4,2019-06-30,14705,22242,36947
16993,283,$EMAE4,2019-09-30,14705,22242,36947
16993,283,$EMAE4,2019-12-31,14705,22242,36947
16993,283,$EMAE4,2020-03-31,14705,22242,36947
16993,283,$EMAE4,2020-06-30,14705,22242,36947
16993,283,$EMAE4,2020-09-30,14705,22242,36947
17329,287,$EGIE3,2010-12-31,652742192,0,652742192
17329,287,$EGIE3,2011-03-31,652742192,0,652742192
17329,287,$EGIE3,2011-06-30,652742192,0,652742192
17329,287,$EGIE3,2011-09-30,652742192,0,652742192
17329,287,$EGIE3,2011-12-31,652742192,0,652742192
17329,287,$EGIE3,2012-03-31,652742192,0,652742192
17329,287,$EGIE3,2012-06-30,652742192,0,652742192
17329,287,$EGIE3,2012-09-30,652742192,0,652742192
17329,287,$EGIE3,2012-12-31,652742192,0,652742192
17329,287,$EGIE3,2013-03-31,652742192,0,652742192
17329,287,$EGIE3,2013-06-30,652742192,0,652742192
17329,287,$EGIE3,2013-09-30,652742192,0,652742192
17329,287,$EGIE3,2013-12-31,652742192,0,652742192
17329,287,$EGIE3,2014-03-31,652742192,0,652742192
17329,287,$EGIE3,2014-06-30,652742192,0,652742192
17329,287,$EGIE3,2014-09-30,652742192,0,652742192
17329,287,$EGIE3,2014-12-31,652742192,0,652742192
17329,287,$EGIE3,2015-03-31,652742192,0,652742192
17329,287,$EGIE3,2015-06-30,652742192,0,652742192
17329,287,$EGIE3,2015-09-30,652742192,0,652742192
17329,287,$EGIE3,2015-12-31,652742192,0,652742192
17329,287,$EGIE3,2016-03-31,652742192,0,652742192
17329,287,$EGIE3,2016-06-30,652742192,0,652742192
17329,287,$EGIE3,2016-09-30,652742192,0,652742192
17329,287,$EGIE3,2016-12-31,652742192,0,652742192
17329,287,$EGIE3,2017-03-31,652742192,0,652742192
17329,287,$EGIE3,2017-06-30,652742192,0,652742192
17329,287,$EGIE3,2017-09-30,652742192,0,652742192
17329,287,$EGIE3,2017-12-31,652742192,0,652742192
17329,287,$EGIE3,2018-03-31,652742192,0,652742192
17329,287,$EGIE3,2018-06-30,652742192,0,652742192
17329,287,$EGIE3,2018-09-30,652742192,0,652742192
17329,287,$EGIE3,2018-12-31,815927740,0,815927740
17329,287,$EGIE3,2019-03-31,815927740,0,815927740
17329,287,$EGIE3,2019-06-30,815927740,0,815927740
17329,287,$EGIE3,2019-09-30,815927740,0,815927740
17329,287,$EGIE3,2019-12-31,815927740,0,815927740
17329,287,$EGIE3,2020-03-31,815927740,0,815927740
17329,287,$EGIE3,2020-06-30,815927740,0,815927740
17329,287,$EGIE3,2020-09-30,815927740,0,815927740
17388,460,$FTRT3B,2010-12-31,209378,0,209378
17388,460,$FTRT3B,2011-03-31,209378,0,209378
17388,460,$FTRT3B,2011-06-30,209378,0,209378
17388,460,$FTRT3B,2011-09-30,209378,0,209378
17388,460,$FTRT3B,2011-12-31,209378,0,209378
17388,460,$FTRT3B,2012-03-31,209378,0,209378
17388,460,$FTRT3B,2012-06-30,209377678,0,209377678
17388,460,$FTRT3B,2012-09-30,209378,0,209378
17388,460,$FTRT3B,2012-12-31,209378,0,209378
17388,460,$FTRT3B,2013-03-31,209377,0,209377
17388,460,$FTRT3B,2013-06-30,209377,0,209377
17388,460,$FTRT3B,2013-09-30,209377,0,209377
17388,460,$FTRT3B,2013-12-31,209378,0,209378
17388,460,$FTRT3B,2014-03-31,209378,0,209378
17388,460,$FTRT3B,2014-06-30,209377,0,209377
17388,460,$FTRT3B,2014-09-30,209377,0,209377
17388,460,$FTRT3B,2014-12-31,597684,0,597684
17388,460,$FTRT3B,2015-03-31,597684,0,597684
17388,460,$FTRT3B,2015-06-30,604743,0,604743
17388,460,$FTRT3B,2015-09-30,604743,0,604743
17388,460,$FTRT3B,2015-12-31,604743,0,604743
17388,460,$FTRT3B,2016-03-31,604743,0,604743
17388,460,$FTRT3B,2016-06-30,604743,0,604743
17388,460,$FTRT3B,2016-09-30,604743,0,604743
17388,460,$FTRT3B,2016-12-31,604743,0,604743
17388,460,$FTRT3B,2017-03-31,604743,0,604743
17388,460,$FTRT3B,2017-06-30,604743,0,604743
17388,460,$FTRT3B,2017-09-30,604743,0,604743
17388,460,$FTRT3B,2017-12-31,604742,0,604742
17388,460,$FTRT3B,2018-03-31,604743,0,604743
17388,460,$FTRT3B,2018-06-30,604743,0,604743
17388,460,$FTRT3B,2018-09-30,604743,0,604743
17388,460,$FTRT3B,2018-12-31,604742,0,604742
17450,299,$RAIL3,2010-12-31,689122312,0,689122312
17450,299,$RAIL3,2011-03-31,689122,0,689122
17450,299,$RAIL3,2011-06-30,689122312,0,689122312
17450,299,$RAIL3,2011-09-30,689122312,0,689122312
17450,299,$RAIL3,2011-12-31,687664312,0,687664312
17450,299,$RAIL3,2012-03-31,687664312,0,687664312
17450,299,$RAIL3,2012-06-30,687664312,0,687664312
17450,299,$RAIL3,2012-09-30,687664312,0,687664312
17450,299,$RAIL3,2012-12-31,687664312,0,687664312
17450,299,$RAIL3,2013-03-31,687664312,0,687664312
17450,299,$RAIL3,2013-06-30,687664312,0,687664312
17450,299,$RAIL3,2013-09-30,687664312,0,687664312
17450,299,$RAIL3,2013-12-31,687664312,0,687664312
17450,299,$RAIL3,2014-03-31,687664312,0,687664312
17450,299,$RAIL3,2014-06-30,687664312,0,687664312
17450,299,$RAIL3,2014-09-30,687664312,0,687664312
17450,299,$RAIL3,2014-12-31,687664312,0,687664312
17450,299,$RAIL3,2015-03-31,687664312,0,687664312
17450,299,$RAIL3,2015-06-30,681995165,0,681995165
17450,299,$RAIL3,2015-09-30,681995165,0,681995165
17450,299,$RAIL3,2015-12-31,681995165,0,681995165
17450,299,$RAIL3,2016-03-31,2616038002,0,2616038002
17450,299,$RAIL3,2016-06-30,2616038002,0,2616038002
17450,299,$RAIL3,2016-09-30,2616038002,0,2616038002
17450,299,$RAIL3,2016-12-31,1339015898,0,1339015898
17450,299,$RAIL3,2017-03-31,1339015898,0,1339015898
17450,299,$RAIL3,2017-06-30,1339015898,0,1339015898
17450,299,$RAIL3,2017-09-30,1339015898,0,1339015898
17450,299,$RAIL3,2017-12-31,1559015898,0,1559015898
17450,299,$RAIL3,2018-03-31,1559015898,0,1559015898
17450,299,$RAIL3,2018-06-30,1559015898,0,1559015898
17450,299,$RAIL3,2018-09-30,1559015898,0,1559015898
17450,299,$RAIL3,2018-12-31,1559015898,0,1559015898
17450,299,$RAIL3,2019-03-31,1559015898,0,1559015898
17450,299,$RAIL3,2019-06-30,1559015898,0,1559015898
17450,299,$RAIL3,2019-09-30,1559015898,0,1559015898
17450,299,$RAIL3,2019-12-31,1559015898,0,1559015898
17450,299,$RAIL3,2020-03-31,1559015898,0,1559015898
17450,299,$RAIL3,2020-06-30,1559015898,0,1559015898
17450,299,$RAIL3,2020-09-30,1853268772,0,1853268772
17485,285,$EKTR3,2010-12-31,91880972,101878293,193759265
17485,285,$EKTR3,2011-03-31,91880972,101878293,193759265
17485,285,$EKTR3,2011-06-30,91880972,101878293,193759265
17485,285,$EKTR3,2011-09-30,91880972,101878293,193759265
17485,285,$EKTR3,2011-12-31,91880972,101878293,193759265
17485,285,$EKTR3,2012-03-31,91880972,101878293,193759265
17485,285,$EKTR3,2012-06-30,91880972,101878293,193759265
17485,285,$EKTR3,2012-09-30,91880972,101878293,193759265
17485,285,$EKTR3,2012-12-31,91880972,101878293,193759265
17485,285,$EKTR3,2013-03-31,91880972,101878293,193759265
17485,285,$EKTR3,2013-06-30,91880972,101878293,193759265
17485,285,$EKTR3,2013-09-30,91880972,101878293,193759265
17485,285,$EKTR3,2013-12-31,91880972,101878293,193759265
17485,285,$EKTR3,2014-03-31,91880972,101878293,193759265
17485,285,$EKTR3,2014-06-30,91880972,101878293,193759265
17485,285,$EKTR3,2014-09-30,91880972,101878293,193759265
17485,285,$EKTR3,2014-12-31,91880972,101878293,193759265
17485,285,$EKTR3,2015-03-31,91880972,101878293,193759265
17485,285,$EKTR3,2015-06-30,91880972,101878293,193759265
17485,285,$EKTR3,2015-09-30,91880972,101878293,193759265
17485,285,$EKTR3,2015-12-31,91880972,101878293,193759265
17485,285,$EKTR3,2016-03-31,91880972,101878293,193759265
17485,285,$EKTR3,2016-06-30,91880972,101878293,193759265
17485,285,$EKTR3,2016-09-30,91880972,101878293,193759265
17485,285,$EKTR3,2016-12-31,91880972,101878293,193759265
17485,285,$EKTR3,2017-03-31,91880972,101878293,193759265
17485,285,$EKTR3,2017-06-30,91880972,101878293,193759265
17485,285,$EKTR3,2017-09-30,91880972,101878293,193759265
17485,285,$EKTR3,2017-12-31,91880972,101878293,193759265
17485,285,$EKTR3,2018-03-31,91880972,101878293,193759265
17485,285,$EKTR3,2018-06-30,91880972,101878293,193759265
17485,285,$EKTR3,2018-09-30,91880972,101878293,193759265
17485,285,$EKTR3,2018-12-31,91880972,101878293,193759265
17485,285,$EKTR3,2019-03-31,91880972,101878293,193759265
17485,285,$EKTR3,2019-06-30,91880972,101878293,193759265
17485,285,$EKTR3,2019-09-30,91881,101879,193760
17485,285,$EKTR3,2019-12-31,91881,101879,193760
17485,285,$EKTR3,2020-03-31,91881,101879,193760
17485,285,$EKTR3,2020-06-30,91881,101879,193760
17485,285,$EKTR3,2020-09-30,91881,101879,193760
17485,286,$EKTR4,2010-12-31,91880972,101878293,193759265
17485,286,$EKTR4,2011-03-31,91880972,101878293,193759265
17485,286,$EKTR4,2011-06-30,91880972,101878293,193759265
17485,286,$EKTR4,2011-09-30,91880972,101878293,193759265
17485,286,$EKTR4,2011-12-31,91880972,101878293,193759265
17485,286,$EKTR4,2012-03-31,91880972,101878293,193759265
17485,286,$EKTR4,2012-06-30,91880972,101878293,193759265
17485,286,$EKTR4,2012-09-30,91880972,101878293,193759265
17485,286,$EKTR4,2012-12-31,91880972,101878293,193759265
17485,286,$EKTR4,2013-03-31,91880972,101878293,193759265
17485,286,$EKTR4,2013-06-30,91880972,101878293,193759265
17485,286,$EKTR4,2013-09-30,91880972,101878293,193759265
17485,286,$EKTR4,2013-12-31,91880972,101878293,193759265
17485,286,$EKTR4,2014-03-31,91880972,101878293,193759265
17485,286,$EKTR4,2014-06-30,91880972,101878293,193759265
17485,286,$EKTR4,2014-09-30,91880972,101878293,193759265
17485,286,$EKTR4,2014-12-31,91880972,101878293,193759265
17485,286,$EKTR4,2015-03-31,91880972,101878293,193759265
17485,286,$EKTR4,2015-06-30,91880972,101878293,193759265
17485,286,$EKTR4,2015-09-30,91880972,101878293,193759265
17485,286,$EKTR4,2015-12-31,91880972,101878293,193759265
17485,286,$EKTR4,2016-03-31,91880972,101878293,193759265
17485,286,$EKTR4,2016-06-30,91880972,101878293,193759265
17485,286,$EKTR4,2016-09-30,91880972,101878293,193759265
17485,286,$EKTR4,2016-12-31,91880972,101878293,193759265
17485,286,$EKTR4,2017-03-31,91880972,101878293,193759265
17485,286,$EKTR4,2017-06-30,91880972,101878293,193759265
17485,286,$EKTR4,2017-09-30,91880972,101878293,193759265
17485,286,$EKTR4,2017-12-31,91880972,101878293,193759265
17485,286,$EKTR4,2018-03-31,91880972,101878293,193759265
17485,286,$EKTR4,2018-06-30,91880972,101878293,193759265
17485,286,$EKTR4,2018-09-30,91880972,101878293,193759265
17485,286,$EKTR4,2018-12-31,91880972,101878293,193759265
17485,286,$EKTR4,2019-03-31,91880972,101878293,193759265
17485,286,$EKTR4,2019-06-30,91880972,101878293,193759265
17485,286,$EKTR4,2019-09-30,91881,101879,193760
17485,286,$EKTR4,2019-12-31,91881,101879,193760
17485,286,$EKTR4,2020-03-31,91881,101879,193760
17485,286,$EKTR4,2020-06-30,91881,101879,193760
17485,286,$EKTR4,2020-09-30,91881,101879,193760
17540,462,$NEWT3B,2010-12-31,691309,0,691309
17540,462,$NEWT3B,2011-03-31,691309,0,691309
17540,462,$NEWT3B,2011-06-30,691309,0,691309
17540,462,$NEWT3B,2011-09-30,691309,0,691309
17540,462,$NEWT3B,2011-12-31,691309,0,691309
17540,462,$NEWT3B,2012-03-31,691309,0,691309
17540,462,$NEWT3B,2012-06-30,691308698,0,691308698
17540,462,$NEWT3B,2012-09-30,691309,0,691309
17540,462,$NEWT3B,2012-12-31,691309,0,691309
17540,462,$NEWT3B,2013-03-31,691309,0,691309
17540,462,$NEWT3B,2013-06-30,691309,0,691309
17540,462,$NEWT3B,2013-09-30,691309,0,691309
17540,462,$NEWT3B,2013-12-31,691309,0,691309
17540,462,$NEWT3B,2014-03-31,691309,0,691309
17540,462,$NEWT3B,2014-06-30,691309,0,691309
17540,462,$NEWT3B,2014-09-30,691309,0,691309
17540,462,$NEWT3B,2014-12-31,1698194,0,1698194
17540,462,$NEWT3B,2015-03-31,1698194,0,1698194
17540,462,$NEWT3B,2015-06-30,1698194,0,1698194
17540,462,$NEWT3B,2015-09-30,1698194,0,1698194
17540,462,$NEWT3B,2015-12-31,1698194,0,1698194
17540,462,$NEWT3B,2016-03-31,1698194,0,1698194
17540,462,$NEWT3B,2016-06-30,1698194,0,1698194
17540,462,$NEWT3B,2016-09-30,1698194,0,1698194
17540,462,$NEWT3B,2016-12-31,1698194,0,1698194
17540,462,$NEWT3B,2017-03-31,1698194,0,1698194
17540,462,$NEWT3B,2017-06-30,1698194,0,1698194
17540,462,$NEWT3B,2017-09-30,1698194,0,1698194
17540,462,$NEWT3B,2017-12-31,1698194,0,1698194
17540,462,$NEWT3B,2018-03-31,1698194,0,1698194
17540,462,$NEWT3B,2018-06-30,1698194,0,1698194
17540,462,$NEWT3B,2018-09-30,1698194,0,1698194
17540,462,$NEWT3B,2018-12-31,1698194,0,1698194
17558,577,$SLCTB3,2019-12-31,50612981,0,50612981
17639,291,$TIMP3,2010-12-31,843281477,1632453583,2475735060
17639,291,$TIMP3,2011-03-31,843281477,1632453583,2475735060
17639,291,$TIMP3,2011-06-30,843986515,1633818420,2477804935
17639,291,$TIMP3,2011-09-30,2217374279,0,2217374279
17639,291,$TIMP3,2011-12-31,2417632647,0,2417632647
17639,291,$TIMP3,2012-03-31,2417632647,0,2417632647
17639,291,$TIMP3,2012-06-30,2417632647,0,2417632647
17639,291,$TIMP3,2012-09-30,2417632647,0,2417632647
17639,291,$TIMP3,2012-12-31,2417632647,0,2417632647
17639,291,$TIMP3,2013-03-31,2417632647,0,2417632647
17639,291,$TIMP3,2013-06-30,2417632647,0,2417632647
17639,291,$TIMP3,2013-09-30,2417632647,0,2417632647
17639,291,$TIMP3,2013-12-31,2417632647,0,2417632647
17639,291,$TIMP3,2014-03-31,2417632647,0,2417632647
17639,291,$TIMP3,2014-06-30,2417632647,0,2417632647
17639,291,$TIMP3,2014-09-30,2420136000,0,2420136000
17639,291,$TIMP3,2014-12-31,2421032479,0,2421032479
17639,291,$TIMP3,2015-03-31,2421032479,0,2421032479
17639,291,$TIMP3,2015-06-30,2421032479,0,2421032479
17639,291,$TIMP3,2015-09-30,2421032479,0,2421032479
17639,291,$TIMP3,2015-12-31,2421032479,0,2421032479
17639,291,$TIMP3,2016-03-31,2421032479,0,2421032479
17639,291,$TIMP3,2016-06-30,2421032479,0,2421032479
17639,291,$TIMP3,2016-09-30,2421032479,0,2421032479
17639,291,$TIMP3,2016-12-31,2421032479,0,2421032479
17639,291,$TIMP3,2017-03-31,2421032479,0,2421032479
17639,291,$TIMP3,2017-06-30,2421032479,0,2421032479
17639,291,$TIMP3,2017-09-30,2421032479,0,2421032479
17639,291,$TIMP3,2017-12-31,2421032479,0,2421032479
17639,291,$TIMP3,2018-03-31,2421032479,0,2421032479
17639,291,$TIMP3,2018-06-30,2421032479,0,2421032479
17639,291,$TIMP3,2018-09-30,2421032479,0,2421032479
17639,291,$TIMP3,2018-12-31,2421032479,0,2421032479
17639,291,$TIMP3,2019-03-31,2421032479,0,2421032479
17639,291,$TIMP3,2019-06-30,2421032479,0,2421032479
17639,291,$TIMP3,2019-09-30,2421032479,0,2421032479
17639,291,$TIMP3,2019-12-31,2421032479,0,2421032479
17639,291,$TIMP3,2020-03-31,2421032479,0,2421032479
17639,291,$TIMP3,2020-06-30,2421032479,0,2421032479
17671,297,$VIVT4,2010-12-31,168820,337417,506237
17671,297,$VIVT4,2011-03-31,168820,337417,506237
17671,297,$VIVT4,2011-06-30,381587,744015,1125602
17671,297,$VIVT4,2011-09-30,381587,744015,1125602
17671,297,$VIVT4,2011-12-31,381587,744015,1125602
17671,297,$VIVT4,2012-03-31,381587,744015,1125602
17671,297,$VIVT4,2012-06-30,381587,744015,1125602
17671,297,$VIVT4,2012-09-30,381587,744015,1125602
17671,297,$VIVT4,2012-12-31,381587,744015,1125602
17671,297,$VIVT4,2013-03-31,381587,744015,1125602
17671,297,$VIVT4,2013-06-30,381587,744015,1125602
17671,297,$VIVT4,2013-09-30,381587,744015,1125602
17671,297,$VIVT4,2013-12-31,381587,744015,1125602
17671,297,$VIVT4,2014-03-31,381587,744015,1125602
17671,297,$VIVT4,2014-06-30,381587,744015,1125602
17671,297,$VIVT4,2014-09-30,381587,744015,1125602
17671,297,$VIVT4,2014-12-31,381587,744015,1125602
17671,297,$VIVT4,2015-03-31,381335,741934,1123269
17671,297,$VIVT4,2015-06-30,571644,1119341,1690985
17671,297,$VIVT4,2015-09-30,571644,1119341,1690985
17671,297,$VIVT4,2015-12-31,571644,1119341,1690985
17671,297,$VIVT4,2016-03-31,571644,1119341,1690985
17671,297,$VIVT4,2016-06-30,571644,1119341,1690985
17671,297,$VIVT4,2016-09-30,571644,1119341,1690985
17671,297,$VIVT4,2016-12-31,571644,1119341,1690985
17671,297,$VIVT4,2017-03-31,571644,1119341,1690985
17671,297,$VIVT4,2017-06-30,571644,1119341,1690985
17671,297,$VIVT4,2017-09-30,571644,1119341,1690985
17671,297,$VIVT4,2017-12-31,571644,1119341,1690985
17671,297,$VIVT4,2018-03-31,571644,1119341,1690985
17671,297,$VIVT4,2018-06-30,571644,1119341,1690985
17671,297,$VIVT4,2018-09-30,571644,1119341,1690985
17671,297,$VIVT4,2018-12-31,571644,1119341,1690985
17671,297,$VIVT4,2019-03-31,571644,1119341,1690985
17671,297,$VIVT4,2019-06-30,571644,1119341,1690985
17671,297,$VIVT4,2019-09-30,571644,1119341,1690985
17671,297,$VIVT4,2019-12-31,571644,1119341,1690985
17671,297,$VIVT4,2020-03-31,571644,1119341,1690985
17671,297,$VIVT4,2020-06-30,571644,1119341,1690985
17671,297,$VIVT4,2020-09-30,571644,1119341,1690985
17671,298,$VIVT3,2010-12-31,168820,337417,506237
17671,298,$VIVT3,2011-03-31,168820,337417,506237
17671,298,$VIVT3,2011-06-30,381587,744015,1125602
17671,298,$VIVT3,2011-09-30,381587,744015,1125602
17671,298,$VIVT3,2011-12-31,381587,744015,1125602
17671,298,$VIVT3,2012-03-31,381587,744015,1125602
17671,298,$VIVT3,2012-06-30,381587,744015,1125602
17671,298,$VIVT3,2012-09-30,381587,744015,1125602
17671,298,$VIVT3,2012-12-31,381587,744015,1125602
17671,298,$VIVT3,2013-03-31,381587,744015,1125602
17671,298,$VIVT3,2013-06-30,381587,744015,1125602
17671,298,$VIVT3,2013-09-30,381587,744015,1125602
17671,298,$VIVT3,2013-12-31,381587,744015,1125602
17671,298,$VIVT3,2014-03-31,381587,744015,1125602
17671,298,$VIVT3,2014-06-30,381587,744015,1125602
17671,298,$VIVT3,2014-09-30,381587,744015,1125602
17671,298,$VIVT3,2014-12-31,381587,744015,1125602
17671,298,$VIVT3,2015-03-31,381335,741934,1123269
17671,298,$VIVT3,2015-06-30,571644,1119341,1690985
17671,298,$VIVT3,2015-09-30,571644,1119341,1690985
17671,298,$VIVT3,2015-12-31,571644,1119341,1690985
17671,298,$VIVT3,2016-03-31,571644,1119341,1690985
17671,298,$VIVT3,2016-06-30,571644,1119341,1690985
17671,298,$VIVT3,2016-09-30,571644,1119341,1690985
17671,298,$VIVT3,2016-12-31,571644,1119341,1690985
17671,298,$VIVT3,2017-03-31,571644,1119341,1690985
17671,298,$VIVT3,2017-06-30,571644,1119341,1690985
17671,298,$VIVT3,2017-09-30,571644,1119341,1690985
17671,298,$VIVT3,2017-12-31,571644,1119341,1690985
17671,298,$VIVT3,2018-03-31,571644,1119341,1690985
17671,298,$VIVT3,2018-06-30,571644,1119341,1690985
17671,298,$VIVT3,2018-09-30,571644,1119341,1690985
17671,298,$VIVT3,2018-12-31,571644,1119341,1690985
17671,298,$VIVT3,2019-03-31,571644,1119341,1690985
17671,298,$VIVT3,2019-06-30,571644,1119341,1690985
17671,298,$VIVT3,2019-09-30,571644,1119341,1690985
17671,298,$VIVT3,2019-12-31,571644,1119341,1690985
17671,298,$VIVT3,2020-03-31,571644,1119341,1690985
17671,298,$VIVT3,2020-06-30,571644,1119341,1690985
17671,298,$VIVT3,2020-09-30,571644,1119341,1690985
17884,461,$BETP3B,2010-12-31,2761620,0,2761620
17884,461,$BETP3B,2011-03-31,2761,0,2761
17884,461,$BETP3B,2011-06-30,2761,0,2761
17884,461,$BETP3B,2011-09-30,2761,0,2761
17884,461,$BETP3B,2011-12-31,2761620,0,2761620
17884,461,$BETP3B,2012-03-31,2761620,0,2761620
17884,461,$BETP3B,2012-06-30,2761620,0,2761620
17884,461,$BETP3B,2012-09-30,2761620,0,2761620
17884,461,$BETP3B,2012-12-31,2761620,0,2761620
17884,461,$BETP3B,2013-03-31,2761620,0,2761620
17884,461,$BETP3B,2013-06-30,2761620,0,2761620
17884,461,$BETP3B,2013-09-30,2761620,0,2761620
17884,461,$BETP3B,2013-12-31,2761620,0,2761620
17884,461,$BETP3B,2014-03-31,2761620,0,2761620
17884,461,$BETP3B,2014-06-30,2761620,0,2761620
17884,461,$BETP3B,2014-09-30,2761620,0,2761620
17884,461,$BETP3B,2014-12-31,2761620,0,2761620
17884,461,$BETP3B,2015-03-31,2761620,0,2761620
17884,461,$BETP3B,2015-06-30,2761620,0,2761620
17884,461,$BETP3B,2015-09-30,2761620,0,2761620
17884,461,$BETP3B,2015-12-31,2761620,0,2761620
17884,461,$BETP3B,2016-03-31,2761620,0,2761620
17884,461,$BETP3B,2016-06-30,2761620,0,2761620
17884,461,$BETP3B,2016-09-30,2761620,0,2761620
17884,461,$BETP3B,2016-12-31,2761620,0,2761620
17884,461,$BETP3B,2017-03-31,2761620,0,2761620
17884,461,$BETP3B,2017-06-30,2761620,0,2761620
17884,461,$BETP3B,2017-09-30,2761620,0,2761620
17884,461,$BETP3B,2017-12-31,2761620,0,2761620
17884,461,$BETP3B,2018-03-31,2761620,0,2761620
17884,461,$BETP3B,2018-06-30,2761620,0,2761620
17884,461,$BETP3B,2018-09-30,2761620,0,2761620
17884,461,$BETP3B,2018-12-31,2761620,0,2761620
17884,461,$BETP3B,2019-03-31,2761620,0,2761620
17884,461,$BETP3B,2019-06-30,2761620,0,2761620
17884,461,$BETP3B,2019-09-30,2761620,0,2761620
17884,461,$BETP3B,2019-12-31,2761620,0,2761620
17884,461,$BETP3B,2020-03-31,2761620,0,2761620
17884,461,$BETP3B,2020-06-30,2761620,0,2761620
17884,461,$BETP3B,2020-09-30,2761620,0,2761620
17892,464,$STBP3,2010-12-31,452567,203209,655776
17892,464,$STBP3,2011-03-31,452862,204387,657249
17892,464,$STBP3,2011-06-30,453567,207205,660772
17892,464,$STBP3,2011-09-30,453584,207277,660861
17892,464,$STBP3,2011-12-31,453584,207277,660861
17892,464,$STBP3,2012-03-31,454106,209363,663469
17892,464,$STBP3,2012-06-30,454236,209881,664117
17892,464,$STBP3,2012-09-30,454244,209917,664161
17892,464,$STBP3,2012-12-31,454244,209917,664161
17892,464,$STBP3,2013-03-31,454520,211020,665540
17892,464,$STBP3,2013-06-30,454629,211457,666086
17892,464,$STBP3,2013-09-30,454629,211457,666086
17892,464,$STBP3,2013-12-31,454629,211457,666086
17892,464,$STBP3,2014-03-31,454629,211457,666086
17892,464,$STBP3,2014-06-30,454629,211457,666086
17892,464,$STBP3,2014-09-30,454629,211457,666086
17892,464,$STBP3,2014-12-31,454629,211457,666086
17892,464,$STBP3,2015-03-31,454629,211457,666086
17892,464,$STBP3,2015-06-30,454629,211457,666086
17892,464,$STBP3,2015-09-30,454629,211457,666086
17892,464,$STBP3,2015-12-31,454629,211457,666086
17892,464,$STBP3,2016-03-31,454629,211457,666086
17892,464,$STBP3,2016-06-30,454629,211457,666086
17892,464,$STBP3,2016-09-30,666086,0,666086
17892,464,$STBP3,2016-12-31,666086,0,666086
17892,464,$STBP3,2017-03-31,666086,0,666086
17892,464,$STBP3,2017-06-30,666086,0,666086
17892,464,$STBP3,2017-09-30,666318,0,666318
17892,464,$STBP3,2017-12-31,666318,0,666318
17892,464,$STBP3,2018-03-31,666318,0,666318
17892,464,$STBP3,2018-06-30,666318,0,666318
17892,464,$STBP3,2018-09-30,666318,0,666318
17892,464,$STBP3,2018-12-31,666318,0,666318
17892,464,$STBP3,2019-03-31,667166,0,667166
17892,464,$STBP3,2019-06-30,667166,0,667166
17892,464,$STBP3,2019-09-30,669236,0,669236
17892,464,$STBP3,2019-12-31,669798,0,669798
17892,464,$STBP3,2020-03-31,669798,0,669798
17892,464,$STBP3,2020-06-30,669798,0,669798
17892,464,$STBP3,2020-09-30,862478,0,862478
17914,302,$MMXM3,2010-12-31,472973,0,472973
17914,302,$MMXM3,2011-03-31,586207,0,586207
17914,302,$MMXM3,2011-06-30,619473,0,619473
17914,302,$MMXM3,2011-09-30,619590,0,619590
17914,302,$MMXM3,2011-12-31,619761,0,619761
17914,302,$MMXM3,2012-03-31,619761,0,619761
17914,302,$MMXM3,2012-06-30,619761,0,619761
17914,302,$MMXM3,2012-09-30,624324,0,624324
17914,302,$MMXM3,2012-12-31,624324,0,624324
17914,302,$MMXM3,2013-03-31,973227,0,973227
17914,302,$MMXM3,2013-06-30,973227,0,973227
17914,302,$MMXM3,2013-09-30,973227,0,973227
17914,302,$MMXM3,2013-12-31,973227,0,973227
17914,302,$MMXM3,2014-03-31,162205,0,162205
17914,302,$MMXM3,2014-06-30,162205,0,162205
17914,302,$MMXM3,2014-09-30,162205,0,162205
17914,302,$MMXM3,2014-12-31,162205,0,162205
17914,302,$MMXM3,2015-03-31,162205,0,162205
17914,302,$MMXM3,2015-06-30,162205,0,162205
17914,302,$MMXM3,2015-09-30,162205,0,162205
17914,302,$MMXM3,2015-12-31,162205,0,162205
17914,302,$MMXM3,2016-03-31,162205,0,162205
17914,302,$MMXM3,2016-06-30,6488,0,6488
17914,302,$MMXM3,2016-09-30,6488,0,6488
17914,302,$MMXM3,2016-12-31,6488,0,6488
17914,302,$MMXM3,2017-03-31,6488,0,6488
17914,302,$MMXM3,2017-06-30,6488,0,6488
17914,302,$MMXM3,2017-09-30,6488,0,6488
17914,302,$MMXM3,2017-12-31,6488,0,6488
17914,302,$MMXM3,2018-03-31,6488,0,6488
17914,302,$MMXM3,2018-06-30,6488,0,6488
17914,302,$MMXM3,2018-09-30,6488,0,6488
17914,302,$MMXM3,2018-12-31,6488,0,6488
17914,302,$MMXM3,2019-03-31,6488,0,6488
17914,302,$MMXM3,2019-06-30,6488,0,6488
17914,302,$MMXM3,2019-09-30,6488,0,6488
17914,302,$MMXM3,2019-12-31,6488,0,6488
17914,302,$MMXM3,2020-03-31,6488,0,6488
17914,302,$MMXM3,2020-06-30,6488,0,6488
17914,302,$MMXM3,2020-09-30,6488,0,6488
17922,292,$BFRE3,2010-12-31,103553128,127445086,230998214
17922,292,$BFRE3,2011-03-31,103553128,127445086,230998214
17922,292,$BFRE3,2011-06-30,103553128,127445086,230998214
17922,292,$BFRE3,2011-09-30,103553128,128740747,232293875
17922,292,$BFRE3,2011-12-31,103553128,128740747,232293875
17922,292,$BFRE3,2012-03-31,105968039,131712331,237680370
17922,292,$BFRE3,2012-06-30,314,609,923
17922,292,$BFRE3,2012-09-30,331,641,972
17922,292,$BFRE3,2012-12-31,331,641,972
17922,292,$BFRE3,2013-03-31,331,641,972
17922,292,$BFRE3,2013-06-30,331,641,972
17922,292,$BFRE3,2013-09-30,17,34,51
17922,292,$BFRE3,2013-12-31,17,34,51
17922,292,$BFRE3,2014-03-31,17,34,51
17922,292,$BFRE3,2014-06-30,17,34,51
17922,292,$BFRE3,2014-09-30,17,34,51
17922,292,$BFRE3,2014-12-31,239,478,717
17922,292,$BFRE3,2015-03-31,239,478,717
17922,292,$BFRE3,2015-06-30,239,478,717
17922,292,$BFRE3,2015-09-30,239,478,717
17922,292,$BFRE3,2015-12-31,239,478,717
17922,292,$BFRE3,2016-03-31,239,478,717
17922,292,$BFRE3,2016-06-30,239,478,717
17922,292,$BFRE3,2016-09-30,239,478,717
17922,292,$BFRE3,2016-12-31,239,478,717
17922,292,$BFRE3,2017-03-31,239,478,717
17922,292,$BFRE3,2017-06-30,239,478,717
17922,292,$BFRE3,2017-09-30,239,478,717
17922,292,$BFRE3,2017-12-31,239,478,717
17922,292,$BFRE3,2018-03-31,239,478,717
17922,292,$BFRE3,2018-06-30,239,478,717
17922,292,$BFRE3,2018-09-30,239,478,717
17922,292,$BFRE3,2018-12-31,239,478,717
17922,292,$BFRE3,2019-03-31,239,478,717
17922,292,$BFRE3,2019-06-30,239,478,717
17922,292,$BFRE3,2019-09-30,239,478,717
17922,292,$BFRE3,2019-12-31,239,478,717
17922,292,$BFRE3,2020-03-31,239,478,717
17922,292,$BFRE3,2020-06-30,239,478,717
17922,292,$BFRE3,2020-09-30,239,478,717
17922,293,$BFRE12,2010-12-31,103553128,127445086,230998214
17922,293,$BFRE12,2011-03-31,103553128,127445086,230998214
17922,293,$BFRE12,2011-06-30,103553128,127445086,230998214
17922,293,$BFRE12,2011-09-30,103553128,128740747,232293875
17922,293,$BFRE12,2011-12-31,103553128,128740747,232293875
17922,293,$BFRE12,2012-03-31,105968039,131712331,237680370
17922,293,$BFRE12,2012-06-30,314,609,923
17922,293,$BFRE12,2012-09-30,331,641,972
17922,293,$BFRE12,2012-12-31,331,641,972
17922,293,$BFRE12,2013-03-31,331,641,972
17922,293,$BFRE12,2013-06-30,331,641,972
17922,293,$BFRE12,2013-09-30,17,34,51
17922,293,$BFRE12,2013-12-31,17,34,51
17922,293,$BFRE12,2014-03-31,17,34,51
17922,293,$BFRE12,2014-06-30,17,34,51
17922,293,$BFRE12,2014-09-30,17,34,51
17922,293,$BFRE12,2014-12-31,239,478,717
17922,293,$BFRE12,2015-03-31,239,478,717
17922,293,$BFRE12,2015-06-30,239,478,717
17922,293,$BFRE12,2015-09-30,239,478,717
17922,293,$BFRE12,2015-12-31,239,478,717
17922,293,$BFRE12,2016-03-31,239,478,717
17922,293,$BFRE12,2016-06-30,239,478,717
17922,293,$BFRE12,2016-09-30,239,478,717
17922,293,$BFRE12,2016-12-31,239,478,717
17922,293,$BFRE12,2017-03-31,239,478,717
17922,293,$BFRE12,2017-06-30,239,478,717
17922,293,$BFRE12,2017-09-30,239,478,717
17922,293,$BFRE12,2017-12-31,239,478,717
17922,293,$BFRE12,2018-03-31,239,478,717
17922,293,$BFRE12,2018-06-30,239,478,717
17922,293,$BFRE12,2018-09-30,239,478,717
17922,293,$BFRE12,2018-12-31,239,478,717
17922,293,$BFRE12,2019-03-31,239,478,717
17922,293,$BFRE12,2019-06-30,239,478,717
17922,293,$BFRE12,2019-09-30,239,478,717
17922,293,$BFRE12,2019-12-31,239,478,717
17922,293,$BFRE12,2020-03-31,239,478,717
17922,293,$BFRE12,2020-06-30,239,478,717
17922,293,$BFRE12,2020-09-30,239,478,717
17922,294,$BFRE11,2010-12-31,103553128,127445086,230998214
17922,294,$BFRE11,2011-03-31,103553128,127445086,230998214
17922,294,$BFRE11,2011-06-30,103553128,127445086,230998214
17922,294,$BFRE11,2011-09-30,103553128,128740747,232293875
17922,294,$BFRE11,2011-12-31,103553128,128740747,232293875
17922,294,$BFRE11,2012-03-31,105968039,131712331,237680370
17922,294,$BFRE11,2012-06-30,314,609,923
17922,294,$BFRE11,2012-09-30,331,641,972
17922,294,$BFRE11,2012-12-31,331,641,972
17922,294,$BFRE11,2013-03-31,331,641,972
17922,294,$BFRE11,2013-06-30,331,641,972
17922,294,$BFRE11,2013-09-30,17,34,51
17922,294,$BFRE11,2013-12-31,17,34,51
17922,294,$BFRE11,2014-03-31,17,34,51
17922,294,$BFRE11,2014-06-30,17,34,51
17922,294,$BFRE11,2014-09-30,17,34,51
17922,294,$BFRE11,2014-12-31,239,478,717
17922,294,$BFRE11,2015-03-31,239,478,717
17922,294,$BFRE11,2015-06-30,239,478,717
17922,294,$BFRE11,2015-09-30,239,478,717
17922,294,$BFRE11,2015-12-31,239,478,717
17922,294,$BFRE11,2016-03-31,239,478,717
17922,294,$BFRE11,2016-06-30,239,478,717
17922,294,$BFRE11,2016-09-30,239,478,717
17922,294,$BFRE11,2016-12-31,239,478,717
17922,294,$BFRE11,2017-03-31,239,478,717
17922,294,$BFRE11,2017-06-30,239,478,717
17922,294,$BFRE11,2017-09-30,239,478,717
17922,294,$BFRE11,2017-12-31,239,478,717
17922,294,$BFRE11,2018-03-31,239,478,717
17922,294,$BFRE11,2018-06-30,239,478,717
17922,294,$BFRE11,2018-09-30,239,478,717
17922,294,$BFRE11,2018-12-31,239,478,717
17922,294,$BFRE11,2019-03-31,239,478,717
17922,294,$BFRE11,2019-06-30,239,478,717
17922,294,$BFRE11,2019-09-30,239,478,717
17922,294,$BFRE11,2019-12-31,239,478,717
17922,294,$BFRE11,2020-03-31,239,478,717
17922,294,$BFRE11,2020-06-30,239,478,717
17922,294,$BFRE11,2020-09-30,239,478,717
17949,466,$MRSA3,2010-12-31,188333,151667,340000
17949,466,$MRSA3,2011-03-31,188333,151667,340000
17949,466,$MRSA3,2011-06-30,188333,151667,340000
17949,466,$MRSA3,2011-09-30,188333,151667,340000
17949,466,$MRSA3,2011-12-31,188333,151667,340000
17949,466,$MRSA3,2012-03-31,188333,151667,340000
17949,466,$MRSA3,2012-06-30,188333,151667,340000
17949,466,$MRSA3,2012-09-30,188333,151667,340000
17949,466,$MRSA3,2012-12-31,188333,151667,340000
17949,466,$MRSA3,2013-03-31,188333,151667,340000
17949,466,$MRSA3,2013-06-30,188333,151667,340000
17949,466,$MRSA3,2013-09-30,188333,151667,340000
17949,466,$MRSA3,2013-12-31,188333,151667,340000
17949,466,$MRSA3,2014-03-31,188333,151667,340000
17949,466,$MRSA3,2014-06-30,188333,151667,340000
17949,466,$MRSA3,2014-09-30,188333,151667,340000
17949,466,$MRSA3,2014-12-31,188333,151667,340000
17949,466,$MRSA3,2015-03-31,188333,151667,340000
17949,466,$MRSA3,2015-06-30,188333,151667,340000
17949,466,$MRSA3,2015-09-30,188333,151667,340000
17949,466,$MRSA3,2015-12-31,188333,151667,340000
17949,466,$MRSA3,2016-03-31,188333,151667,340000
17949,466,$MRSA3,2016-06-30,188333,151667,340000
17949,466,$MRSA3,2016-09-30,188333,151667,340000
17949,466,$MRSA3,2016-12-31,188333,151667,340000
17949,466,$MRSA3,2017-03-31,188333,151667,340000
17949,466,$MRSA3,2017-06-30,188333,151667,340000
17949,466,$MRSA3,2017-09-30,188333,151667,340000
17949,466,$MRSA3,2017-12-31,188333,151667,340000
17949,466,$MRSA3,2018-03-31,188333,151667,340000
17949,466,$MRSA3,2018-06-30,188333,151667,340000
17949,466,$MRSA3,2018-09-30,188333,151667,340000
17949,466,$MRSA3,2018-12-31,188333,151667,340000
17949,466,$MRSA3,2019-03-31,188333,151667,340000
17949,466,$MRSA3,2019-06-30,188333,151667,340000
17949,466,$MRSA3,2019-09-30,188333,151667,340000
17949,466,$MRSA3,2019-12-31,188333,151667,340000
17949,466,$MRSA3,2020-03-31,188333,151667,340000
17949,466,$MRSA3,2020-06-30,188333,151667,340000
17949,466,$MRSA3,2020-09-30,188333,151667,340000
17949,467,$MRSA5,2010-12-31,188333,151667,340000
17949,467,$MRSA5,2011-03-31,188333,151667,340000
17949,467,$MRSA5,2011-06-30,188333,151667,340000
17949,467,$MRSA5,2011-09-30,188333,151667,340000
17949,467,$MRSA5,2011-12-31,188333,151667,340000
17949,467,$MRSA5,2012-03-31,188333,151667,340000
17949,467,$MRSA5,2012-06-30,188333,151667,340000
17949,467,$MRSA5,2012-09-30,188333,151667,340000
17949,467,$MRSA5,2012-12-31,188333,151667,340000
17949,467,$MRSA5,2013-03-31,188333,151667,340000
17949,467,$MRSA5,2013-06-30,188333,151667,340000
17949,467,$MRSA5,2013-09-30,188333,151667,340000
17949,467,$MRSA5,2013-12-31,188333,151667,340000
17949,467,$MRSA5,2014-03-31,188333,151667,340000
17949,467,$MRSA5,2014-06-30,188333,151667,340000
17949,467,$MRSA5,2014-09-30,188333,151667,340000
17949,467,$MRSA5,2014-12-31,188333,151667,340000
17949,467,$MRSA5,2015-03-31,188333,151667,340000
17949,467,$MRSA5,2015-06-30,188333,151667,340000
17949,467,$MRSA5,2015-09-30,188333,151667,340000
17949,467,$MRSA5,2015-12-31,188333,151667,340000
17949,467,$MRSA5,2016-03-31,188333,151667,340000
17949,467,$MRSA5,2016-06-30,188333,151667,340000
17949,467,$MRSA5,2016-09-30,188333,151667,340000
17949,467,$MRSA5,2016-12-31,188333,151667,340000
17949,467,$MRSA5,2017-03-31,188333,151667,340000
17949,467,$MRSA5,2017-06-30,188333,151667,340000
17949,467,$MRSA5,2017-09-30,188333,151667,340000
17949,467,$MRSA5,2017-12-31,188333,151667,340000
17949,467,$MRSA5,2018-03-31,188333,151667,340000
17949,467,$MRSA5,2018-06-30,188333,151667,340000
17949,467,$MRSA5,2018-09-30,188333,151667,340000
17949,467,$MRSA5,2018-12-31,188333,151667,340000
17949,467,$MRSA5,2019-03-31,188333,151667,340000
17949,467,$MRSA5,2019-06-30,188333,151667,340000
17949,467,$MRSA5,2019-09-30,188333,151667,340000
17949,467,$MRSA5,2019-12-31,188333,151667,340000
17949,467,$MRSA5,2020-03-31,188333,151667,340000
17949,467,$MRSA5,2020-06-30,188333,151667,340000
17949,467,$MRSA5,2020-09-30,188333,151667,340000
17949,468,$MRSA6,2010-12-31,188333,151667,340000
17949,468,$MRSA6,2011-03-31,188333,151667,340000
17949,468,$MRSA6,2011-06-30,188333,151667,340000
17949,468,$MRSA6,2011-09-30,188333,151667,340000
17949,468,$MRSA6,2011-12-31,188333,151667,340000
17949,468,$MRSA6,2012-03-31,188333,151667,340000
17949,468,$MRSA6,2012-06-30,188333,151667,340000
17949,468,$MRSA6,2012-09-30,188333,151667,340000
17949,468,$MRSA6,2012-12-31,188333,151667,340000
17949,468,$MRSA6,2013-03-31,188333,151667,340000
17949,468,$MRSA6,2013-06-30,188333,151667,340000
17949,468,$MRSA6,2013-09-30,188333,151667,340000
17949,468,$MRSA6,2013-12-31,188333,151667,340000
17949,468,$MRSA6,2014-03-31,188333,151667,340000
17949,468,$MRSA6,2014-06-30,188333,151667,340000
17949,468,$MRSA6,2014-09-30,188333,151667,340000
17949,468,$MRSA6,2014-12-31,188333,151667,340000
17949,468,$MRSA6,2015-03-31,188333,151667,340000
17949,468,$MRSA6,2015-06-30,188333,151667,340000
17949,468,$MRSA6,2015-09-30,188333,151667,340000
17949,468,$MRSA6,2015-12-31,188333,151667,340000
17949,468,$MRSA6,2016-03-31,188333,151667,340000
17949,468,$MRSA6,2016-06-30,188333,151667,340000
17949,468,$MRSA6,2016-09-30,188333,151667,340000
17949,468,$MRSA6,2016-12-31,188333,151667,340000
17949,468,$MRSA6,2017-03-31,188333,151667,340000
17949,468,$MRSA6,2017-06-30,188333,151667,340000
17949,468,$MRSA6,2017-09-30,188333,151667,340000
17949,468,$MRSA6,2017-12-31,188333,151667,340000
17949,468,$MRSA6,2018-03-31,188333,151667,340000
17949,468,$MRSA6,2018-06-30,188333,151667,340000
17949,468,$MRSA6,2018-09-30,188333,151667,340000
17949,468,$MRSA6,2018-12-31,188333,151667,340000
17949,468,$MRSA6,2019-03-31,188333,151667,340000
17949,468,$MRSA6,2019-06-30,188333,151667,340000
17949,468,$MRSA6,2019-09-30,188333,151667,340000
17949,468,$MRSA6,2019-12-31,188333,151667,340000
17949,468,$MRSA6,2020-03-31,188333,151667,340000
17949,468,$MRSA6,2020-06-30,188333,151667,340000
17949,468,$MRSA6,2020-09-30,188333,151667,340000
17965,463,$OPGM3B,2010-12-31,14176,0,14176
17965,463,$OPGM3B,2011-03-31,14176,0,14176
17965,463,$OPGM3B,2011-06-30,14176,0,14176
17965,463,$OPGM3B,2011-09-30,14176,0,14176
17965,463,$OPGM3B,2011-12-31,14176,0,14176
17965,463,$OPGM3B,2012-03-31,14176,0,14176
17965,463,$OPGM3B,2012-06-30,14176,0,14176
17965,463,$OPGM3B,2012-09-30,1936,0,1936
17965,463,$OPGM3B,2012-12-31,1936,0,1936
17965,463,$OPGM3B,2013-03-31,1936,0,1936
17965,463,$OPGM3B,2013-06-30,1936,0,1936
17965,463,$OPGM3B,2013-09-30,1936,0,1936
17965,463,$OPGM3B,2013-12-31,1936,0,1936
17965,463,$OPGM3B,2014-03-31,1936,0,1936
17965,463,$OPGM3B,2014-06-30,1936,0,1936
17965,463,$OPGM3B,2014-09-30,1936,0,1936
17965,463,$OPGM3B,2014-12-31,1936,0,1936
17965,463,$OPGM3B,2015-03-31,1936,0,1936
17965,463,$OPGM3B,2015-06-30,1936,0,1936
17965,463,$OPGM3B,2015-09-30,1936,0,1936
17965,463,$OPGM3B,2015-12-31,1936,0,1936
17965,463,$OPGM3B,2016-03-31,1936,0,1936
17965,463,$OPGM3B,2016-06-30,1936,0,1936
17965,463,$OPGM3B,2016-09-30,1936,0,1936
17965,463,$OPGM3B,2016-12-31,1936,0,1936
17965,463,$OPGM3B,2017-03-31,1936,0,1936
17965,463,$OPGM3B,2017-06-30,1936,0,1936
17965,463,$OPGM3B,2017-09-30,1936,0,1936
17965,463,$OPGM3B,2017-12-31,1936,0,1936
17965,463,$OPGM3B,2018-03-31,1936,0,1936
17965,463,$OPGM3B,2018-06-30,1936,0,1936
17965,463,$OPGM3B,2018-09-30,1936,0,1936
17965,463,$OPGM3B,2018-12-31,1936,0,1936
17965,463,$OPGM3B,2019-03-31,1936,0,1936
17965,463,$OPGM3B,2019-06-30,1936,0,1936
17965,463,$OPGM3B,2019-09-30,1936,0,1936
17965,463,$OPGM3B,2019-12-31,1935716,0,1935716
17965,463,$OPGM3B,2020-03-31,1935716,0,1935716
17965,463,$OPGM3B,2020-06-30,1935716,0,1935716
17965,463,$OPGM3B,2020-09-30,1935716,0,1935716
17973,316,$KROT3,2010-12-31,234114,232126,466240
17973,316,$KROT3,2011-03-31,234114,232126,466240
17973,316,$KROT3,2011-06-30,234114,232126,466240
17973,316,$KROT3,2011-09-30,252543,342704,595247
17973,316,$KROT3,2011-12-31,253866,350619,604485
17973,316,$KROT3,2012-03-31,355090,488231,843321
17973,316,$KROT3,2012-06-30,355090,488231,843321
17973,316,$KROT3,2012-09-30,364549,575914,940463
17973,316,$KROT3,2012-12-31,134352,0,134352
17973,316,$KROT3,2013-03-31,268704,0,268704
17973,316,$KROT3,2013-06-30,268704,0,268704
17973,316,$KROT3,2013-09-30,268704,0,268704
17973,316,$KROT3,2013-12-31,268704,0,268704
17973,316,$KROT3,2014-03-31,268704,0,268704
17973,316,$KROT3,2014-06-30,268703876,0,268703876
17973,316,$KROT3,2014-09-30,1621377,0,1621377
17973,316,$KROT3,2014-12-31,1623795559,0,1623795559
17973,316,$KROT3,2015-03-31,1624948,0,1624948
17973,316,$KROT3,2015-06-30,1623154,0,1623154
17973,316,$KROT3,2015-09-30,1614039,0,1614039
17973,316,$KROT3,2015-12-31,1614707,0,1614707
17973,316,$KROT3,2016-03-31,1616720,0,1616720
17973,316,$KROT3,2016-06-30,1618406,0,1618406
17973,316,$KROT3,2016-09-30,1621839,0,1621839
17973,316,$KROT3,2016-12-31,1626069778,0,1626069778
17973,316,$KROT3,2017-03-31,1624847,0,1624847
17973,316,$KROT3,2017-06-30,1626069778,0,1626069778
17973,316,$KROT3,2017-09-30,1637455614,0,1637455614
17973,316,$KROT3,2017-12-31,1640526448,0,1640526448
17973,316,$KROT3,2018-03-31,1640648206,0,1640648206
17973,316,$KROT3,2018-06-30,1644248206,0,1644248206
17973,316,$KROT3,2018-09-30,1644248206,0,1644248206
17973,316,$KROT3,2018-12-31,1644248206,0,1644248206
17973,316,$KROT3,2019-03-31,1644248206,0,1644248206
17973,316,$KROT3,2019-06-30,1644248206,0,1644248206
17973,316,$KROT3,2019-09-30,1644248206,0,1644248206
17973,316,$KROT3,2019-12-31,1644248206,0,1644248206
17973,316,$KROT3,2020-03-31,1876606210,0,1876606210
17973,316,$KROT3,2020-06-30,1876606210,0,1876606210
17973,316,$KROT3,2020-09-30,1876606210,0,1876606210
17973,319,$COGN3,2010-12-31,234114,232126,466240
17973,319,$COGN3,2011-03-31,234114,232126,466240
17973,319,$COGN3,2011-06-30,234114,232126,466240
17973,319,$COGN3,2011-09-30,252543,342704,595247
17973,319,$COGN3,2011-12-31,253866,350619,604485
17973,319,$COGN3,2012-03-31,355090,488231,843321
17973,319,$COGN3,2012-06-30,355090,488231,843321
17973,319,$COGN3,2012-09-30,364549,575914,940463
17973,319,$COGN3,2012-12-31,134352,0,134352
17973,319,$COGN3,2013-03-31,268704,0,268704
17973,319,$COGN3,2013-06-30,268704,0,268704
17973,319,$COGN3,2013-09-30,268704,0,268704
17973,319,$COGN3,2013-12-31,268704,0,268704
17973,319,$COGN3,2014-03-31,268704,0,268704
17973,319,$COGN3,2014-06-30,268703876,0,268703876
17973,319,$COGN3,2014-09-30,1621377,0,1621377
17973,319,$COGN3,2014-12-31,1623795559,0,1623795559
17973,319,$COGN3,2015-03-31,1624948,0,1624948
17973,319,$COGN3,2015-06-30,1623154,0,1623154
17973,319,$COGN3,2015-09-30,1614039,0,1614039
17973,319,$COGN3,2015-12-31,1614707,0,1614707
17973,319,$COGN3,2016-03-31,1616720,0,1616720
17973,319,$COGN3,2016-06-30,1618406,0,1618406
17973,319,$COGN3,2016-09-30,1621839,0,1621839
17973,319,$COGN3,2016-12-31,1626069778,0,1626069778
17973,319,$COGN3,2017-03-31,1624847,0,1624847
17973,319,$COGN3,2017-06-30,1626069778,0,1626069778
17973,319,$COGN3,2017-09-30,1637455614,0,1637455614
17973,319,$COGN3,2017-12-31,1640526448,0,1640526448
17973,319,$COGN3,2018-03-31,1640648206,0,1640648206
17973,319,$COGN3,2018-06-30,1644248206,0,1644248206
17973,319,$COGN3,2018-09-30,1644248206,0,1644248206
17973,319,$COGN3,2018-12-31,1644248206,0,1644248206
17973,319,$COGN3,2019-03-31,1644248206,0,1644248206
17973,319,$COGN3,2019-06-30,1644248206,0,1644248206
17973,319,$COGN3,2019-09-30,1644248206,0,1644248206
17973,319,$COGN3,2019-12-31,1644248206,0,1644248206
17973,319,$COGN3,2020-03-31,1876606210,0,1876606210
17973,319,$COGN3,2020-06-30,1876606210,0,1876606210
17973,319,$COGN3,2020-09-30,1876606210,0,1876606210
18139,288,$CSRN3,2010-12-31,129746,38328,168074
18139,288,$CSRN3,2011-03-31,129746,38328,168074
18139,288,$CSRN3,2011-06-30,129746,38328,168074
18139,288,$CSRN3,2011-09-30,129746,38328,168074
18139,288,$CSRN3,2011-12-31,129746,38328,168074
18139,288,$CSRN3,2012-03-31,129746,38328,168074
18139,288,$CSRN3,2012-06-30,129746,38328,168074
18139,288,$CSRN3,2012-09-30,129746,38328,168074
18139,288,$CSRN3,2012-12-31,129746,38328,168074
18139,288,$CSRN3,2013-03-31,129746,38328,168074
18139,288,$CSRN3,2013-06-30,129746,38328,168074
18139,288,$CSRN3,2013-09-30,129746,38328,168074
18139,288,$CSRN3,2013-12-31,129746,38328,168074
18139,288,$CSRN3,2014-03-31,129746,38328,168074
18139,288,$CSRN3,2014-06-30,129746,38328,168074
18139,288,$CSRN3,2014-09-30,129746,38328,168074
18139,288,$CSRN3,2014-12-31,129746,38328,168074
18139,288,$CSRN3,2015-03-31,129746,38328,168074
18139,288,$CSRN3,2015-06-30,129746,38328,168074
18139,288,$CSRN3,2015-09-30,129746,38328,168074
18139,288,$CSRN3,2015-12-31,129746,38328,168074
18139,288,$CSRN3,2016-03-31,129746,38328,168074
18139,288,$CSRN3,2016-06-30,129746,38328,168074
18139,288,$CSRN3,2016-09-30,129746,38328,168074
18139,288,$CSRN3,2016-12-31,129746,38328,168074
18139,288,$CSRN3,2017-03-31,129746,38328,168074
18139,288,$CSRN3,2017-06-30,129746,38328,168074
18139,288,$CSRN3,2017-09-30,129746,38328,168074
18139,288,$CSRN3,2017-12-31,129746,38328,168074
18139,288,$CSRN3,2018-03-31,129746,38328,168074
18139,288,$CSRN3,2018-06-30,129746,38328,168074
18139,288,$CSRN3,2018-09-30,129746,38328,168074
18139,288,$CSRN3,2018-12-31,129746,38328,168074
18139,288,$CSRN3,2019-03-31,129746,38328,168074
18139,288,$CSRN3,2019-06-30,129746,38328,168074
18139,288,$CSRN3,2019-09-30,129746,38328,168074
18139,288,$CSRN3,2019-12-31,129746,38328,168074
18139,288,$CSRN3,2020-03-31,129746,38328,168074
18139,288,$CSRN3,2020-06-30,129746,38328,168074
18139,288,$CSRN3,2020-09-30,129746,38328,168074
18139,289,$CSRN6,2010-12-31,129746,38328,168074
18139,289,$CSRN6,2011-03-31,129746,38328,168074
18139,289,$CSRN6,2011-06-30,129746,38328,168074
18139,289,$CSRN6,2011-09-30,129746,38328,168074
18139,289,$CSRN6,2011-12-31,129746,38328,168074
18139,289,$CSRN6,2012-03-31,129746,38328,168074
18139,289,$CSRN6,2012-06-30,129746,38328,168074
18139,289,$CSRN6,2012-09-30,129746,38328,168074
18139,289,$CSRN6,2012-12-31,129746,38328,168074
18139,289,$CSRN6,2013-03-31,129746,38328,168074
18139,289,$CSRN6,2013-06-30,129746,38328,168074
18139,289,$CSRN6,2013-09-30,129746,38328,168074
18139,289,$CSRN6,2013-12-31,129746,38328,168074
18139,289,$CSRN6,2014-03-31,129746,38328,168074
18139,289,$CSRN6,2014-06-30,129746,38328,168074
18139,289,$CSRN6,2014-09-30,129746,38328,168074
18139,289,$CSRN6,2014-12-31,129746,38328,168074
18139,289,$CSRN6,2015-03-31,129746,38328,168074
18139,289,$CSRN6,2015-06-30,129746,38328,168074
18139,289,$CSRN6,2015-09-30,129746,38328,168074
18139,289,$CSRN6,2015-12-31,129746,38328,168074
18139,289,$CSRN6,2016-03-31,129746,38328,168074
18139,289,$CSRN6,2016-06-30,129746,38328,168074
18139,289,$CSRN6,2016-09-30,129746,38328,168074
18139,289,$CSRN6,2016-12-31,129746,38328,168074
18139,289,$CSRN6,2017-03-31,129746,38328,168074
18139,289,$CSRN6,2017-06-30,129746,38328,168074
18139,289,$CSRN6,2017-09-30,129746,38328,168074
18139,289,$CSRN6,2017-12-31,129746,38328,168074
18139,289,$CSRN6,2018-03-31,129746,38328,168074
18139,289,$CSRN6,2018-06-30,129746,38328,168074
18139,289,$CSRN6,2018-09-30,129746,38328,168074
18139,289,$CSRN6,2018-12-31,129746,38328,168074
18139,289,$CSRN6,2019-03-31,129746,38328,168074
18139,289,$CSRN6,2019-06-30,129746,38328,168074
18139,289,$CSRN6,2019-09-30,129746,38328,168074
18139,289,$CSRN6,2019-12-31,129746,38328,168074
18139,289,$CSRN6,2020-03-31,129746,38328,168074
18139,289,$CSRN6,2020-06-30,129746,38328,168074
18139,289,$CSRN6,2020-09-30,129746,38328,168074
18139,290,$CSRN5,2010-12-31,129746,38328,168074
18139,290,$CSRN5,2011-03-31,129746,38328,168074
18139,290,$CSRN5,2011-06-30,129746,38328,168074
18139,290,$CSRN5,2011-09-30,129746,38328,168074
18139,290,$CSRN5,2011-12-31,129746,38328,168074
18139,290,$CSRN5,2012-03-31,129746,38328,168074
18139,290,$CSRN5,2012-06-30,129746,38328,168074
18139,290,$CSRN5,2012-09-30,129746,38328,168074
18139,290,$CSRN5,2012-12-31,129746,38328,168074
18139,290,$CSRN5,2013-03-31,129746,38328,168074
18139,290,$CSRN5,2013-06-30,129746,38328,168074
18139,290,$CSRN5,2013-09-30,129746,38328,168074
18139,290,$CSRN5,2013-12-31,129746,38328,168074
18139,290,$CSRN5,2014-03-31,129746,38328,168074
18139,290,$CSRN5,2014-06-30,129746,38328,168074
18139,290,$CSRN5,2014-09-30,129746,38328,168074
18139,290,$CSRN5,2014-12-31,129746,38328,168074
18139,290,$CSRN5,2015-03-31,129746,38328,168074
18139,290,$CSRN5,2015-06-30,129746,38328,168074
18139,290,$CSRN5,2015-09-30,129746,38328,168074
18139,290,$CSRN5,2015-12-31,129746,38328,168074
18139,290,$CSRN5,2016-03-31,129746,38328,168074
18139,290,$CSRN5,2016-06-30,129746,38328,168074
18139,290,$CSRN5,2016-09-30,129746,38328,168074
18139,290,$CSRN5,2016-12-31,129746,38328,168074
18139,290,$CSRN5,2017-03-31,129746,38328,168074
18139,290,$CSRN5,2017-06-30,129746,38328,168074
18139,290,$CSRN5,2017-09-30,129746,38328,168074
18139,290,$CSRN5,2017-12-31,129746,38328,168074
18139,290,$CSRN5,2018-03-31,129746,38328,168074
18139,290,$CSRN5,2018-06-30,129746,38328,168074
18139,290,$CSRN5,2018-09-30,129746,38328,168074
18139,290,$CSRN5,2018-12-31,129746,38328,168074
18139,290,$CSRN5,2019-03-31,129746,38328,168074
18139,290,$CSRN5,2019-06-30,129746,38328,168074
18139,290,$CSRN5,2019-09-30,129746,38328,168074
18139,290,$CSRN5,2019-12-31,129746,38328,168074
18139,290,$CSRN5,2020-03-31,129746,38328,168074
18139,290,$CSRN5,2020-06-30,129746,38328,168074
18139,290,$CSRN5,2020-09-30,129746,38328,168074
18309,470,$CELP3,2010-12-31,59398,4453,63851
18309,470,$CELP3,2011-03-31,59398,4453,63851
18309,470,$CELP3,2011-06-30,59398,4453,63851
18309,470,$CELP3,2011-09-30,59398,4453,63851
18309,470,$CELP3,2011-12-31,59398,4453,63851
18309,470,$CELP3,2012-03-31,59398,4453,63851
18309,470,$CELP3,2012-06-30,59398,4453,63851
18309,470,$CELP3,2012-09-30,59398,4453,63851
18309,470,$CELP3,2012-12-31,59397496,4453438,63850934
18309,470,$CELP3,2013-03-31,59397496,4453438,63850934
18309,470,$CELP3,2013-06-30,1902996369,4453438,1907449807
18309,470,$CELP3,2013-09-30,1902996369,4453438,1907449807
18309,470,$CELP3,2013-12-31,1902996369,4453438,1907449807
18309,470,$CELP3,2014-03-31,1902996369,4453438,1907449807
18309,470,$CELP3,2014-06-30,1902996369,4453438,1907449807
18309,470,$CELP3,2014-09-30,1902996369,4453438,1907449807
18309,470,$CELP3,2014-12-31,1902996369,4453438,1907449807
18309,470,$CELP3,2015-03-31,1902996369,4453438,1907449807
18309,470,$CELP3,2015-06-30,1902996369,4453438,1907449807
18309,470,$CELP3,2015-09-30,2204620569,4453438,2209074007
18309,470,$CELP3,2015-12-31,2204620569,4453438,2209074007
18309,470,$CELP3,2016-03-31,2204620569,4453438,2209074007
18309,470,$CELP3,2016-06-30,2204620569,4453438,2209074007
18309,470,$CELP3,2016-09-30,2204620569,4453438,2209074007
18309,470,$CELP3,2016-12-31,2204620569,4453438,2209074007
18309,470,$CELP3,2017-03-31,2204620569,4453438,2209074007
18309,470,$CELP3,2017-06-30,2204620569,4453438,2209074007
18309,470,$CELP3,2017-09-30,2204620569,4453438,2209074007
18309,470,$CELP3,2017-12-31,2204620569,4453438,2209074007
18309,470,$CELP3,2018-03-31,2204620569,4453438,2209074007
18309,470,$CELP3,2018-06-30,2204620569,4453438,2209074007
18309,470,$CELP3,2018-09-30,2204620569,4453438,2209074007
18309,470,$CELP3,2018-12-31,2204620569,4453438,2209074007
18309,470,$CELP3,2019-03-31,2204620569,4453438,2209074007
18309,470,$CELP3,2019-06-30,2204620569,4453438,2209074007
18309,470,$CELP3,2019-09-30,2204620569,4453438,2209074007
18309,470,$CELP3,2019-12-31,2204620569,4453438,2209074007
18309,470,$CELP3,2020-03-31,2204620569,4453438,2209074007
18309,470,$CELP3,2020-06-30,2204620569,4453438,2209074007
18309,470,$CELP3,2020-09-30,2204620569,4453438,2209074007
18309,471,$CELP7,2010-12-31,59398,4453,63851
18309,471,$CELP7,2011-03-31,59398,4453,63851
18309,471,$CELP7,2011-06-30,59398,4453,63851
18309,471,$CELP7,2011-09-30,59398,4453,63851
18309,471,$CELP7,2011-12-31,59398,4453,63851
18309,471,$CELP7,2012-03-31,59398,4453,63851
18309,471,$CELP7,2012-06-30,59398,4453,63851
18309,471,$CELP7,2012-09-30,59398,4453,63851
18309,471,$CELP7,2012-12-31,59397496,4453438,63850934
18309,471,$CELP7,2013-03-31,59397496,4453438,63850934
18309,471,$CELP7,2013-06-30,1902996369,4453438,1907449807
18309,471,$CELP7,2013-09-30,1902996369,4453438,1907449807
18309,471,$CELP7,2013-12-31,1902996369,4453438,1907449807
18309,471,$CELP7,2014-03-31,1902996369,4453438,1907449807
18309,471,$CELP7,2014-06-30,1902996369,4453438,1907449807
18309,471,$CELP7,2014-09-30,1902996369,4453438,1907449807
18309,471,$CELP7,2014-12-31,1902996369,4453438,1907449807
18309,471,$CELP7,2015-03-31,1902996369,4453438,1907449807
18309,471,$CELP7,2015-06-30,1902996369,4453438,1907449807
18309,471,$CELP7,2015-09-30,2204620569,4453438,2209074007
18309,471,$CELP7,2015-12-31,2204620569,4453438,2209074007
18309,471,$CELP7,2016-03-31,2204620569,4453438,2209074007
18309,471,$CELP7,2016-06-30,2204620569,4453438,2209074007
18309,471,$CELP7,2016-09-30,2204620569,4453438,2209074007
18309,471,$CELP7,2016-12-31,2204620569,4453438,2209074007
18309,471,$CELP7,2017-03-31,2204620569,4453438,2209074007
18309,471,$CELP7,2017-06-30,2204620569,4453438,2209074007
18309,471,$CELP7,2017-09-30,2204620569,4453438,2209074007
18309,471,$CELP7,2017-12-31,2204620569,4453438,2209074007
18309,471,$CELP7,2018-03-31,2204620569,4453438,2209074007
18309,471,$CELP7,2018-06-30,2204620569,4453438,2209074007
18309,471,$CELP7,2018-09-30,2204620569,4453438,2209074007
18309,471,$CELP7,2018-12-31,2204620569,4453438,2209074007
18309,471,$CELP7,2019-03-31,2204620569,4453438,2209074007
18309,471,$CELP7,2019-06-30,2204620569,4453438,2209074007
18309,471,$CELP7,2019-09-30,2204620569,4453438,2209074007
18309,471,$CELP7,2019-12-31,2204620569,4453438,2209074007
18309,471,$CELP7,2020-03-31,2204620569,4453438,2209074007
18309,471,$CELP7,2020-06-30,2204620569,4453438,2209074007
18309,471,$CELP7,2020-09-30,2204620569,4453438,2209074007
18309,472,$CELP5,2010-12-31,59398,4453,63851
18309,472,$CELP5,2011-03-31,59398,4453,63851
18309,472,$CELP5,2011-06-30,59398,4453,63851
18309,472,$CELP5,2011-09-30,59398,4453,63851
18309,472,$CELP5,2011-12-31,59398,4453,63851
18309,472,$CELP5,2012-03-31,59398,4453,63851
18309,472,$CELP5,2012-06-30,59398,4453,63851
18309,472,$CELP5,2012-09-30,59398,4453,63851
18309,472,$CELP5,2012-12-31,59397496,4453438,63850934
18309,472,$CELP5,2013-03-31,59397496,4453438,63850934
18309,472,$CELP5,2013-06-30,1902996369,4453438,1907449807
18309,472,$CELP5,2013-09-30,1902996369,4453438,1907449807
18309,472,$CELP5,2013-12-31,1902996369,4453438,1907449807
18309,472,$CELP5,2014-03-31,1902996369,4453438,1907449807
18309,472,$CELP5,2014-06-30,1902996369,4453438,1907449807
18309,472,$CELP5,2014-09-30,1902996369,4453438,1907449807
18309,472,$CELP5,2014-12-31,1902996369,4453438,1907449807
18309,472,$CELP5,2015-03-31,1902996369,4453438,1907449807
18309,472,$CELP5,2015-06-30,1902996369,4453438,1907449807
18309,472,$CELP5,2015-09-30,2204620569,4453438,2209074007
18309,472,$CELP5,2015-12-31,2204620569,4453438,2209074007
18309,472,$CELP5,2016-03-31,2204620569,4453438,2209074007
18309,472,$CELP5,2016-06-30,2204620569,4453438,2209074007
18309,472,$CELP5,2016-09-30,2204620569,4453438,2209074007
18309,472,$CELP5,2016-12-31,2204620569,4453438,2209074007
18309,472,$CELP5,2017-03-31,2204620569,4453438,2209074007
18309,472,$CELP5,2017-06-30,2204620569,4453438,2209074007
18309,472,$CELP5,2017-09-30,2204620569,4453438,2209074007
18309,472,$CELP5,2017-12-31,2204620569,4453438,2209074007
18309,472,$CELP5,2018-03-31,2204620569,4453438,2209074007
18309,472,$CELP5,2018-06-30,2204620569,4453438,2209074007
18309,472,$CELP5,2018-09-30,2204620569,4453438,2209074007
18309,472,$CELP5,2018-12-31,2204620569,4453438,2209074007
18309,472,$CELP5,2019-03-31,2204620569,4453438,2209074007
18309,472,$CELP5,2019-06-30,2204620569,4453438,2209074007
18309,472,$CELP5,2019-09-30,2204620569,4453438,2209074007
18309,472,$CELP5,2019-12-31,2204620569,4453438,2209074007
18309,472,$CELP5,2020-03-31,2204620569,4453438,2209074007
18309,472,$CELP5,2020-06-30,2204620569,4453438,2209074007
18309,472,$CELP5,2020-09-30,2204620569,4453438,2209074007
18309,473,$CELP6,2010-12-31,59398,4453,63851
18309,473,$CELP6,2011-03-31,59398,4453,63851
18309,473,$CELP6,2011-06-30,59398,4453,63851
18309,473,$CELP6,2011-09-30,59398,4453,63851
18309,473,$CELP6,2011-12-31,59398,4453,63851
18309,473,$CELP6,2012-03-31,59398,4453,63851
18309,473,$CELP6,2012-06-30,59398,4453,63851
18309,473,$CELP6,2012-09-30,59398,4453,63851
18309,473,$CELP6,2012-12-31,59397496,4453438,63850934
18309,473,$CELP6,2013-03-31,59397496,4453438,63850934
18309,473,$CELP6,2013-06-30,1902996369,4453438,1907449807
18309,473,$CELP6,2013-09-30,1902996369,4453438,1907449807
18309,473,$CELP6,2013-12-31,1902996369,4453438,1907449807
18309,473,$CELP6,2014-03-31,1902996369,4453438,1907449807
18309,473,$CELP6,2014-06-30,1902996369,4453438,1907449807
18309,473,$CELP6,2014-09-30,1902996369,4453438,1907449807
18309,473,$CELP6,2014-12-31,1902996369,4453438,1907449807
18309,473,$CELP6,2015-03-31,1902996369,4453438,1907449807
18309,473,$CELP6,2015-06-30,1902996369,4453438,1907449807
18309,473,$CELP6,2015-09-30,2204620569,4453438,2209074007
18309,473,$CELP6,2015-12-31,2204620569,4453438,2209074007
18309,473,$CELP6,2016-03-31,2204620569,4453438,2209074007
18309,473,$CELP6,2016-06-30,2204620569,4453438,2209074007
18309,473,$CELP6,2016-09-30,2204620569,4453438,2209074007
18309,473,$CELP6,2016-12-31,2204620569,4453438,2209074007
18309,473,$CELP6,2017-03-31,2204620569,4453438,2209074007
18309,473,$CELP6,2017-06-30,2204620569,4453438,2209074007
18309,473,$CELP6,2017-09-30,2204620569,4453438,2209074007
18309,473,$CELP6,2017-12-31,2204620569,4453438,2209074007
18309,473,$CELP6,2018-03-31,2204620569,4453438,2209074007
18309,473,$CELP6,2018-06-30,2204620569,4453438,2209074007
18309,473,$CELP6,2018-09-30,2204620569,4453438,2209074007
18309,473,$CELP6,2018-12-31,2204620569,4453438,2209074007
18309,473,$CELP6,2019-03-31,2204620569,4453438,2209074007
18309,473,$CELP6,2019-06-30,2204620569,4453438,2209074007
18309,473,$CELP6,2019-09-30,2204620569,4453438,2209074007
18309,473,$CELP6,2019-12-31,2204620569,4453438,2209074007
18309,473,$CELP6,2020-03-31,2204620569,4453438,2209074007
18309,473,$CELP6,2020-06-30,2204620569,4453438,2209074007
18309,473,$CELP6,2020-09-30,2204620569,4453438,2209074007
18333,469,$PRPT3B,2010-12-31,11300000,0,11300000
18333,469,$PRPT3B,2011-03-31,11375000,0,11375000
18333,469,$PRPT3B,2011-06-30,11375000,0,11375000
18333,469,$PRPT3B,2011-09-30,11375000,0,11375000
18333,469,$PRPT3B,2011-12-31,11375000,0,11375000
18333,469,$PRPT3B,2012-03-31,11494403,0,11494403
18333,469,$PRPT3B,2012-06-30,11494403,0,11494403
18333,469,$PRPT3B,2012-09-30,11494403,0,11494403
18333,469,$PRPT3B,2012-12-31,19494403,0,19494403
18333,469,$PRPT3B,2013-03-31,19494403,0,19494403
18333,469,$PRPT3B,2013-06-30,19494403,0,19494403
18333,469,$PRPT3B,2013-09-30,19494403,0,19494403
18333,469,$PRPT3B,2013-12-31,19494403,0,19494403
18333,469,$PRPT3B,2014-03-31,29494403,0,29494403
18333,469,$PRPT3B,2014-06-30,29494403,0,29494403
18333,469,$PRPT3B,2014-09-30,29494403,0,29494403
18333,469,$PRPT3B,2014-12-31,29494403,0,29494403
18333,469,$PRPT3B,2015-03-31,38994403,0,38994403
18333,469,$PRPT3B,2015-06-30,40615795,0,40615795
18333,469,$PRPT3B,2015-09-30,40615795,0,40615795
18333,469,$PRPT3B,2015-12-31,40615795,0,40615795
18333,469,$PRPT3B,2016-03-31,40615795,0,40615795
18333,469,$PRPT3B,2016-06-30,51815796,0,51815796
18333,469,$PRPT3B,2016-09-30,51815796,0,51815796
18333,469,$PRPT3B,2016-12-31,51815796,0,51815796
18333,469,$PRPT3B,2017-03-31,51815796,0,51815796
18333,469,$PRPT3B,2017-06-30,61815796,0,61815796
18333,469,$PRPT3B,2017-09-30,61815796,0,61815796
18333,469,$PRPT3B,2017-12-31,61815796,0,61815796
18333,469,$PRPT3B,2018-03-31,72815796,0,72815796
18333,469,$PRPT3B,2018-06-30,72815796,0,72815796
18333,469,$PRPT3B,2018-09-30,72815796,0,72815796
18333,469,$PRPT3B,2018-12-31,72815796,0,72815796
18333,469,$PRPT3B,2019-03-31,86815796,0,86815796
18333,469,$PRPT3B,2019-06-30,86815796,0,86815796
18333,469,$PRPT3B,2019-09-30,86815796,0,86815796
18333,469,$PRPT3B,2019-12-31,106815796,0,106815796
18333,469,$PRPT3B,2020-03-31,106815796,0,106815796
18333,469,$PRPT3B,2020-06-30,106815796,0,106815796
18333,469,$PRPT3B,2020-09-30,106815796,0,106815796
18368,295,$GEPA3,2010-12-31,31478,62955,94433
18368,295,$GEPA3,2011-03-31,31478,62955,94433
18368,295,$GEPA3,2011-06-30,31478,62955,94433
18368,295,$GEPA3,2011-09-30,31478,62955,94433
18368,295,$GEPA3,2011-12-31,31478,62955,94433
18368,295,$GEPA3,2012-03-31,31478,62955,94433
18368,295,$GEPA3,2012-06-30,31478,62955,94433
18368,295,$GEPA3,2012-09-30,31478,62955,94433
18368,295,$GEPA3,2012-12-31,31478,62955,94433
18368,295,$GEPA3,2013-03-31,31478,62955,94433
18368,295,$GEPA3,2013-06-30,31478,62955,94433
18368,295,$GEPA3,2013-09-30,31478,62955,94433
18368,295,$GEPA3,2013-12-31,31478,62955,94433
18368,295,$GEPA3,2014-03-31,31478,62955,94433
18368,295,$GEPA3,2014-06-30,31478,62955,94433
18368,295,$GEPA3,2014-09-30,31478,62955,94433
18368,295,$GEPA3,2014-12-31,31478,62955,94433
18368,295,$GEPA3,2015-03-31,31478,62955,94433
18368,295,$GEPA3,2015-06-30,31478,62955,94433
18368,295,$GEPA3,2015-09-30,31478,62955,94433
18368,295,$GEPA3,2015-12-31,31478,62955,94433
18368,295,$GEPA3,2016-03-31,31478,62955,94433
18368,295,$GEPA3,2016-06-30,31478,62955,94433
18368,295,$GEPA3,2016-09-30,31478,62955,94433
18368,295,$GEPA3,2016-12-31,31478,62955,94433
18368,295,$GEPA3,2017-03-31,31478,62955,94433
18368,295,$GEPA3,2017-06-30,31478,62955,94433
18368,295,$GEPA3,2017-09-30,31478,62955,94433
18368,295,$GEPA3,2017-12-31,31478,62955,94433
18368,295,$GEPA3,2018-03-31,31478,62955,94433
18368,295,$GEPA3,2018-06-30,31478,62955,94433
18368,295,$GEPA3,2018-09-30,31478,62955,94433
18368,295,$GEPA3,2018-12-31,31478,62955,94433
18368,295,$GEPA3,2019-03-31,31478,62955,94433
18368,295,$GEPA3,2019-06-30,31478,62955,94433
18368,295,$GEPA3,2019-09-30,31478,62955,94433
18368,295,$GEPA3,2019-12-31,31478,62955,94433
18368,295,$GEPA3,2020-03-31,31478,62955,94433
18368,295,$GEPA3,2020-06-30,31478,62955,94433
18368,295,$GEPA3,2020-09-30,31478,62955,94433
18368,296,$GEPA4,2010-12-31,31478,62955,94433
18368,296,$GEPA4,2011-03-31,31478,62955,94433
18368,296,$GEPA4,2011-06-30,31478,62955,94433
18368,296,$GEPA4,2011-09-30,31478,62955,94433
18368,296,$GEPA4,2011-12-31,31478,62955,94433
18368,296,$GEPA4,2012-03-31,31478,62955,94433
18368,296,$GEPA4,2012-06-30,31478,62955,94433
18368,296,$GEPA4,2012-09-30,31478,62955,94433
18368,296,$GEPA4,2012-12-31,31478,62955,94433
18368,296,$GEPA4,2013-03-31,31478,62955,94433
18368,296,$GEPA4,2013-06-30,31478,62955,94433
18368,296,$GEPA4,2013-09-30,31478,62955,94433
18368,296,$GEPA4,2013-12-31,31478,62955,94433
18368,296,$GEPA4,2014-03-31,31478,62955,94433
18368,296,$GEPA4,2014-06-30,31478,62955,94433
18368,296,$GEPA4,2014-09-30,31478,62955,94433
18368,296,$GEPA4,2014-12-31,31478,62955,94433
18368,296,$GEPA4,2015-03-31,31478,62955,94433
18368,296,$GEPA4,2015-06-30,31478,62955,94433
18368,296,$GEPA4,2015-09-30,31478,62955,94433
18368,296,$GEPA4,2015-12-31,31478,62955,94433
18368,296,$GEPA4,2016-03-31,31478,62955,94433
18368,296,$GEPA4,2016-06-30,31478,62955,94433
18368,296,$GEPA4,2016-09-30,31478,62955,94433
18368,296,$GEPA4,2016-12-31,31478,62955,94433
18368,296,$GEPA4,2017-03-31,31478,62955,94433
18368,296,$GEPA4,2017-06-30,31478,62955,94433
18368,296,$GEPA4,2017-09-30,31478,62955,94433
18368,296,$GEPA4,2017-12-31,31478,62955,94433
18368,296,$GEPA4,2018-03-31,31478,62955,94433
18368,296,$GEPA4,2018-06-30,31478,62955,94433
18368,296,$GEPA4,2018-09-30,31478,62955,94433
18368,296,$GEPA4,2018-12-31,31478,62955,94433
18368,296,$GEPA4,2019-03-31,31478,62955,94433
18368,296,$GEPA4,2019-06-30,31478,62955,94433
18368,296,$GEPA4,2019-09-30,31478,62955,94433
18368,296,$GEPA4,2019-12-31,31478,62955,94433
18368,296,$GEPA4,2020-03-31,31478,62955,94433
18368,296,$GEPA4,2020-06-30,31478,62955,94433
18368,296,$GEPA4,2020-09-30,31478,62955,94433
18376,307,$TRPL3,2010-12-31,63861,87968,151829
18376,307,$TRPL3,2011-03-31,63861,87968,151829
18376,307,$TRPL3,2011-06-30,63861,87968,151829
18376,307,$TRPL3,2011-09-30,63861,87968,151829
18376,307,$TRPL3,2011-12-31,64484,88177,152661
18376,307,$TRPL3,2012-03-31,64484,88177,152661
18376,307,$TRPL3,2012-06-30,64484,88177,152661
18376,307,$TRPL3,2012-09-30,64484,88177,152661
18376,307,$TRPL3,2012-12-31,64484433,88177132,152661565
18376,307,$TRPL3,2013-03-31,64484,88177,152661
18376,307,$TRPL3,2013-06-30,64484,88177,152661
18376,307,$TRPL3,2013-09-30,64484,88177,152661
18376,307,$TRPL3,2013-12-31,64484,88177,152661
18376,307,$TRPL3,2014-03-31,64484,88177,152661
18376,307,$TRPL3,2014-06-30,64484,88177,152661
18376,307,$TRPL3,2014-09-30,64484433,96775022,161259455
18376,307,$TRPL3,2014-12-31,64484433,96775022,161259455
18376,307,$TRPL3,2015-03-31,64484433,96775022,161259455
18376,307,$TRPL3,2015-06-30,64484433,96775022,161259455
18376,307,$TRPL3,2015-09-30,64484433,96775022,161259455
18376,307,$TRPL3,2015-12-31,64484433,96775022,161259455
18376,307,$TRPL3,2016-03-31,64484433,96775022,161259455
18376,307,$TRPL3,2016-06-30,64484433,100236393,164720826
18376,307,$TRPL3,2016-09-30,64484433,100236393,164720826
18376,307,$TRPL3,2016-12-31,64484433,100236393,164720826
18376,307,$TRPL3,2017-03-31,64484433,100236393,164720826
18376,307,$TRPL3,2017-06-30,64484433,100236393,164720826
18376,307,$TRPL3,2017-09-30,64484433,100236393,164720826
18376,307,$TRPL3,2017-12-31,64484433,100236393,164720826
18376,307,$TRPL3,2018-03-31,64484433,100236393,164720826
18376,307,$TRPL3,2018-06-30,64484433,100236393,164720826
18376,307,$TRPL3,2018-09-30,64484433,100236393,164720826
18376,307,$TRPL3,2018-12-31,64484433,100236393,164720826
18376,307,$TRPL3,2019-03-31,64484433,100236393,164720826
18376,307,$TRPL3,2019-06-30,257937732,400945572,658883304
18376,307,$TRPL3,2019-09-30,257937732,400945572,658883304
18376,307,$TRPL3,2019-12-31,257937732,400945572,658883304
18376,307,$TRPL3,2020-03-31,257937732,400945572,658883304
18376,307,$TRPL3,2020-06-30,257937732,400945572,658883304
18376,307,$TRPL3,2020-09-30,257937732,400945572,658883304
18376,308,$TRPL4,2010-12-31,63861,87968,151829
18376,308,$TRPL4,2011-03-31,63861,87968,151829
18376,308,$TRPL4,2011-06-30,63861,87968,151829
18376,308,$TRPL4,2011-09-30,63861,87968,151829
18376,308,$TRPL4,2011-12-31,64484,88177,152661
18376,308,$TRPL4,2012-03-31,64484,88177,152661
18376,308,$TRPL4,2012-06-30,64484,88177,152661
18376,308,$TRPL4,2012-09-30,64484,88177,152661
18376,308,$TRPL4,2012-12-31,64484433,88177132,152661565
18376,308,$TRPL4,2013-03-31,64484,88177,152661
18376,308,$TRPL4,2013-06-30,64484,88177,152661
18376,308,$TRPL4,2013-09-30,64484,88177,152661
18376,308,$TRPL4,2013-12-31,64484,88177,152661
18376,308,$TRPL4,2014-03-31,64484,88177,152661
18376,308,$TRPL4,2014-06-30,64484,88177,152661
18376,308,$TRPL4,2014-09-30,64484433,96775022,161259455
18376,308,$TRPL4,2014-12-31,64484433,96775022,161259455
18376,308,$TRPL4,2015-03-31,64484433,96775022,161259455
18376,308,$TRPL4,2015-06-30,64484433,96775022,161259455
18376,308,$TRPL4,2015-09-30,64484433,96775022,161259455
18376,308,$TRPL4,2015-12-31,64484433,96775022,161259455
18376,308,$TRPL4,2016-03-31,64484433,96775022,161259455
18376,308,$TRPL4,2016-06-30,64484433,100236393,164720826
18376,308,$TRPL4,2016-09-30,64484433,100236393,164720826
18376,308,$TRPL4,2016-12-31,64484433,100236393,164720826
18376,308,$TRPL4,2017-03-31,64484433,100236393,164720826
18376,308,$TRPL4,2017-06-30,64484433,100236393,164720826
18376,308,$TRPL4,2017-09-30,64484433,100236393,164720826
18376,308,$TRPL4,2017-12-31,64484433,100236393,164720826
18376,308,$TRPL4,2018-03-31,64484433,100236393,164720826
18376,308,$TRPL4,2018-06-30,64484433,100236393,164720826
18376,308,$TRPL4,2018-09-30,64484433,100236393,164720826
18376,308,$TRPL4,2018-12-31,64484433,100236393,164720826
18376,308,$TRPL4,2019-03-31,64484433,100236393,164720826
18376,308,$TRPL4,2019-06-30,257937732,400945572,658883304
18376,308,$TRPL4,2019-09-30,257937732,400945572,658883304
18376,308,$TRPL4,2019-12-31,257937732,400945572,658883304
18376,308,$TRPL4,2020-03-31,257937732,400945572,658883304
18376,308,$TRPL4,2020-06-30,257937732,400945572,658883304
18376,308,$TRPL4,2020-09-30,257937732,400945572,658883304
18414,309,$IDNT3,2010-12-31,115381,0,115381
18414,309,$IDNT3,2011-03-31,115928,0,115928
18414,309,$IDNT3,2011-06-30,115928,0,115928
18414,309,$IDNT3,2011-09-30,115953,0,115953
18414,309,$IDNT3,2011-12-31,115928,0,115928
18414,309,$IDNT3,2012-03-31,115928,0,115928
18414,309,$IDNT3,2012-06-30,115928,0,115928
18414,309,$IDNT3,2012-09-30,115928,0,115928
18414,309,$IDNT3,2012-12-31,115928,0,115928
18414,309,$IDNT3,2013-03-31,115928,0,115928
18414,309,$IDNT3,2013-06-30,122270,0,122270
18414,309,$IDNT3,2013-09-30,103030,0,103030
18414,309,$IDNT3,2013-12-31,122270,0,122270
18414,309,$IDNT3,2014-03-31,122270,0,122270
18414,309,$IDNT3,2014-06-30,122270,0,122270
18414,309,$IDNT3,2014-09-30,122270,0,122270
18414,309,$IDNT3,2014-12-31,122270,0,122270
18414,309,$IDNT3,2015-03-31,122270,0,122270
18414,309,$IDNT3,2015-06-30,163436,0,163436
18414,309,$IDNT3,2015-09-30,16344,0,16344
18414,309,$IDNT3,2015-12-31,16344,0,16344
18414,309,$IDNT3,2016-03-31,16344,0,16344
18414,309,$IDNT3,2016-06-30,16344,0,16344
18414,309,$IDNT3,2016-09-30,16344,0,16344
18414,309,$IDNT3,2016-12-31,16344,0,16344
18414,309,$IDNT3,2017-03-31,16344,0,16344
18414,309,$IDNT3,2017-06-30,16344,0,16344
18414,309,$IDNT3,2017-09-30,16344,0,16344
18414,309,$IDNT3,2017-12-31,16344,0,16344
18414,309,$IDNT3,2018-03-31,16344,0,16344
18414,309,$IDNT3,2018-06-30,16344,0,16344
18414,309,$IDNT3,2018-09-30,16344,0,16344
18414,309,$IDNT3,2018-12-31,16344,0,16344
18414,309,$IDNT3,2019-03-31,16344,0,16344
18414,309,$IDNT3,2019-06-30,16344,0,16344
18414,309,$IDNT3,2019-09-30,16344,0,16344
18414,309,$IDNT3,2019-12-31,16344,0,16344
18414,309,$IDNT3,2020-03-31,16344,0,16344
18414,309,$IDNT3,2020-06-30,78450,0,78450
18414,309,$IDNT3,2020-09-30,78450,0,78450
18414,313,$PDTC3,2010-12-31,115381,0,115381
18414,313,$PDTC3,2011-03-31,115928,0,115928
18414,313,$PDTC3,2011-06-30,115928,0,115928
18414,313,$PDTC3,2011-09-30,115953,0,115953
18414,313,$PDTC3,2011-12-31,115928,0,115928
18414,313,$PDTC3,2012-03-31,115928,0,115928
18414,313,$PDTC3,2012-06-30,115928,0,115928
18414,313,$PDTC3,2012-09-30,115928,0,115928
18414,313,$PDTC3,2012-12-31,115928,0,115928
18414,313,$PDTC3,2013-03-31,115928,0,115928
18414,313,$PDTC3,2013-06-30,122270,0,122270
18414,313,$PDTC3,2013-09-30,103030,0,103030
18414,313,$PDTC3,2013-12-31,122270,0,122270
18414,313,$PDTC3,2014-03-31,122270,0,122270
18414,313,$PDTC3,2014-06-30,122270,0,122270
18414,313,$PDTC3,2014-09-30,122270,0,122270
18414,313,$PDTC3,2014-12-31,122270,0,122270
18414,313,$PDTC3,2015-03-31,122270,0,122270
18414,313,$PDTC3,2015-06-30,163436,0,163436
18414,313,$PDTC3,2015-09-30,16344,0,16344
18414,313,$PDTC3,2015-12-31,16344,0,16344
18414,313,$PDTC3,2016-03-31,16344,0,16344
18414,313,$PDTC3,2016-06-30,16344,0,16344
18414,313,$PDTC3,2016-09-30,16344,0,16344
18414,313,$PDTC3,2016-12-31,16344,0,16344
18414,313,$PDTC3,2017-03-31,16344,0,16344
18414,313,$PDTC3,2017-06-30,16344,0,16344
18414,313,$PDTC3,2017-09-30,16344,0,16344
18414,313,$PDTC3,2017-12-31,16344,0,16344
18414,313,$PDTC3,2018-03-31,16344,0,16344
18414,313,$PDTC3,2018-06-30,16344,0,16344
18414,313,$PDTC3,2018-09-30,16344,0,16344
18414,313,$PDTC3,2018-12-31,16344,0,16344
18414,313,$PDTC3,2019-03-31,16344,0,16344
18414,313,$PDTC3,2019-06-30,16344,0,16344
18414,313,$PDTC3,2019-09-30,16344,0,16344
18414,313,$PDTC3,2019-12-31,16344,0,16344
18414,313,$PDTC3,2020-03-31,16344,0,16344
18414,313,$PDTC3,2020-06-30,78450,0,78450
18414,313,$PDTC3,2020-09-30,78450,0,78450
18465,303,$UGPA3,2010-12-31,197719588,346664408,544383996
18465,303,$UGPA3,2011-03-31,197719588,346664408,544383996
18465,303,$UGPA3,2011-06-30,197719588,346664408,544383996
18465,303,$UGPA3,2011-09-30,544383996,0,544383996
18465,303,$UGPA3,2011-12-31,544383996,0,544383996
18465,303,$UGPA3,2012-03-31,544383996,0,544383996
18465,303,$UGPA3,2012-06-30,544383996,0,544383996
18465,303,$UGPA3,2012-09-30,544383996,0,544383996
18465,303,$UGPA3,2012-12-31,544383996,0,544383996
18465,303,$UGPA3,2013-03-31,544383996,0,544383996
18465,303,$UGPA3,2013-06-30,544383996,0,544383996
18465,303,$UGPA3,2013-09-30,544383996,0,544383996
18465,303,$UGPA3,2013-12-31,544383996,0,544383996
18465,303,$UGPA3,2014-03-31,556405096,0,556405096
18465,303,$UGPA3,2014-06-30,556405096,0,556405096
18465,303,$UGPA3,2014-09-30,556405096,0,556405096
18465,303,$UGPA3,2014-12-31,556405096,0,556405096
18465,303,$UGPA3,2015-03-31,556405096,0,556405096
18465,303,$UGPA3,2015-06-30,556405096,0,556405096
18465,303,$UGPA3,2015-09-30,556405096,0,556405096
18465,303,$UGPA3,2015-12-31,556405096,0,556405096
18465,303,$UGPA3,2016-03-31,556405096,0,556405096
18465,303,$UGPA3,2016-06-30,556405096,0,556405096
18465,303,$UGPA3,2016-09-30,556405096,0,556405096
18465,303,$UGPA3,2016-12-31,556405096,0,556405096
18465,303,$UGPA3,2017-03-31,556405096,0,556405096
18465,303,$UGPA3,2017-06-30,556405096,0,556405096
18465,303,$UGPA3,2017-09-30,556405096,0,556405096
18465,303,$UGPA3,2017-12-31,556405096,0,556405096
18465,303,$UGPA3,2018-03-31,556405096,0,556405096
18465,303,$UGPA3,2018-06-30,556405096,0,556405096
18465,303,$UGPA3,2018-09-30,556405096,0,556405096
18465,303,$UGPA3,2018-12-31,556405096,0,556405096
18465,303,$UGPA3,2019-03-31,556405096,0,556405096
18465,303,$UGPA3,2019-06-30,1112810192,0,1112810192
18465,303,$UGPA3,2019-09-30,1112810192,0,1112810192
18465,303,$UGPA3,2019-12-31,1112810192,0,1112810192
18465,303,$UGPA3,2020-03-31,1114918734,0,1114918734
18465,303,$UGPA3,2020-06-30,1114918734,0,1114918734
18465,303,$UGPA3,2020-09-30,1115005712,0,1115005712
18589,474,$00,2010-12-31,402202,384204,786406
18589,474,$00,2011-03-31,402202,384204,786406
18589,474,$00,2011-06-30,402202,384204,786406
18589,474,$00,2011-09-30,402202,384204,786406
18589,474,$00,2011-12-31,402202,384204,786406
18589,474,$00,2012-03-31,402202,384204,786406
18589,474,$00,2012-06-30,402202,384204,786406
18589,474,$00,2012-09-30,402202,384204,786406
18589,474,$00,2012-12-31,402202,384204,786406
18589,474,$00,2013-03-31,402202,384204,786406
18589,474,$00,2013-06-30,402202,384204,786406
18589,474,$00,2013-09-30,402202,384204,786406
18589,474,$00,2013-12-31,402202,384204,786406
18589,474,$00,2014-03-31,402202,384204,786406
18589,474,$00,2014-06-30,402202,384204,786406
18589,474,$00,2014-09-30,402202,384204,786406
18589,474,$00,2014-12-31,402202,384204,786406
18589,474,$00,2015-03-31,402202,384204,786406
18589,474,$00,2015-06-30,402202,384204,786406
18589,474,$00,2015-09-30,402202,384204,786406
18589,474,$00,2015-12-31,402202,384204,786406
18589,474,$00,2016-03-31,402202,384204,786406
18589,474,$00,2016-06-30,402202,384204,786406
18589,474,$00,2016-09-30,402202,384204,786406
18589,474,$00,2016-12-31,402202,384204,786406
18589,474,$00,2017-03-31,402202,384204,786406
18589,474,$00,2017-06-30,402202,384204,786406
18589,474,$00,2017-09-30,402202,384204,786406
18589,474,$00,2017-12-31,402202308,384203962,786406270
18589,474,$00,2018-03-31,402202,384204,786406
18589,474,$00,2018-06-30,402202,384204,786406
18589,474,$00,2018-09-30,402202,384204,786406
18589,474,$00,2018-12-31,402202,384204,786406
18589,474,$00,2019-03-31,402202,384204,786406
18589,474,$00,2019-06-30,402202,384204,786406
18589,474,$00,2019-09-30,402202,384204,786406
18589,474,$00,2019-12-31,402202,384204,786406
18589,474,$00,2020-03-31,402202,384204,786406
18589,474,$00,2020-06-30,402202,384204,786406
18589,474,$00,2020-09-30,402202,384204,786406
18597,300,$DTCY3,2010-12-31,52882,3247,56129
18597,300,$DTCY3,2011-03-31,52884310,3247500,56131810
18597,300,$DTCY3,2011-06-30,52884310,3247500,56131810
18597,300,$DTCY3,2011-09-30,52884310,3247500,56131810
18597,300,$DTCY3,2011-12-31,52884310,3247500,56131810
18597,300,$DTCY3,2012-03-31,52884310,3247500,56131810
18597,300,$DTCY3,2012-06-30,52884310,3247500,56131810
18597,300,$DTCY3,2012-09-30,52884310,3247500,56131810
18597,300,$DTCY3,2012-12-31,52884310,3247500,56131810
18597,300,$DTCY3,2013-03-31,52884310,3247500,56131810
18597,300,$DTCY3,2013-06-30,52884310,3247500,56131810
18597,300,$DTCY3,2013-09-30,52884310,3247500,56131810
18597,300,$DTCY3,2013-12-31,52884310,3247500,56131810
18597,300,$DTCY3,2014-03-31,52884310,3247500,56131810
18597,300,$DTCY3,2014-06-30,52884310,3247500,56131810
18597,300,$DTCY3,2014-09-30,52884310,3247500,56131810
18597,300,$DTCY3,2014-12-31,52884310,3247500,56131810
18597,300,$DTCY3,2015-03-31,52884310,3247500,56131810
18597,300,$DTCY3,2015-06-30,52884310,3247500,56131810
18597,300,$DTCY3,2015-09-30,52884310,3247500,56131810
18597,300,$DTCY3,2015-12-31,52884310,3247500,56131810
18597,300,$DTCY3,2016-03-31,52884310,3247500,56131810
18597,300,$DTCY3,2016-06-30,5288431,324750,5613181
18597,300,$DTCY3,2016-09-30,7338756,450655,7789411
18597,300,$DTCY3,2016-12-31,7338756,450655,7789411
18597,300,$DTCY3,2017-03-31,7338756,450655,7789411
18597,300,$DTCY3,2017-06-30,7338756,450655,7789411
18597,300,$DTCY3,2017-09-30,7338756,450655,7789411
18597,300,$DTCY3,2017-12-31,7338756,450655,7789411
18597,300,$DTCY3,2018-03-31,7338756,450655,7789411
18597,300,$DTCY3,2018-06-30,7338756,450655,7789411
18597,300,$DTCY3,2018-09-30,7338756,450655,7789411
18597,300,$DTCY3,2018-12-31,7338756,450655,7789411
18597,300,$DTCY3,2019-03-31,7338756,450655,7789411
18597,300,$DTCY3,2019-06-30,7338756,450655,7789411
18597,300,$DTCY3,2019-09-30,7338756,450655,7789411
18597,300,$DTCY3,2019-12-31,7338756,450655,7789411
18597,300,$DTCY3,2020-03-31,7338756,450655,7789411
18597,300,$DTCY3,2020-06-30,7338756,450655,7789411
18597,300,$DTCY3,2020-09-30,7338756,450655,7789411
18597,301,$DTCY,2010-12-31,52882,3247,56129
18597,301,$DTCY,2011-03-31,52884310,3247500,56131810
18597,301,$DTCY,2011-06-30,52884310,3247500,56131810
18597,301,$DTCY,2011-09-30,52884310,3247500,56131810
18597,301,$DTCY,2011-12-31,52884310,3247500,56131810
18597,301,$DTCY,2012-03-31,52884310,3247500,56131810
18597,301,$DTCY,2012-06-30,52884310,3247500,56131810
18597,301,$DTCY,2012-09-30,52884310,3247500,56131810
18597,301,$DTCY,2012-12-31,52884310,3247500,56131810
18597,301,$DTCY,2013-03-31,52884310,3247500,56131810
18597,301,$DTCY,2013-06-30,52884310,3247500,56131810
18597,301,$DTCY,2013-09-30,52884310,3247500,56131810
18597,301,$DTCY,2013-12-31,52884310,3247500,56131810
18597,301,$DTCY,2014-03-31,52884310,3247500,56131810
18597,301,$DTCY,2014-06-30,52884310,3247500,56131810
18597,301,$DTCY,2014-09-30,52884310,3247500,56131810
18597,301,$DTCY,2014-12-31,52884310,3247500,56131810
18597,301,$DTCY,2015-03-31,52884310,3247500,56131810
18597,301,$DTCY,2015-06-30,52884310,3247500,56131810
18597,301,$DTCY,2015-09-30,52884310,3247500,56131810
18597,301,$DTCY,2015-12-31,52884310,3247500,56131810
18597,301,$DTCY,2016-03-31,52884310,3247500,56131810
18597,301,$DTCY,2016-06-30,5288431,324750,5613181
18597,301,$DTCY,2016-09-30,7338756,450655,7789411
18597,301,$DTCY,2016-12-31,7338756,450655,7789411
18597,301,$DTCY,2017-03-31,7338756,450655,7789411
18597,301,$DTCY,2017-06-30,7338756,450655,7789411
18597,301,$DTCY,2017-09-30,7338756,450655,7789411
18597,301,$DTCY,2017-12-31,7338756,450655,7789411
18597,301,$DTCY,2018-03-31,7338756,450655,7789411
18597,301,$DTCY,2018-06-30,7338756,450655,7789411
18597,301,$DTCY,2018-09-30,7338756,450655,7789411
18597,301,$DTCY,2018-12-31,7338756,450655,7789411
18597,301,$DTCY,2019-03-31,7338756,450655,7789411
18597,301,$DTCY,2019-06-30,7338756,450655,7789411
18597,301,$DTCY,2019-09-30,7338756,450655,7789411
18597,301,$DTCY,2019-12-31,7338756,450655,7789411
18597,301,$DTCY,2020-03-31,7338756,450655,7789411
18597,301,$DTCY,2020-06-30,7338756,450655,7789411
18597,301,$DTCY,2020-09-30,7338756,450655,7789411
18627,304,$SAPR4,2010-12-31,289836870,124245312,414082182
18627,304,$SAPR4,2011-03-31,289836870,124245312,414082182
18627,304,$SAPR4,2011-06-30,289836870,124245312,414082182
18627,304,$SAPR4,2011-09-30,289836870,124245312,414082182
18627,304,$SAPR4,2011-12-31,289836870,124245312,414082182
18627,304,$SAPR4,2012-03-31,289836870,124245312,414082182
18627,304,$SAPR4,2012-06-30,289836870,124245312,414082182
18627,304,$SAPR4,2012-09-30,289836870,124245312,414082182
18627,304,$SAPR4,2012-12-31,289836870,124245312,414082182
18627,304,$SAPR4,2013-03-31,289836870,124245312,414082182
18627,304,$SAPR4,2013-06-30,289836870,124245312,414082182
18627,304,$SAPR4,2013-09-30,289836870,124245312,414082182
18627,304,$SAPR4,2013-12-31,289836870,186783336,476620206
18627,304,$SAPR4,2014-03-31,289836870,186783336,476620206
18627,304,$SAPR4,2014-06-30,231967956,244652250,476620206
18627,304,$SAPR4,2014-09-30,231967956,244652250,476620206
18627,304,$SAPR4,2014-12-31,231967956,244652250,476620206
18627,304,$SAPR4,2015-03-31,231967956,244652250,476620206
18627,304,$SAPR4,2015-06-30,231967956,244652250,476620206
18627,304,$SAPR4,2015-09-30,231967956,244652250,476620206
18627,304,$SAPR4,2015-12-31,231967956,244652250,476620206
18627,304,$SAPR4,2016-03-31,231967956,244652250,476620206
18627,304,$SAPR4,2016-06-30,231967956,244652250,476620206
18627,304,$SAPR4,2016-09-30,231967956,244652250,476620206
18627,304,$SAPR4,2016-12-31,167911724,335823449,503735173
18627,304,$SAPR4,2017-03-31,167911724,335823449,503735173
18627,304,$SAPR4,2017-06-30,167911724,335823449,503735173
18627,304,$SAPR4,2017-09-30,167911724,335823449,503735173
18627,304,$SAPR4,2017-12-31,167911753,335823420,503735173
18627,304,$SAPR4,2018-03-31,167911753,335823420,503735173
18627,304,$SAPR4,2018-06-30,167911753,335823420,503735173
18627,304,$SAPR4,2018-09-30,167911753,335823420,503735173
18627,304,$SAPR4,2018-12-31,167911753,335823420,503735173
18627,304,$SAPR4,2019-03-31,167911753,335823420,503735173
18627,304,$SAPR4,2019-06-30,167911753,335823420,503735173
18627,304,$SAPR4,2019-09-30,167911753,335823420,503735173
18627,304,$SAPR4,2019-12-31,167911753,335823420,503735173
18627,304,$SAPR4,2020-03-31,503735259,1007470260,1511205519
18627,304,$SAPR4,2020-06-30,503735259,1007470260,1511205519
18627,304,$SAPR4,2020-09-30,503735259,1007470260,1511205519
18627,305,$SAPR3,2010-12-31,289836870,124245312,414082182
18627,305,$SAPR3,2011-03-31,289836870,124245312,414082182
18627,305,$SAPR3,2011-06-30,289836870,124245312,414082182
18627,305,$SAPR3,2011-09-30,289836870,124245312,414082182
18627,305,$SAPR3,2011-12-31,289836870,124245312,414082182
18627,305,$SAPR3,2012-03-31,289836870,124245312,414082182
18627,305,$SAPR3,2012-06-30,289836870,124245312,414082182
18627,305,$SAPR3,2012-09-30,289836870,124245312,414082182
18627,305,$SAPR3,2012-12-31,289836870,124245312,414082182
18627,305,$SAPR3,2013-03-31,289836870,124245312,414082182
18627,305,$SAPR3,2013-06-30,289836870,124245312,414082182
18627,305,$SAPR3,2013-09-30,289836870,124245312,414082182
18627,305,$SAPR3,2013-12-31,289836870,186783336,476620206
18627,305,$SAPR3,2014-03-31,289836870,186783336,476620206
18627,305,$SAPR3,2014-06-30,231967956,244652250,476620206
18627,305,$SAPR3,2014-09-30,231967956,244652250,476620206
18627,305,$SAPR3,2014-12-31,231967956,244652250,476620206
18627,305,$SAPR3,2015-03-31,231967956,244652250,476620206
18627,305,$SAPR3,2015-06-30,231967956,244652250,476620206
18627,305,$SAPR3,2015-09-30,231967956,244652250,476620206
18627,305,$SAPR3,2015-12-31,231967956,244652250,476620206
18627,305,$SAPR3,2016-03-31,231967956,244652250,476620206
18627,305,$SAPR3,2016-06-30,231967956,244652250,476620206
18627,305,$SAPR3,2016-09-30,231967956,244652250,476620206
18627,305,$SAPR3,2016-12-31,167911724,335823449,503735173
18627,305,$SAPR3,2017-03-31,167911724,335823449,503735173
18627,305,$SAPR3,2017-06-30,167911724,335823449,503735173
18627,305,$SAPR3,2017-09-30,167911724,335823449,503735173
18627,305,$SAPR3,2017-12-31,167911753,335823420,503735173
18627,305,$SAPR3,2018-03-31,167911753,335823420,503735173
18627,305,$SAPR3,2018-06-30,167911753,335823420,503735173
18627,305,$SAPR3,2018-09-30,167911753,335823420,503735173
18627,305,$SAPR3,2018-12-31,167911753,335823420,503735173
18627,305,$SAPR3,2019-03-31,167911753,335823420,503735173
18627,305,$SAPR3,2019-06-30,167911753,335823420,503735173
18627,305,$SAPR3,2019-09-30,167911753,335823420,503735173
18627,305,$SAPR3,2019-12-31,167911753,335823420,503735173
18627,305,$SAPR3,2020-03-31,503735259,1007470260,1511205519
18627,305,$SAPR3,2020-06-30,503735259,1007470260,1511205519
18627,305,$SAPR3,2020-09-30,503735259,1007470260,1511205519
18627,590,$SAPR11,2010-12-31,289836870,124245312,414082182
18627,590,$SAPR11,2011-03-31,289836870,124245312,414082182
18627,590,$SAPR11,2011-06-30,289836870,124245312,414082182
18627,590,$SAPR11,2011-09-30,289836870,124245312,414082182
18627,590,$SAPR11,2011-12-31,289836870,124245312,414082182
18627,590,$SAPR11,2012-03-31,289836870,124245312,414082182
18627,590,$SAPR11,2012-06-30,289836870,124245312,414082182
18627,590,$SAPR11,2012-09-30,289836870,124245312,414082182
18627,590,$SAPR11,2012-12-31,289836870,124245312,414082182
18627,590,$SAPR11,2013-03-31,289836870,124245312,414082182
18627,590,$SAPR11,2013-06-30,289836870,124245312,414082182
18627,590,$SAPR11,2013-09-30,289836870,124245312,414082182
18627,590,$SAPR11,2013-12-31,289836870,186783336,476620206
18627,590,$SAPR11,2014-03-31,289836870,186783336,476620206
18627,590,$SAPR11,2014-06-30,231967956,244652250,476620206
18627,590,$SAPR11,2014-09-30,231967956,244652250,476620206
18627,590,$SAPR11,2014-12-31,231967956,244652250,476620206
18627,590,$SAPR11,2015-03-31,231967956,244652250,476620206
18627,590,$SAPR11,2015-06-30,231967956,244652250,476620206
18627,590,$SAPR11,2015-09-30,231967956,244652250,476620206
18627,590,$SAPR11,2015-12-31,231967956,244652250,476620206
18627,590,$SAPR11,2016-03-31,231967956,244652250,476620206
18627,590,$SAPR11,2016-06-30,231967956,244652250,476620206
18627,590,$SAPR11,2016-09-30,231967956,244652250,476620206
18627,590,$SAPR11,2016-12-31,167911724,335823449,503735173
18627,590,$SAPR11,2017-03-31,167911724,335823449,503735173
18627,590,$SAPR11,2017-06-30,167911724,335823449,503735173
18627,590,$SAPR11,2017-09-30,167911724,335823449,503735173
18627,590,$SAPR11,2017-12-31,167911753,335823420,503735173
18627,590,$SAPR11,2018-03-31,167911753,335823420,503735173
18627,590,$SAPR11,2018-06-30,167911753,335823420,503735173
18627,590,$SAPR11,2018-09-30,167911753,335823420,503735173
18627,590,$SAPR11,2018-12-31,167911753,335823420,503735173
18627,590,$SAPR11,2019-03-31,167911753,335823420,503735173
18627,590,$SAPR11,2019-06-30,167911753,335823420,503735173
18627,590,$SAPR11,2019-09-30,167911753,335823420,503735173
18627,590,$SAPR11,2019-12-31,167911753,335823420,503735173
18627,590,$SAPR11,2020-03-31,503735259,1007470260,1511205519
18627,590,$SAPR11,2020-06-30,503735259,1007470260,1511205519
18627,590,$SAPR11,2020-09-30,503735259,1007470260,1511205519
18660,317,$CPFE3,2010-12-31,481137130,0,481137130
18660,317,$CPFE3,2011-03-31,481137130,0,481137130
18660,317,$CPFE3,2011-06-30,962274260,0,962274260
18660,317,$CPFE3,2011-09-30,962274260,0,962274260
18660,317,$CPFE3,2011-12-31,962274260,0,962274260
18660,317,$CPFE3,2012-03-31,962274260,0,962274260
18660,317,$CPFE3,2012-06-30,962274260,0,962274260
18660,317,$CPFE3,2012-09-30,962274260,0,962274260
18660,317,$CPFE3,2012-12-31,962274260,0,962274260
18660,317,$CPFE3,2013-03-31,962274260,0,962274260
18660,317,$CPFE3,2013-06-30,962274260,0,962274260
18660,317,$CPFE3,2013-09-30,962274260,0,962274260
18660,317,$CPFE3,2013-12-31,962274260,0,962274260
18660,317,$CPFE3,2014-03-31,962274260,0,962274260
18660,317,$CPFE3,2014-06-30,962274260,0,962274260
18660,317,$CPFE3,2014-09-30,962274260,0,962274260
18660,317,$CPFE3,2014-12-31,962274260,0,962274260
18660,317,$CPFE3,2015-03-31,962274260,0,962274260
18660,317,$CPFE3,2015-06-30,993014215,0,993014215
18660,317,$CPFE3,2015-09-30,993014215,0,993014215
18660,317,$CPFE3,2015-12-31,993014215,0,993014215
18660,317,$CPFE3,2016-03-31,993014215,0,993014215
18660,317,$CPFE3,2016-06-30,1017914746,0,1017914746
18660,317,$CPFE3,2016-09-30,1017914746,0,1017914746
18660,317,$CPFE3,2016-12-31,1017914746,0,1017914746
18660,317,$CPFE3,2017-03-31,1017914746,0,1017914746
18660,317,$CPFE3,2017-06-30,1017914746,0,1017914746
18660,317,$CPFE3,2017-09-30,1017917746,0,1017917746
18660,317,$CPFE3,2017-12-31,1017914746,0,1017914746
18660,317,$CPFE3,2018-03-31,1017914746,0,1017914746
18660,317,$CPFE3,2018-06-30,1017914746,0,1017914746
18660,317,$CPFE3,2018-09-30,1017914746,0,1017914746
18660,317,$CPFE3,2018-12-31,1017914746,0,1017914746
18660,317,$CPFE3,2019-03-31,1017914746,0,1017914746
18660,317,$CPFE3,2019-06-30,1152254440,0,1152254440
18660,317,$CPFE3,2019-09-30,1152254440,0,1152254440
18660,317,$CPFE3,2019-12-31,1152254440,0,1152254440
18660,317,$CPFE3,2020-03-31,1152254440,0,1152254440
18660,317,$CPFE3,2020-06-30,1152254440,0,1152254440
18660,317,$CPFE3,2020-09-30,1152254440,0,1152254440
18708,311,$PEAB3,2010-12-31,6425139,6425139,12850278
18708,311,$PEAB3,2011-03-31,6425139,6425139,12850278
18708,311,$PEAB3,2011-06-30,6425139,6425139,12850278
18708,311,$PEAB3,2011-09-30,6425139,6425139,12850278
18708,311,$PEAB3,2011-12-31,6425,6425,12850
18708,311,$PEAB3,2012-03-31,6425139,6425139,12850278
18708,311,$PEAB3,2012-06-30,6425139,6425139,12850278
18708,311,$PEAB3,2012-09-30,6425139,6425139,12850278
18708,311,$PEAB3,2012-12-31,6425,6425,12850
18708,311,$PEAB3,2013-03-31,6425139,6425139,12850278
18708,311,$PEAB3,2013-06-30,6425139,6425139,12850278
18708,311,$PEAB3,2013-09-30,6425139,6425139,12850278
18708,311,$PEAB3,2013-12-31,6425,6425,12850
18708,311,$PEAB3,2014-03-31,6425139,6425139,12850278
18708,311,$PEAB3,2014-06-30,6425139,6425139,12850278
18708,311,$PEAB3,2014-09-30,6425139,6425139,12850278
18708,311,$PEAB3,2014-12-31,6425,6425,12850
18708,311,$PEAB3,2015-03-31,6425139,6425139,12850278
18708,311,$PEAB3,2015-06-30,6425139,6425139,12850278
18708,311,$PEAB3,2015-09-30,6425139,6425139,12850278
18708,311,$PEAB3,2015-12-31,6425,6425,12850
18708,311,$PEAB3,2016-03-31,6425139,6425139,12850278
18708,311,$PEAB3,2016-06-30,6425139,6425139,12850278
18708,311,$PEAB3,2016-09-30,6425139,6425139,12850278
18708,311,$PEAB3,2016-12-31,6425,6425,12850
18708,311,$PEAB3,2017-03-31,6425139,6425139,12850278
18708,311,$PEAB3,2017-06-30,6425139,6425139,12850278
18708,311,$PEAB3,2017-09-30,6425139,6425139,12850278
18708,311,$PEAB3,2017-12-31,6425139,6425139,12850278
18708,311,$PEAB3,2018-03-31,6425139,6425139,12850278
18708,311,$PEAB3,2018-06-30,6425139,6425139,12850278
18708,311,$PEAB3,2018-09-30,6425139,6425139,12850278
18708,311,$PEAB3,2018-12-31,6425139,6425139,12850278
18708,311,$PEAB3,2019-03-31,6425139,6425139,12850278
18708,311,$PEAB3,2019-06-30,6425139,6425139,12850278
18708,311,$PEAB3,2019-09-30,6425139,6425139,12850278
18708,311,$PEAB3,2019-12-31,6425139,6425139,12850278
18708,311,$PEAB3,2020-03-31,6425139,6425139,12850278
18708,311,$PEAB3,2020-06-30,6425139,6425139,12850278
18708,311,$PEAB3,2020-09-30,6425139,6425139,12850278
18708,312,$PEAB4,2010-12-31,6425139,6425139,12850278
18708,312,$PEAB4,2011-03-31,6425139,6425139,12850278
18708,312,$PEAB4,2011-06-30,6425139,6425139,12850278
18708,312,$PEAB4,2011-09-30,6425139,6425139,12850278
18708,312,$PEAB4,2011-12-31,6425,6425,12850
18708,312,$PEAB4,2012-03-31,6425139,6425139,12850278
18708,312,$PEAB4,2012-06-30,6425139,6425139,12850278
18708,312,$PEAB4,2012-09-30,6425139,6425139,12850278
18708,312,$PEAB4,2012-12-31,6425,6425,12850
18708,312,$PEAB4,2013-03-31,6425139,6425139,12850278
18708,312,$PEAB4,2013-06-30,6425139,6425139,12850278
18708,312,$PEAB4,2013-09-30,6425139,6425139,12850278
18708,312,$PEAB4,2013-12-31,6425,6425,12850
18708,312,$PEAB4,2014-03-31,6425139,6425139,12850278
18708,312,$PEAB4,2014-06-30,6425139,6425139,12850278
18708,312,$PEAB4,2014-09-30,6425139,6425139,12850278
18708,312,$PEAB4,2014-12-31,6425,6425,12850
18708,312,$PEAB4,2015-03-31,6425139,6425139,12850278
18708,312,$PEAB4,2015-06-30,6425139,6425139,12850278
18708,312,$PEAB4,2015-09-30,6425139,6425139,12850278
18708,312,$PEAB4,2015-12-31,6425,6425,12850
18708,312,$PEAB4,2016-03-31,6425139,6425139,12850278
18708,312,$PEAB4,2016-06-30,6425139,6425139,12850278
18708,312,$PEAB4,2016-09-30,6425139,6425139,12850278
18708,312,$PEAB4,2016-12-31,6425,6425,12850
18708,312,$PEAB4,2017-03-31,6425139,6425139,12850278
18708,312,$PEAB4,2017-06-30,6425139,6425139,12850278
18708,312,$PEAB4,2017-09-30,6425139,6425139,12850278
18708,312,$PEAB4,2017-12-31,6425139,6425139,12850278
18708,312,$PEAB4,2018-03-31,6425139,6425139,12850278
18708,312,$PEAB4,2018-06-30,6425139,6425139,12850278
18708,312,$PEAB4,2018-09-30,6425139,6425139,12850278
18708,312,$PEAB4,2018-12-31,6425139,6425139,12850278
18708,312,$PEAB4,2019-03-31,6425139,6425139,12850278
18708,312,$PEAB4,2019-06-30,6425139,6425139,12850278
18708,312,$PEAB4,2019-09-30,6425139,6425139,12850278
18708,312,$PEAB4,2019-12-31,6425139,6425139,12850278
18708,312,$PEAB4,2020-03-31,6425139,6425139,12850278
18708,312,$PEAB4,2020-06-30,6425139,6425139,12850278
18708,312,$PEAB4,2020-09-30,6425139,6425139,12850278
18724,314,$BRAP3,2010-12-31,122523,227025,349548
18724,314,$BRAP3,2011-03-31,122523,227025,349548
18724,314,$BRAP3,2011-06-30,122523,227025,349548
18724,314,$BRAP3,2011-09-30,122523,227025,349548
18724,314,$BRAP3,2011-12-31,122523,227025,349548
18724,314,$BRAP3,2012-03-31,122523,227025,349548
18724,314,$BRAP3,2012-06-30,122523,227025,349548
18724,314,$BRAP3,2012-09-30,122523,227025,349548
18724,314,$BRAP3,2012-12-31,122523,227025,349548
18724,314,$BRAP3,2013-03-31,122523,227025,349548
18724,314,$BRAP3,2013-06-30,122523,227025,349548
18724,314,$BRAP3,2013-09-30,122523,227025,349548
18724,314,$BRAP3,2013-12-31,122523,227025,349548
18724,314,$BRAP3,2014-03-31,122523,227025,349548
18724,314,$BRAP3,2014-06-30,122523,227025,349548
18724,314,$BRAP3,2014-09-30,122523,227025,349548
18724,314,$BRAP3,2014-12-31,122523,227025,349548
18724,314,$BRAP3,2015-03-31,122523,227025,349548
18724,314,$BRAP3,2015-06-30,122523,227025,349548
18724,314,$BRAP3,2015-09-30,122523,227025,349548
18724,314,$BRAP3,2015-12-31,122523,227025,349548
18724,314,$BRAP3,2016-03-31,122523,227025,349548
18724,314,$BRAP3,2016-06-30,122523,227025,349548
18724,314,$BRAP3,2016-09-30,122523,227025,349548
18724,314,$BRAP3,2016-12-31,122523,227025,349548
18724,314,$BRAP3,2017-03-31,122523,227025,349548
18724,314,$BRAP3,2017-06-30,122523,227025,349548
18724,314,$BRAP3,2017-09-30,122523,227025,349548
18724,314,$BRAP3,2017-12-31,122523,227025,349548
18724,314,$BRAP3,2018-03-31,122523,227025,349548
18724,314,$BRAP3,2018-06-30,122171,225863,348034
18724,314,$BRAP3,2018-09-30,122171,225863,348034
18724,314,$BRAP3,2018-12-31,122171,225863,348034
18724,314,$BRAP3,2019-03-31,122171,225863,348034
18724,314,$BRAP3,2019-06-30,122171,225863,348034
18724,314,$BRAP3,2019-09-30,122171,225863,348034
18724,314,$BRAP3,2019-12-31,122171,225863,348034
18724,314,$BRAP3,2020-03-31,122171,225863,348034
18724,314,$BRAP3,2020-06-30,122171,225863,348034
18724,314,$BRAP3,2020-09-30,122171,225863,348034
18724,315,$BRAP4,2010-12-31,122523,227025,349548
18724,315,$BRAP4,2011-03-31,122523,227025,349548
18724,315,$BRAP4,2011-06-30,122523,227025,349548
18724,315,$BRAP4,2011-09-30,122523,227025,349548
18724,315,$BRAP4,2011-12-31,122523,227025,349548
18724,315,$BRAP4,2012-03-31,122523,227025,349548
18724,315,$BRAP4,2012-06-30,122523,227025,349548
18724,315,$BRAP4,2012-09-30,122523,227025,349548
18724,315,$BRAP4,2012-12-31,122523,227025,349548
18724,315,$BRAP4,2013-03-31,122523,227025,349548
18724,315,$BRAP4,2013-06-30,122523,227025,349548
18724,315,$BRAP4,2013-09-30,122523,227025,349548
18724,315,$BRAP4,2013-12-31,122523,227025,349548
18724,315,$BRAP4,2014-03-31,122523,227025,349548
18724,315,$BRAP4,2014-06-30,122523,227025,349548
18724,315,$BRAP4,2014-09-30,122523,227025,349548
18724,315,$BRAP4,2014-12-31,122523,227025,349548
18724,315,$BRAP4,2015-03-31,122523,227025,349548
18724,315,$BRAP4,2015-06-30,122523,227025,349548
18724,315,$BRAP4,2015-09-30,122523,227025,349548
18724,315,$BRAP4,2015-12-31,122523,227025,349548
18724,315,$BRAP4,2016-03-31,122523,227025,349548
18724,315,$BRAP4,2016-06-30,122523,227025,349548
18724,315,$BRAP4,2016-09-30,122523,227025,349548
18724,315,$BRAP4,2016-12-31,122523,227025,349548
18724,315,$BRAP4,2017-03-31,122523,227025,349548
18724,315,$BRAP4,2017-06-30,122523,227025,349548
18724,315,$BRAP4,2017-09-30,122523,227025,349548
18724,315,$BRAP4,2017-12-31,122523,227025,349548
18724,315,$BRAP4,2018-03-31,122523,227025,349548
18724,315,$BRAP4,2018-06-30,122171,225863,348034
18724,315,$BRAP4,2018-09-30,122171,225863,348034
18724,315,$BRAP4,2018-12-31,122171,225863,348034
18724,315,$BRAP4,2019-03-31,122171,225863,348034
18724,315,$BRAP4,2019-06-30,122171,225863,348034
18724,315,$BRAP4,2019-09-30,122171,225863,348034
18724,315,$BRAP4,2019-12-31,122171,225863,348034
18724,315,$BRAP4,2020-03-31,122171,225863,348034
18724,315,$BRAP4,2020-06-30,122171,225863,348034
18724,315,$BRAP4,2020-09-30,122171,225863,348034
18775,475,$IVPR3,2010-12-31,91099784,182199568,273299352
18775,475,$IVPR3,2011-03-31,91099784,182199568,273299352
18775,475,$IVPR3,2011-06-30,91099784,182199568,273299352
18775,475,$IVPR3,2011-09-30,94744746,189489492,284234238
18775,475,$IVPR3,2011-12-31,99229,198459,297688
18775,475,$IVPR3,2012-03-31,143057124,286114248,429171372
18775,475,$IVPR3,2012-06-30,143057124,286114248,429171372
18775,475,$IVPR3,2012-09-30,143057124,286114248,429171372
18775,475,$IVPR3,2012-12-31,143057,286114,429171
18775,475,$IVPR3,2013-03-31,143057124,286114248,429171372
18775,475,$IVPR3,2013-06-30,143057124,286114248,429171372
18775,475,$IVPR3,2013-09-30,143057124,286114248,429171372
18775,475,$IVPR3,2013-12-31,143057,286114,429171
18775,475,$IVPR3,2014-03-31,143057124,286114248,429171372
18775,475,$IVPR3,2014-06-30,143057124,286114248,429171372
18775,475,$IVPR3,2014-09-30,143057124,286114248,429171372
18775,475,$IVPR3,2014-12-31,143057124,286114248,429171372
18775,475,$IVPR3,2015-03-31,143057124,286114248,429171372
18775,475,$IVPR3,2015-06-30,143057124,286114248,429171372
18775,475,$IVPR3,2015-09-30,143057124,286114248,429171372
18775,475,$IVPR3,2015-12-31,143057124,286114248,429171372
18775,475,$IVPR3,2016-03-31,143057124,286114248,429171372
18775,475,$IVPR3,2016-06-30,143057124,286114248,429171372
18775,475,$IVPR3,2016-09-30,143057124,286114248,429171372
18775,475,$IVPR3,2016-12-31,143057124,286114248,429171372
18775,475,$IVPR3,2017-03-31,143057124,286114248,429171372
18775,475,$IVPR3,2017-06-30,143057124,286114248,429171372
18775,475,$IVPR3,2017-09-30,143057124,286114248,429171372
18775,475,$IVPR3,2017-12-31,143057124,286114248,429171372
18775,475,$IVPR3,2018-03-31,143057124,286114248,429171372
18775,475,$IVPR3,2018-06-30,143057124,286114248,429171372
18775,475,$IVPR3,2018-09-30,143057124,286114248,429171372
18775,475,$IVPR3,2018-12-31,143057124,286114248,429171372
18775,475,$IVPR3,2019-03-31,143057124,286114248,429171372
18775,475,$IVPR3,2019-06-30,143057124,286114248,429171372
18775,475,$IVPR3,2019-09-30,143057124,286114248,429171372
18775,475,$IVPR3,2019-12-31,143057124,286114248,429171372
18775,475,$IVPR3,2020-03-31,143057124,286114248,429171372
18775,475,$IVPR3,2020-06-30,143057124,286114248,429171372
18775,475,$IVPR3,2020-09-30,143057124,286114248,429171372
18775,476,$IVPR4,2010-12-31,91099784,182199568,273299352
18775,476,$IVPR4,2011-03-31,91099784,182199568,273299352
18775,476,$IVPR4,2011-06-30,91099784,182199568,273299352
18775,476,$IVPR4,2011-09-30,94744746,189489492,284234238
18775,476,$IVPR4,2011-12-31,99229,198459,297688
18775,476,$IVPR4,2012-03-31,143057124,286114248,429171372
18775,476,$IVPR4,2012-06-30,143057124,286114248,429171372
18775,476,$IVPR4,2012-09-30,143057124,286114248,429171372
18775,476,$IVPR4,2012-12-31,143057,286114,429171
18775,476,$IVPR4,2013-03-31,143057124,286114248,429171372
18775,476,$IVPR4,2013-06-30,143057124,286114248,429171372
18775,476,$IVPR4,2013-09-30,143057124,286114248,429171372
18775,476,$IVPR4,2013-12-31,143057,286114,429171
18775,476,$IVPR4,2014-03-31,143057124,286114248,429171372
18775,476,$IVPR4,2014-06-30,143057124,286114248,429171372
18775,476,$IVPR4,2014-09-30,143057124,286114248,429171372
18775,476,$IVPR4,2014-12-31,143057124,286114248,429171372
18775,476,$IVPR4,2015-03-31,143057124,286114248,429171372
18775,476,$IVPR4,2015-06-30,143057124,286114248,429171372
18775,476,$IVPR4,2015-09-30,143057124,286114248,429171372
18775,476,$IVPR4,2015-12-31,143057124,286114248,429171372
18775,476,$IVPR4,2016-03-31,143057124,286114248,429171372
18775,476,$IVPR4,2016-06-30,143057124,286114248,429171372
18775,476,$IVPR4,2016-09-30,143057124,286114248,429171372
18775,476,$IVPR4,2016-12-31,143057124,286114248,429171372
18775,476,$IVPR4,2017-03-31,143057124,286114248,429171372
18775,476,$IVPR4,2017-06-30,143057124,286114248,429171372
18775,476,$IVPR4,2017-09-30,143057124,286114248,429171372
18775,476,$IVPR4,2017-12-31,143057124,286114248,429171372
18775,476,$IVPR4,2018-03-31,143057124,286114248,429171372
18775,476,$IVPR4,2018-06-30,143057124,286114248,429171372
18775,476,$IVPR4,2018-09-30,143057124,286114248,429171372
18775,476,$IVPR4,2018-12-31,143057124,286114248,429171372
18775,476,$IVPR4,2019-03-31,143057124,286114248,429171372
18775,476,$IVPR4,2019-06-30,143057124,286114248,429171372
18775,476,$IVPR4,2019-09-30,143057124,286114248,429171372
18775,476,$IVPR4,2019-12-31,143057124,286114248,429171372
18775,476,$IVPR4,2020-03-31,143057124,286114248,429171372
18775,476,$IVPR4,2020-06-30,143057124,286114248,429171372
18775,476,$IVPR4,2020-09-30,143057124,286114248,429171372
18821,320,$CCRO3,2010-12-31,441396800,0,441396800
18821,320,$CCRO3,2011-03-31,441396800,0,441396800
18821,320,$CCRO3,2011-06-30,441396800,0,441396800
18821,320,$CCRO3,2011-09-30,441396800,0,441396800
18821,320,$CCRO3,2011-12-31,1765587200,0,1765587200
18821,320,$CCRO3,2012-03-31,1765587200,0,1765587200
18821,320,$CCRO3,2012-06-30,1765587200,0,1765587200
18821,320,$CCRO3,2012-09-30,1765587200,0,1765587200
18821,320,$CCRO3,2012-12-31,1765587200,0,1765587200
18821,320,$CCRO3,2013-03-31,1765587200,0,1765587200
18821,320,$CCRO3,2013-06-30,1765587200,0,1765587200
18821,320,$CCRO3,2013-09-30,1765587200,0,1765587200
18821,320,$CCRO3,2013-12-31,1765587200,0,1765587200
18821,320,$CCRO3,2014-03-31,1765587200,0,1765587200
18821,320,$CCRO3,2014-06-30,1765587200,0,1765587200
18821,320,$CCRO3,2014-09-30,1765587200,0,1765587200
18821,320,$CCRO3,2014-12-31,1765587200,0,1765587200
18821,320,$CCRO3,2015-03-31,1765587200,0,1765587200
18821,320,$CCRO3,2015-06-30,1765587200,0,1765587200
18821,320,$CCRO3,2015-09-30,1765587200,0,1765587200
18821,320,$CCRO3,2015-12-31,1765587200,0,1765587200
18821,320,$CCRO3,2016-03-31,1765587200,0,1765587200
18821,320,$CCRO3,2016-06-30,1765587200,0,1765587200
18821,320,$CCRO3,2016-09-30,1765587200,0,1765587200
18821,320,$CCRO3,2016-12-31,1765587200,0,1765587200
18821,320,$CCRO3,2017-03-31,2020000000,0,2020000000
18821,320,$CCRO3,2017-06-30,2020000000,0,2020000000
18821,320,$CCRO3,2017-09-30,2020000000,0,2020000000
18821,320,$CCRO3,2017-12-31,2020000000,0,2020000000
18821,320,$CCRO3,2018-03-31,2020000000,0,2020000000
18821,320,$CCRO3,2018-06-30,2020000000,0,2020000000
18821,320,$CCRO3,2018-09-30,2020000000,0,2020000000
18821,320,$CCRO3,2018-12-31,2020000000,0,2020000000
18821,320,$CCRO3,2019-03-31,2020000000,0,2020000000
18821,320,$CCRO3,2019-06-30,2020000000,0,2020000000
18821,320,$CCRO3,2019-09-30,2020000000,0,2020000000
18821,320,$CCRO3,2019-12-31,2020000000,0,2020000000
18821,320,$CCRO3,2020-03-31,2020000000,0,2020000000
18821,320,$CCRO3,2020-06-30,2020000000,0,2020000000
18821,320,$CCRO3,2020-09-30,2020000000,0,2020000000
18970,477,$TIET11,2010-12-31,600000001,50000007,650000008
18970,477,$TIET11,2011-03-31,600000,50000,650000
18970,477,$TIET11,2011-06-30,600000,50000,650000
18970,477,$TIET11,2011-09-30,600000,50000,650000
18970,477,$TIET11,2011-12-31,600000,50000,650000
18970,477,$TIET11,2012-03-31,600000,50000,650000
18970,477,$TIET11,2012-06-30,600000,50000,650000
18970,477,$TIET11,2012-09-30,600000,50000,650000
18970,477,$TIET11,2012-12-31,600000,50000,650000
18970,477,$TIET11,2013-03-31,600000,50000,650000
18970,477,$TIET11,2013-06-30,600000,50000,650000
18970,477,$TIET11,2013-09-30,300000,350000,650000
18970,477,$TIET11,2013-12-31,600000,50000,650000
18970,477,$TIET11,2014-03-31,600000,50000,650000
18970,477,$TIET11,2014-06-30,600000,50000,650000
18970,477,$TIET11,2014-09-30,600000,50000,650000
18970,477,$TIET11,2014-12-31,600000,50000,650000
18970,477,$TIET11,2015-03-31,600000,50000,650000
18970,477,$TIET11,2015-06-30,600000,50000,650000
18970,477,$TIET11,2015-09-30,600000,50000,650000
18970,477,$TIET11,2015-12-31,751094,1155174,1906268
18970,477,$TIET11,2016-03-31,751094,1155174,1906268
18970,477,$TIET11,2016-06-30,751094,1155174,1906268
18970,477,$TIET11,2016-09-30,775175,1192210,1967385
18970,477,$TIET11,2016-12-31,775175,1192210,1967385
18970,477,$TIET11,2017-03-31,775175,1192210,1967385
18970,477,$TIET11,2017-06-30,775175,1192210,1967385
18970,477,$TIET11,2017-09-30,775144,1192089,1967233
18970,477,$TIET11,2017-12-31,775155,1192131,1967286
18970,477,$TIET11,2018-03-31,775175,1192210,1967385
18970,477,$TIET11,2018-06-30,775175,1192210,1967385
18970,477,$TIET11,2018-09-30,775175,1192210,1967385
18970,477,$TIET11,2018-12-31,775175,1192210,1967385
18970,477,$TIET11,2019-03-31,775175,1192210,1967385
18970,477,$TIET11,2019-06-30,775175,1192210,1967385
18970,477,$TIET11,2019-09-30,786265,1209267,1995532
18970,477,$TIET11,2019-12-31,786265,1209267,1995532
18970,477,$TIET11,2020-03-31,786265,1209267,1995532
18970,477,$TIET11,2020-06-30,786265,1209267,1995532
18970,477,$TIET11,2020-09-30,786265,1209267,1995532
19100,325,$LIQO3,2010-12-31,23089600,36681000,59770600
19100,325,$LIQO3,2011-03-31,23089600,36681000,59770600
19100,325,$LIQO3,2011-06-30,23089600,36681000,59770600
19100,325,$LIQO3,2011-09-30,24966582,39719499,64686081
19100,325,$LIQO3,2011-12-31,24966582,39719499,64686081
19100,325,$LIQO3,2012-03-31,24966582,39719499,64686081
19100,325,$LIQO3,2012-06-30,24966582,39719499,64686081
19100,325,$LIQO3,2012-09-30,24966582,39719499,64686081
19100,325,$LIQO3,2012-12-31,24966582,39719499,64686081
19100,325,$LIQO3,2013-03-31,24966582,39719499,64686081
19100,325,$LIQO3,2013-06-30,119957883,225809987,345767870
19100,325,$LIQO3,2013-09-30,119957883,225809987,345767870
19100,325,$LIQO3,2013-12-31,119725707,226042163,345767870
19100,325,$LIQO3,2014-03-31,119725707,226042163,345767870
19100,325,$LIQO3,2014-06-30,119725707,226042163,345767870
19100,325,$LIQO3,2014-09-30,119725707,226042163,345767870
19100,325,$LIQO3,2014-12-31,119725707,226042163,345767870
19100,325,$LIQO3,2015-03-31,119725707,226042163,345767870
19100,325,$LIQO3,2015-06-30,119725707,226042163,345767870
19100,325,$LIQO3,2015-09-30,118357576,220569639,338927215
19100,325,$LIQO3,2015-12-31,119725707,226042163,345767870
19100,325,$LIQO3,2016-03-31,119725707,226042163,345767870
19100,325,$LIQO3,2016-06-30,3457678,0,3457678
19100,325,$LIQO3,2016-09-30,3457678,0,3457678
19100,325,$LIQO3,2016-12-31,4185596,0,4185596
19100,325,$LIQO3,2017-03-31,4185596,0,4185596
19100,325,$LIQO3,2017-06-30,4185596,0,4185596
19100,325,$LIQO3,2017-09-30,4185596,0,4185596
19100,325,$LIQO3,2017-12-31,4185596,0,4185596
19100,325,$LIQO3,2018-03-31,4185596,0,4185596
19100,325,$LIQO3,2018-06-30,7457603,0,7457603
19100,325,$LIQO3,2018-09-30,11009412,0,11009412
19100,325,$LIQO3,2018-12-31,15727661,0,15727661
19100,325,$LIQO3,2019-03-31,21967447,0,21967447
19100,325,$LIQO3,2019-06-30,83954451,0,83954451
19100,325,$LIQO3,2019-09-30,2798048,0,2798048
19100,325,$LIQO3,2019-12-31,2812644,0,2812644
19100,325,$LIQO3,2020-03-31,23458943,0,23458943
19100,325,$LIQO3,2020-06-30,23458943,0,23458943
19100,325,$LIQO3,2020-09-30,23458943,0,23458943
19100,326,$ATMP3,2010-12-31,23089600,36681000,59770600
19100,326,$ATMP3,2011-03-31,23089600,36681000,59770600
19100,326,$ATMP3,2011-06-30,23089600,36681000,59770600
19100,326,$ATMP3,2011-09-30,24966582,39719499,64686081
19100,326,$ATMP3,2011-12-31,24966582,39719499,64686081
19100,326,$ATMP3,2012-03-31,24966582,39719499,64686081
19100,326,$ATMP3,2012-06-30,24966582,39719499,64686081
19100,326,$ATMP3,2012-09-30,24966582,39719499,64686081
19100,326,$ATMP3,2012-12-31,24966582,39719499,64686081
19100,326,$ATMP3,2013-03-31,24966582,39719499,64686081
19100,326,$ATMP3,2013-06-30,119957883,225809987,345767870
19100,326,$ATMP3,2013-09-30,119957883,225809987,345767870
19100,326,$ATMP3,2013-12-31,119725707,226042163,345767870
19100,326,$ATMP3,2014-03-31,119725707,226042163,345767870
19100,326,$ATMP3,2014-06-30,119725707,226042163,345767870
19100,326,$ATMP3,2014-09-30,119725707,226042163,345767870
19100,326,$ATMP3,2014-12-31,119725707,226042163,345767870
19100,326,$ATMP3,2015-03-31,119725707,226042163,345767870
19100,326,$ATMP3,2015-06-30,119725707,226042163,345767870
19100,326,$ATMP3,2015-09-30,118357576,220569639,338927215
19100,326,$ATMP3,2015-12-31,119725707,226042163,345767870
19100,326,$ATMP3,2016-03-31,119725707,226042163,345767870
19100,326,$ATMP3,2016-06-30,3457678,0,3457678
19100,326,$ATMP3,2016-09-30,3457678,0,3457678
19100,326,$ATMP3,2016-12-31,4185596,0,4185596
19100,326,$ATMP3,2017-03-31,4185596,0,4185596
19100,326,$ATMP3,2017-06-30,4185596,0,4185596
19100,326,$ATMP3,2017-09-30,4185596,0,4185596
19100,326,$ATMP3,2017-12-31,4185596,0,4185596
19100,326,$ATMP3,2018-03-31,4185596,0,4185596
19100,326,$ATMP3,2018-06-30,7457603,0,7457603
19100,326,$ATMP3,2018-09-30,11009412,0,11009412
19100,326,$ATMP3,2018-12-31,15727661,0,15727661
19100,326,$ATMP3,2019-03-31,21967447,0,21967447
19100,326,$ATMP3,2019-06-30,83954451,0,83954451
19100,326,$ATMP3,2019-09-30,2798048,0,2798048
19100,326,$ATMP3,2019-12-31,2812644,0,2812644
19100,326,$ATMP3,2020-03-31,23458943,0,23458943
19100,326,$ATMP3,2020-06-30,23458943,0,23458943
19100,326,$ATMP3,2020-09-30,23458943,0,23458943
19232,478,$PRMN3B,2010-12-31,100,0,100
19232,478,$PRMN3B,2011-03-31,100,0,100
19232,478,$PRMN3B,2011-06-30,100,0,100
19232,478,$PRMN3B,2011-09-30,100,0,100
19232,478,$PRMN3B,2011-12-31,100000,0,100000
19232,478,$PRMN3B,2012-03-31,100,0,100
19232,478,$PRMN3B,2012-06-30,100,0,100
19232,478,$PRMN3B,2012-09-30,100,0,100
19232,478,$PRMN3B,2012-12-31,100,0,100
19232,478,$PRMN3B,2013-03-31,100,0,100
19232,478,$PRMN3B,2013-06-30,100,0,100
19232,478,$PRMN3B,2013-09-30,100,0,100
19232,478,$PRMN3B,2013-12-31,100000,0,100000
19232,478,$PRMN3B,2014-03-31,100,0,100
19232,478,$PRMN3B,2014-06-30,100,0,100
19232,478,$PRMN3B,2014-09-30,100,0,100
19232,478,$PRMN3B,2014-12-31,100000,0,100000
19232,478,$PRMN3B,2015-03-31,100,0,100
19232,478,$PRMN3B,2015-06-30,100000,0,100000
19232,478,$PRMN3B,2015-09-30,100000,0,100000
19232,478,$PRMN3B,2015-12-31,100,0,100
19232,478,$PRMN3B,2016-03-31,100000,0,100000
19232,478,$PRMN3B,2016-06-30,100000,0,100000
19232,478,$PRMN3B,2016-09-30,100,0,100
19232,478,$PRMN3B,2016-12-31,100,0,100
19232,478,$PRMN3B,2017-03-31,100,0,100
19232,478,$PRMN3B,2017-06-30,100,0,100
19232,478,$PRMN3B,2017-09-30,100,0,100
19232,478,$PRMN3B,2017-12-31,100,0,100
19232,478,$PRMN3B,2018-03-31,100,0,100
19232,478,$PRMN3B,2018-06-30,100,0,100
19232,478,$PRMN3B,2018-09-30,100,0,100
19232,478,$PRMN3B,2018-12-31,100,0,100
19232,478,$PRMN3B,2019-03-31,100,0,100
19232,478,$PRMN3B,2019-06-30,100,0,100
19232,478,$PRMN3B,2019-09-30,100,0,100
19232,478,$PRMN3B,2019-12-31,100,0,100
19232,478,$PRMN3B,2020-03-31,100,0,100
19232,478,$PRMN3B,2020-06-30,100,0,100
19232,478,$PRMN3B,2020-09-30,100,0,100
19305,318,$BIOM3,2010-12-31,7543,9795,17338
19305,318,$BIOM3,2011-03-31,7543248,9795585,17338833
19305,318,$BIOM3,2011-06-30,7543248,9795585,17338833
19305,318,$BIOM3,2011-09-30,7543248,9795585,17338833
19305,318,$BIOM3,2011-12-31,7543248,9795585,17338833
19305,318,$BIOM3,2012-03-31,7543248,9795585,17338833
19305,318,$BIOM3,2012-06-30,7543,9796,17339
19305,318,$BIOM3,2012-09-30,7543,9796,17339
19305,318,$BIOM3,2012-12-31,7543,9796,17339
19305,318,$BIOM3,2013-03-31,7543,9796,17339
19305,318,$BIOM3,2013-06-30,7543,9796,17339
19305,318,$BIOM3,2013-09-30,17339,0,17339
19305,318,$BIOM3,2013-12-31,29890,0,29890
19305,318,$BIOM3,2014-03-31,30827,0,30827
19305,318,$BIOM3,2014-06-30,30827,0,30827
19305,318,$BIOM3,2014-09-30,30827,0,30827
19305,318,$BIOM3,2014-12-31,30827,0,30827
19305,318,$BIOM3,2015-03-31,30827,0,30827
19305,318,$BIOM3,2015-06-30,30827,0,30827
19305,318,$BIOM3,2015-09-30,30827,0,30827
19305,318,$BIOM3,2015-12-31,30827,0,30827
19305,318,$BIOM3,2016-03-31,30827,0,30827
19305,318,$BIOM3,2016-06-30,30827,0,30827
19305,318,$BIOM3,2016-09-30,30827,0,30827
19305,318,$BIOM3,2016-12-31,30827,0,30827
19305,318,$BIOM3,2017-03-31,30827,0,30827
19305,318,$BIOM3,2017-06-30,35309,0,35309
19305,318,$BIOM3,2017-09-30,35309,0,35309
19305,318,$BIOM3,2017-12-31,35309,0,35309
19305,318,$BIOM3,2018-03-31,35309,0,35309
19305,318,$BIOM3,2018-06-30,47782714,0,47782714
19305,318,$BIOM3,2018-09-30,47782714,0,47782714
19305,318,$BIOM3,2018-12-31,47782714,0,47782714
19305,318,$BIOM3,2019-03-31,47782714,0,47782714
19305,318,$BIOM3,2019-06-30,47840092,0,47840092
19305,318,$BIOM3,2019-09-30,47840092,0,47840092
19305,318,$BIOM3,2019-12-31,60759988,0,60759988
19305,318,$BIOM3,2020-03-31,60759988,0,60759988
19305,318,$BIOM3,2020-06-30,60791774,0,60791774
19305,318,$BIOM3,2020-09-30,60791774,0,60791774
19330,321,$TPIS3,2010-12-31,146000,0,146000
19330,321,$TPIS3,2011-03-31,146000,0,146000
19330,321,$TPIS3,2011-06-30,146000,0,146000
19330,321,$TPIS3,2011-09-30,146000,0,146000
19330,321,$TPIS3,2011-12-31,146000,0,146000
19330,321,$TPIS3,2012-03-31,146000,0,146000
19330,321,$TPIS3,2012-06-30,146000,0,146000
19330,321,$TPIS3,2012-09-30,146000,0,146000
19330,321,$TPIS3,2012-12-31,146000,0,146000
19330,321,$TPIS3,2013-03-31,146000,0,146000
19330,321,$TPIS3,2013-06-30,146000,0,146000
19330,321,$TPIS3,2013-09-30,176000,0,176000
19330,321,$TPIS3,2013-12-31,176000,0,176000
19330,321,$TPIS3,2014-03-31,176000,0,176000
19330,321,$TPIS3,2014-06-30,176000,0,176000
19330,321,$TPIS3,2014-09-30,176000,0,176000
19330,321,$TPIS3,2014-12-31,176000,0,176000
19330,321,$TPIS3,2015-03-31,176000,0,176000
19330,321,$TPIS3,2015-06-30,176000,0,176000
19330,321,$TPIS3,2015-09-30,176000,0,176000
19330,321,$TPIS3,2015-12-31,176000,0,176000
19330,321,$TPIS3,2016-03-31,176000,0,176000
19330,321,$TPIS3,2016-06-30,176000,0,176000
19330,321,$TPIS3,2016-09-30,176000,0,176000
19330,321,$TPIS3,2016-12-31,176000,0,176000
19330,321,$TPIS3,2017-03-31,176000,0,176000
19330,321,$TPIS3,2017-06-30,176000,0,176000
19330,321,$TPIS3,2017-09-30,176000,0,176000
19330,321,$TPIS3,2017-12-31,176000,0,176000
19330,321,$TPIS3,2018-03-31,176000,0,176000
19330,321,$TPIS3,2018-06-30,176000,0,176000
19330,321,$TPIS3,2018-09-30,176000,0,176000
19330,321,$TPIS3,2018-12-31,176000,0,176000
19330,321,$TPIS3,2019-03-31,176000,0,176000
19330,321,$TPIS3,2019-06-30,176000,0,176000
19330,321,$TPIS3,2019-09-30,176000,0,176000
19330,321,$TPIS3,2019-12-31,176000,0,176000
19330,321,$TPIS3,2020-03-31,176000,0,176000
19330,321,$TPIS3,2020-06-30,176000,0,176000
19330,321,$TPIS3,2020-09-30,176000,0,176000
19348,322,$ITUB3,2010-12-31,2289286,2281650,4570936
19348,322,$ITUB3,2011-03-31,2289286,2281650,4570936
19348,322,$ITUB3,2011-06-30,2289286,2281650,4570936
19348,322,$ITUB3,2011-06-30,2289286,2281650,4570936
19348,322,$ITUB3,2011-09-30,2289286,2281650,4570936
19348,322,$ITUB3,2011-12-31,2289286,2281650,4570936
19348,322,$ITUB3,2011-12-31,2289286,2281650,4570936
19348,322,$ITUB3,2012-03-31,2289286,2281650,4570936
19348,322,$ITUB3,2012-06-30,2289286,2281650,4570936
19348,322,$ITUB3,2012-09-30,2289286,2281650,4570936
19348,322,$ITUB3,2012-12-31,2289286,2281650,4570936
19348,322,$ITUB3,2013-03-31,2289286,2281650,4570936
19348,322,$ITUB3,2013-06-30,2518215,2509815,5028030
19348,322,$ITUB3,2013-09-30,2518215,2509815,5028030
19348,322,$ITUB3,2013-12-31,2518215,2509815,5028030
19348,322,$ITUB3,2013-12-31,2518215,2509815,5028030
19348,322,$ITUB3,2014-03-31,2518215,2509815,5028030
19348,322,$ITUB3,2014-06-30,2770037,2760796,5530833
19348,322,$ITUB3,2014-09-30,2770037,2760796,5530833
19348,322,$ITUB3,2014-12-31,2770037,2760796,5530833
19348,322,$ITUB3,2015-03-31,2770037,2760796,5530833
19348,322,$ITUB3,2015-06-30,3047040,3036876,6083916
19348,322,$ITUB3,2015-09-30,3047040,3036875,6083915
19348,322,$ITUB3,2015-12-31,3047040,3036876,6083916
19348,322,$ITUB3,2016-03-31,3047040,3036875,6083915
19348,322,$ITUB3,2016-06-30,3047040,2936876,5983916
19348,322,$ITUB3,2016-06-30,3047040,2936876,5983916
19348,322,$ITUB3,2016-09-30,3047040,2936876,5983916
19348,322,$ITUB3,2016-12-31,3351744,3230563,6582307
19348,322,$ITUB3,2017-03-31,3351744,3230563,6582307
19348,322,$ITUB3,2017-06-30,3351744,3230563,6582307
19348,322,$ITUB3,2017-06-30,3351744,3230563,6582307
19348,322,$ITUB3,2017-09-30,3351744,3230563,6582307
19348,322,$ITUB3,2017-12-31,3319951,3230563,6550514
19348,322,$ITUB3,2018-03-31,3305527,3230563,6536090
19348,322,$ITUB3,2018-06-30,3305527,3230563,6536090
19348,322,$ITUB3,2018-09-30,3305527,3230563,6536090
19348,322,$ITUB3,2018-12-31,4958290,4845845,9804135
19348,322,$ITUB3,2018-12-31,4958290,4845845,9804135
19348,322,$ITUB3,2019-03-31,4958290,4845845,9804135
19348,322,$ITUB3,2019-06-30,4958290,4845845,9804135
19348,322,$ITUB3,2019-06-30,4958290,4845845,9804135
19348,322,$ITUB3,2019-09-30,4958290,4845845,9804135
19348,322,$ITUB3,2019-12-31,4958290,4845845,9804135
19348,322,$ITUB3,2020-03-31,4958290,4845845,9804135
19348,322,$ITUB3,2020-06-30,4958290,4845845,9804135
19348,322,$ITUB3,2020-09-30,4958290,4845845,9804135
19348,323,$ITUB4,2010-12-31,2289286,2281650,4570936
19348,323,$ITUB4,2011-03-31,2289286,2281650,4570936
19348,323,$ITUB4,2011-06-30,2289286,2281650,4570936
19348,323,$ITUB4,2011-06-30,2289286,2281650,4570936
19348,323,$ITUB4,2011-09-30,2289286,2281650,4570936
19348,323,$ITUB4,2011-12-31,2289286,2281650,4570936
19348,323,$ITUB4,2011-12-31,2289286,2281650,4570936
19348,323,$ITUB4,2012-03-31,2289286,2281650,4570936
19348,323,$ITUB4,2012-06-30,2289286,2281650,4570936
19348,323,$ITUB4,2012-09-30,2289286,2281650,4570936
19348,323,$ITUB4,2012-12-31,2289286,2281650,4570936
19348,323,$ITUB4,2013-03-31,2289286,2281650,4570936
19348,323,$ITUB4,2013-06-30,2518215,2509815,5028030
19348,323,$ITUB4,2013-09-30,2518215,2509815,5028030
19348,323,$ITUB4,2013-12-31,2518215,2509815,5028030
19348,323,$ITUB4,2013-12-31,2518215,2509815,5028030
19348,323,$ITUB4,2014-03-31,2518215,2509815,5028030
19348,323,$ITUB4,2014-06-30,2770037,2760796,5530833
19348,323,$ITUB4,2014-09-30,2770037,2760796,5530833
19348,323,$ITUB4,2014-12-31,2770037,2760796,5530833
19348,323,$ITUB4,2015-03-31,2770037,2760796,5530833
19348,323,$ITUB4,2015-06-30,3047040,3036876,6083916
19348,323,$ITUB4,2015-09-30,3047040,3036875,6083915
19348,323,$ITUB4,2015-12-31,3047040,3036876,6083916
19348,323,$ITUB4,2016-03-31,3047040,3036875,6083915
19348,323,$ITUB4,2016-06-30,3047040,2936876,5983916
19348,323,$ITUB4,2016-06-30,3047040,2936876,5983916
19348,323,$ITUB4,2016-09-30,3047040,2936876,5983916
19348,323,$ITUB4,2016-12-31,3351744,3230563,6582307
19348,323,$ITUB4,2017-03-31,3351744,3230563,6582307
19348,323,$ITUB4,2017-06-30,3351744,3230563,6582307
19348,323,$ITUB4,2017-06-30,3351744,3230563,6582307
19348,323,$ITUB4,2017-09-30,3351744,3230563,6582307
19348,323,$ITUB4,2017-12-31,3319951,3230563,6550514
19348,323,$ITUB4,2018-03-31,3305527,3230563,6536090
19348,323,$ITUB4,2018-06-30,3305527,3230563,6536090
19348,323,$ITUB4,2018-09-30,3305527,3230563,6536090
19348,323,$ITUB4,2018-12-31,4958290,4845845,9804135
19348,323,$ITUB4,2018-12-31,4958290,4845845,9804135
19348,323,$ITUB4,2019-03-31,4958290,4845845,9804135
19348,323,$ITUB4,2019-06-30,4958290,4845845,9804135
19348,323,$ITUB4,2019-06-30,4958290,4845845,9804135
19348,323,$ITUB4,2019-09-30,4958290,4845845,9804135
19348,323,$ITUB4,2019-12-31,4958290,4845845,9804135
19348,323,$ITUB4,2020-03-31,4958290,4845845,9804135
19348,323,$ITUB4,2020-06-30,4958290,4845845,9804135
19348,323,$ITUB4,2020-09-30,4958290,4845845,9804135
19445,328,$CSMG3,2010-12-31,115299,0,115299
19445,328,$CSMG3,2011-03-31,115299,0,115299
19445,328,$CSMG3,2011-06-30,115299,0,115299
19445,328,$CSMG3,2011-09-30,115299,0,115299
19445,328,$CSMG3,2011-12-31,114931,0,114931
19445,328,$CSMG3,2012-03-31,114931,0,114931
19445,328,$CSMG3,2012-06-30,119314,0,119314
19445,328,$CSMG3,2012-09-30,119327,0,119327
19445,328,$CSMG3,2012-12-31,119684,0,119684
19445,328,$CSMG3,2013-03-31,119327,0,119327
19445,328,$CSMG3,2013-06-30,119327,0,119327
19445,328,$CSMG3,2013-09-30,119327,0,119327
19445,328,$CSMG3,2013-12-31,119684,0,119684
19445,328,$CSMG3,2014-03-31,119327,0,119327
19445,328,$CSMG3,2014-06-30,119327,0,119327
19445,328,$CSMG3,2014-09-30,119327,0,119327
19445,328,$CSMG3,2014-12-31,119684,0,119684
19445,328,$CSMG3,2015-03-31,119684,0,119684
19445,328,$CSMG3,2015-06-30,119684,0,119684
19445,328,$CSMG3,2015-09-30,119684,0,119684
19445,328,$CSMG3,2015-12-31,119684,0,119684
19445,328,$CSMG3,2016-03-31,119684,0,119684
19445,328,$CSMG3,2016-06-30,119684,0,119684
19445,328,$CSMG3,2016-09-30,126751,0,126751
19445,328,$CSMG3,2016-12-31,126394,0,126394
19445,328,$CSMG3,2017-03-31,126751,0,126751
19445,328,$CSMG3,2017-06-30,126751,0,126751
19445,328,$CSMG3,2017-09-30,126751,0,126751
19445,328,$CSMG3,2017-12-31,126751,0,126751
19445,328,$CSMG3,2018-03-31,126751,0,126751
19445,328,$CSMG3,2018-06-30,126751,0,126751
19445,328,$CSMG3,2018-09-30,126751,0,126751
19445,328,$CSMG3,2018-12-31,126751,0,126751
19445,328,$CSMG3,2019-03-31,126751,0,126751
19445,328,$CSMG3,2019-06-30,126751,0,126751
19445,328,$CSMG3,2019-09-30,126751,0,126751
19445,328,$CSMG3,2019-12-31,126751,0,126751
19445,328,$CSMG3,2020-03-31,126751,0,126751
19445,328,$CSMG3,2020-06-30,126751,0,126751
19445,328,$CSMG3,2020-09-30,126751,0,126751
19453,324,$ECOR3,2010-12-31,558699,0,558699
19453,324,$ECOR3,2011-03-31,558699,0,558699
19453,324,$ECOR3,2011-06-30,558699,0,558699
19453,324,$ECOR3,2011-09-30,558699,0,558699
19453,324,$ECOR3,2011-12-31,558699,0,558699
19453,324,$ECOR3,2012-03-31,558699,0,558699
19453,324,$ECOR3,2012-06-30,558699,0,558699
19453,324,$ECOR3,2012-09-30,558699,0,558699
19453,324,$ECOR3,2012-12-31,558699,0,558699
19453,324,$ECOR3,2013-03-31,558699,0,558699
19453,324,$ECOR3,2013-06-30,558699,0,558699
19453,324,$ECOR3,2013-09-30,558699,0,558699
19453,324,$ECOR3,2013-12-31,558699,0,558699
19453,324,$ECOR3,2014-03-31,558699,0,558699
19453,324,$ECOR3,2014-06-30,558699,0,558699
19453,324,$ECOR3,2014-09-30,558699,0,558699
19453,324,$ECOR3,2014-12-31,558699,0,558699
19453,324,$ECOR3,2015-03-31,558699,0,558699
19453,324,$ECOR3,2015-06-30,558699,0,558699
19453,324,$ECOR3,2015-09-30,558699,0,558699
19453,324,$ECOR3,2015-12-31,558699,0,558699
19453,324,$ECOR3,2016-03-31,558699,0,558699
19453,324,$ECOR3,2016-06-30,558699,0,558699
19453,324,$ECOR3,2016-09-30,558699,0,558699
19453,324,$ECOR3,2016-12-31,558699,0,558699
19453,324,$ECOR3,2017-03-31,558699,0,558699
19453,324,$ECOR3,2017-06-30,558699,0,558699
19453,324,$ECOR3,2017-09-30,558699,0,558699
19453,324,$ECOR3,2017-12-31,558699,0,558699
19453,324,$ECOR3,2018-03-31,558699,0,558699
19453,324,$ECOR3,2018-06-30,558699,0,558699
19453,324,$ECOR3,2018-09-30,558699,0,558699
19453,324,$ECOR3,2018-12-31,558699,0,558699
19453,324,$ECOR3,2019-03-31,558699,0,558699
19453,324,$ECOR3,2019-06-30,558699,0,558699
19453,324,$ECOR3,2019-09-30,558699,0,558699
19453,324,$ECOR3,2019-12-31,558699,0,558699
19453,324,$ECOR3,2020-03-31,558699,0,558699
19453,324,$ECOR3,2020-06-30,558699,0,558699
19453,324,$ECOR3,2020-09-30,558699,0,558699
19550,329,$NATU3,2010-12-31,430881,0,430881
19550,329,$NATU3,2011-03-31,431035,0,431035
19550,329,$NATU3,2011-06-30,431235,0,431235
19550,329,$NATU3,2011-09-30,431239,0,431239
19550,329,$NATU3,2011-12-31,431239,0,431239
19550,329,$NATU3,2012-03-31,431239,0,431239
19550,329,$NATU3,2012-06-30,431239,0,431239
19550,329,$NATU3,2012-09-30,431239,0,431239
19550,329,$NATU3,2012-12-31,431239,0,431239
19550,329,$NATU3,2013-03-31,431239,0,431239
19550,329,$NATU3,2013-06-30,431239,0,431239
19550,329,$NATU3,2013-09-30,431239,0,431239
19550,329,$NATU3,2013-12-31,431239,0,431239
19550,329,$NATU3,2014-03-31,431239,0,431239
19550,329,$NATU3,2014-06-30,431239,0,431239
19550,329,$NATU3,2014-09-30,431239,0,431239
19550,329,$NATU3,2014-12-31,431239,0,431239
19550,329,$NATU3,2015-03-31,431239,0,431239
19550,329,$NATU3,2015-06-30,431239,0,431239
19550,329,$NATU3,2015-09-30,431239,0,431239
19550,329,$NATU3,2015-12-31,431239,0,431239
19550,329,$NATU3,2016-03-31,431239,0,431239
19550,329,$NATU3,2016-06-30,431239,0,431239
19550,329,$NATU3,2016-09-30,431239,0,431239
19550,329,$NATU3,2016-12-31,431239,0,431239
19550,329,$NATU3,2017-03-31,431239,0,431239
19550,329,$NATU3,2017-06-30,431239,0,431239
19550,329,$NATU3,2017-09-30,431239,0,431239
19550,329,$NATU3,2017-12-31,431239,0,431239
19550,329,$NATU3,2018-03-31,431239,0,431239
19550,329,$NATU3,2018-06-30,431239,0,431239
19550,329,$NATU3,2018-09-30,431239,0,431239
19550,329,$NATU3,2018-12-31,431239,0,431239
19550,329,$NATU3,2019-03-31,431324,0,431324
19550,329,$NATU3,2019-06-30,431964,0,431964
19550,329,$NATU3,2019-09-30,865795,0,865795
19550,329,$NATU3,2019-12-31,865660,0,865660
19550,329,$NATU3,2020-03-31,865660,0,865660
19550,329,$NATU3,2020-06-30,865660,0,865660
19550,329,$NATU3,2020-09-30,920205,0,920205
19569,334,$GOLL4,2010-12-31,137033,133304,270337
19569,334,$GOLL4,2011-03-31,137032734,133338652,270371386
19569,334,$GOLL4,2011-06-30,137032734,133354132,270386866
19569,334,$GOLL4,2011-09-30,137032734,133354132,270386866
19569,334,$GOLL4,2011-12-31,137032734,133357270,270390004
19569,334,$GOLL4,2012-03-31,137032734,133357270,270390004
19569,334,$GOLL4,2012-06-30,137032734,133357270,270390004
19569,334,$GOLL4,2012-09-30,143858204,134858582,278716786
19569,334,$GOLL4,2012-12-31,143858204,134858582,278716786
19569,334,$GOLL4,2013-03-31,143858204,135003122,278861326
19569,334,$GOLL4,2013-06-30,143858204,135003122,278861326
19569,334,$GOLL4,2013-09-30,143858204,135003122,278861326
19569,334,$GOLL4,2013-12-31,143858204,135003122,278861326
19569,334,$GOLL4,2014-03-31,143858204,135003122,278861326
19569,334,$GOLL4,2014-06-30,143858204,135009316,278867520
19569,334,$GOLL4,2014-09-30,143858204,139257602,283115806
19569,334,$GOLL4,2014-12-31,5035037140,139315357,5174352497
19569,334,$GOLL4,2015-03-31,5035037140,139318357,5174355497
19569,334,$GOLL4,2015-06-30,5035037140,139318357,5174355497
19569,334,$GOLL4,2015-09-30,5035037140,203383968,5238421108
19569,334,$GOLL4,2015-12-31,5035037140,203383968,5238421108
19569,334,$GOLL4,2016-03-31,5035037140,203383968,5238421108
19569,334,$GOLL4,2016-06-30,5035037140,203383968,5238421108
19569,334,$GOLL4,2016-09-30,5035037140,203383968,5238421108
19569,334,$GOLL4,2016-12-31,5035037140,203383968,5238421108
19569,334,$GOLL4,2017-03-31,5035037140,203383968,5238421108
19569,334,$GOLL4,2017-06-30,5035037140,203383968,5238421108
19569,334,$GOLL4,2017-09-30,5035037140,203628153,5238665293
19569,334,$GOLL4,2017-12-31,2863682710,265899432,3129582142
19569,334,$GOLL4,2018-03-31,2863682710,266060461,3129743171
19569,334,$GOLL4,2018-06-30,2863682710,266559135,3130241845
19569,334,$GOLL4,2018-09-30,2863682710,266890553,3130573263
19569,334,$GOLL4,2018-12-31,2863682710,267543740,3131226450
19569,334,$GOLL4,2019-03-31,2863682710,268065268,3131747978
19569,334,$GOLL4,2019-06-30,2863682710,268206164,3131888874
19569,334,$GOLL4,2019-09-30,2863682710,268290641,3131973351
19569,334,$GOLL4,2019-12-31,2863682710,273682014,3137364724
19569,334,$GOLL4,2020-03-31,2863682710,273682014,3137364724
19569,334,$GOLL4,2020-06-30,2863682710,273879123,3137561833
19569,334,$GOLL4,2020-09-30,2863682710,274043115,3137725825
19615,327,$GRND3,2010-12-31,300720000,0,300720000
19615,327,$GRND3,2011-03-31,300720,0,300720
19615,327,$GRND3,2011-06-30,300720,0,300720
19615,327,$GRND3,2011-09-30,300720,0,300720
19615,327,$GRND3,2011-12-31,300720,0,300720
19615,327,$GRND3,2012-03-31,300720,0,300720
19615,327,$GRND3,2012-06-30,300720,0,300720
19615,327,$GRND3,2012-09-30,300720,0,300720
19615,327,$GRND3,2012-12-31,300720,0,300720
19615,327,$GRND3,2013-03-31,300720,0,300720
19615,327,$GRND3,2013-06-30,300720,0,300720
19615,327,$GRND3,2013-09-30,300720,0,300720
19615,327,$GRND3,2013-12-31,300720,0,300720
19615,327,$GRND3,2014-03-31,300720,0,300720
19615,327,$GRND3,2014-06-30,300720,0,300720
19615,327,$GRND3,2014-09-30,300720,0,300720
19615,327,$GRND3,2014-12-31,300720,0,300720
19615,327,$GRND3,2015-03-31,300720,0,300720
19615,327,$GRND3,2015-06-30,300720,0,300720
19615,327,$GRND3,2015-09-30,300720,0,300720
19615,327,$GRND3,2015-12-31,300720,0,300720
19615,327,$GRND3,2016-03-31,300720,0,300720
19615,327,$GRND3,2016-06-30,300720,0,300720
19615,327,$GRND3,2016-09-30,300720,0,300720
19615,327,$GRND3,2016-12-31,300720,0,300720
19615,327,$GRND3,2017-03-31,300720,0,300720
19615,327,$GRND3,2017-06-30,300720,0,300720
19615,327,$GRND3,2017-09-30,300720,0,300720
19615,327,$GRND3,2017-12-31,300720,0,300720
19615,327,$GRND3,2018-03-31,300720,0,300720
19615,327,$GRND3,2018-06-30,902160,0,902160
19615,327,$GRND3,2018-09-30,902160,0,902160
19615,327,$GRND3,2018-12-31,902160,0,902160
19615,327,$GRND3,2019-03-31,902160,0,902160
19615,327,$GRND3,2019-06-30,902160,0,902160
19615,327,$GRND3,2019-09-30,902160,0,902160
19615,327,$GRND3,2019-12-31,902160,0,902160
19615,327,$GRND3,2020-03-31,902160,0,902160
19615,327,$GRND3,2020-06-30,902160,0,902160
19615,327,$GRND3,2020-09-30,902160,0,902160
19623,330,$DASA3,2010-12-31,229611740,0,229611740
19623,330,$DASA3,2011-03-31,311803015,0,311803015
19623,330,$DASA3,2011-06-30,311803015,0,311803015
19623,330,$DASA3,2011-09-30,311803015,0,311803015
19623,330,$DASA3,2011-12-31,311803015,0,311803015
19623,330,$DASA3,2012-03-31,311803015,0,311803015
19623,330,$DASA3,2012-06-30,311803015,0,311803015
19623,330,$DASA3,2012-09-30,311803015,0,311803015
19623,330,$DASA3,2012-12-31,311803015,0,311803015
19623,330,$DASA3,2013-03-31,311803015,0,311803015
19623,330,$DASA3,2013-06-30,311803015,0,311803015
19623,330,$DASA3,2013-09-30,311803015,0,311803015
19623,330,$DASA3,2013-12-31,311803015,0,311803015
19623,330,$DASA3,2014-03-31,311803015,0,311803015
19623,330,$DASA3,2014-06-30,311803015,0,311803015
19623,330,$DASA3,2014-09-30,311803015,0,311803015
19623,330,$DASA3,2014-12-31,311803015,0,311803015
19623,330,$DASA3,2015-03-31,311803015,0,311803015
19623,330,$DASA3,2015-06-30,311803015,0,311803015
19623,330,$DASA3,2015-09-30,310889283,0,310889283
19623,330,$DASA3,2015-12-31,310889283,0,310889283
19623,330,$DASA3,2016-03-31,310889283,0,310889283
19623,330,$DASA3,2016-06-30,310889283,0,310889283
19623,330,$DASA3,2016-09-30,310889283,0,310889283
19623,330,$DASA3,2016-12-31,310889283,0,310889283
19623,330,$DASA3,2017-03-31,310889283,0,310889283
19623,330,$DASA3,2017-06-30,310889283,0,310889283
19623,330,$DASA3,2017-09-30,311851140,0,311851140
19623,330,$DASA3,2017-12-31,311891942,0,311891942
19623,330,$DASA3,2018-03-31,311816941,0,311816941
19623,330,$DASA3,2018-06-30,311816941,0,311816941
19623,330,$DASA3,2018-09-30,311816941,0,311816941
19623,330,$DASA3,2018-12-31,311816941,0,311816941
19623,330,$DASA3,2019-03-31,311816941,0,311816941
19623,330,$DASA3,2019-06-30,314944846,0,314944846
19623,330,$DASA3,2019-09-30,314944846,0,314944846
19623,330,$DASA3,2019-12-31,314944846,0,314944846
19623,330,$DASA3,2020-03-31,480813758,0,480813758
19623,330,$DASA3,2020-06-30,480813758,0,480813758
19623,330,$DASA3,2020-09-30,480813758,0,480813758
19658,332,$FRTA3,2010-12-31,110000,0,110000
19658,332,$FRTA3,2011-03-31,110000,0,110000
19658,332,$FRTA3,2011-06-30,110000,0,110000
19658,332,$FRTA3,2011-09-30,110000,0,110000
19658,332,$FRTA3,2011-12-31,110000,0,110000
19658,332,$FRTA3,2012-03-31,150000,0,150000
19658,332,$FRTA3,2012-06-30,150000,0,150000
19658,332,$FRTA3,2012-09-30,150000,0,150000
19658,332,$FRTA3,2012-12-31,150000,0,150000
19658,332,$FRTA3,2013-03-31,150000,0,150000
19658,332,$FRTA3,2013-06-30,150000,0,150000
19658,332,$FRTA3,2013-09-30,150000,0,150000
19658,332,$FRTA3,2013-12-31,150000,0,150000
19658,332,$FRTA3,2014-03-31,150000,0,150000
19658,332,$FRTA3,2014-06-30,151875,0,151875
19658,332,$FRTA3,2014-09-30,151875,0,151875
19658,332,$FRTA3,2014-12-31,7593,0,7593
19658,332,$FRTA3,2015-03-31,7593,0,7593
19658,332,$FRTA3,2015-06-30,9094,0,9094
19658,332,$FRTA3,2015-09-30,9094,0,9094
19658,332,$FRTA3,2015-12-31,9094,0,9094
19658,332,$FRTA3,2016-03-31,9094,0,9094
19658,332,$FRTA3,2016-06-30,11942,0,11942
19658,332,$FRTA3,2016-09-30,11942,0,11942
19658,332,$FRTA3,2016-12-31,11942,0,11942
19658,332,$FRTA3,2017-03-31,11942,0,11942
19658,332,$FRTA3,2017-06-30,11942,0,11942
19658,332,$FRTA3,2017-09-30,11942,0,11942
19658,332,$FRTA3,2017-12-31,11942,0,11942
19658,332,$FRTA3,2018-03-31,12006636,0,12006636
19658,332,$FRTA3,2018-06-30,12006636,0,12006636
19658,332,$FRTA3,2018-09-30,12006636,0,12006636
19658,332,$FRTA3,2018-12-31,12006,0,12006
19658,332,$FRTA3,2019-03-31,12006636,0,12006636
19658,332,$FRTA3,2019-06-30,12006636,0,12006636
19658,332,$FRTA3,2019-09-30,2001106,0,2001106
19658,332,$FRTA3,2019-12-31,2001106,0,2001106
19658,332,$FRTA3,2020-03-31,2001106,0,2001106
19658,332,$FRTA3,2020-06-30,2001106,0,2001106
19658,332,$FRTA3,2020-09-30,2001106,0,2001106
19739,331,$RENT3,2010-12-31,201708,0,201708
19739,331,$RENT3,2011-03-31,201708,0,201708
19739,331,$RENT3,2011-06-30,201708,0,201708
19739,331,$RENT3,2011-09-30,201708,0,201708
19739,331,$RENT3,2011-12-31,201708,0,201708
19739,331,$RENT3,2012-03-31,201708,0,201708
19739,331,$RENT3,2012-06-30,201708,0,201708
19739,331,$RENT3,2012-09-30,201708,0,201708
19739,331,$RENT3,2012-12-31,201708,0,201708
19739,331,$RENT3,2013-03-31,201708,0,201708
19739,331,$RENT3,2013-06-30,211793,0,211793
19739,331,$RENT3,2013-09-30,211793,0,211793
19739,331,$RENT3,2013-12-31,211793,0,211793
19739,331,$RENT3,2014-03-31,211793,0,211793
19739,331,$RENT3,2014-06-30,211793,0,211793
19739,331,$RENT3,2014-09-30,211793,0,211793
19739,331,$RENT3,2014-12-31,211793,0,211793
19739,331,$RENT3,2015-03-31,211793,0,211793
19739,331,$RENT3,2015-06-30,211793,0,211793
19739,331,$RENT3,2015-09-30,211793,0,211793
19739,331,$RENT3,2015-12-31,211793,0,211793
19739,331,$RENT3,2016-03-31,211793,0,211793
19739,331,$RENT3,2016-06-30,211793,0,211793
19739,331,$RENT3,2016-09-30,211793,0,211793
19739,331,$RENT3,2016-12-31,211793,0,211793
19739,331,$RENT3,2017-03-31,211793,0,211793
19739,331,$RENT3,2017-06-30,222383,0,222383
19739,331,$RENT3,2017-09-30,222383,0,222383
19739,331,$RENT3,2017-12-31,667149,0,667149
19739,331,$RENT3,2018-03-31,667149,0,667149
19739,331,$RENT3,2018-06-30,667149,0,667149
19739,331,$RENT3,2018-09-30,667149,0,667149
19739,331,$RENT3,2018-12-31,667149,0,667149
19739,331,$RENT3,2019-03-31,722349,0,722349
19739,331,$RENT3,2019-06-30,722349,0,722349
19739,331,$RENT3,2019-09-30,722349,0,722349
19739,331,$RENT3,2019-12-31,758467,0,758467
19739,331,$RENT3,2020-03-31,758467,0,758467
19739,331,$RENT3,2020-06-30,758467,0,758467
19739,331,$RENT3,2020-09-30,758467,0,758467
19763,333,$ENBR3,2010-12-31,158805,0,158805
19763,333,$ENBR3,2011-03-31,158805,0,158805
19763,333,$ENBR3,2011-06-30,158805,0,158805
19763,333,$ENBR3,2011-09-30,158805,0,158805
19763,333,$ENBR3,2011-12-31,158805,0,158805
19763,333,$ENBR3,2012-03-31,476415,0,476415
19763,333,$ENBR3,2012-06-30,476415,0,476415
19763,333,$ENBR3,2012-09-30,476415,0,476415
19763,333,$ENBR3,2012-12-31,476415,0,476415
19763,333,$ENBR3,2013-03-31,476415,0,476415
19763,333,$ENBR3,2013-06-30,476415,0,476415
19763,333,$ENBR3,2013-09-30,476415,0,476415
19763,333,$ENBR3,2013-12-31,476415,0,476415
19763,333,$ENBR3,2014-03-31,476415,0,476415
19763,333,$ENBR3,2014-06-30,476415,0,476415
19763,333,$ENBR3,2014-09-30,476415,0,476415
19763,333,$ENBR3,2014-12-31,476415,0,476415
19763,333,$ENBR3,2015-03-31,476415,0,476415
19763,333,$ENBR3,2015-06-30,476415,0,476415
19763,333,$ENBR3,2015-09-30,476415,0,476415
19763,333,$ENBR3,2015-12-31,476415,0,476415
19763,333,$ENBR3,2016-03-31,476415,0,476415
19763,333,$ENBR3,2016-06-30,476415,0,476415
19763,333,$ENBR3,2016-09-30,606850,0,606850
19763,333,$ENBR3,2016-12-31,606850,0,606850
19763,333,$ENBR3,2017-03-31,606850,0,606850
19763,333,$ENBR3,2017-06-30,606850,0,606850
19763,333,$ENBR3,2017-09-30,606165,0,606165
19763,333,$ENBR3,2017-12-31,606165,0,606165
19763,333,$ENBR3,2018-03-31,606165,0,606165
19763,333,$ENBR3,2018-06-30,606248,0,606248
19763,333,$ENBR3,2018-09-30,606248,0,606248
19763,333,$ENBR3,2018-12-31,606248,0,606248
19763,333,$ENBR3,2019-03-31,606850,0,606850
19763,333,$ENBR3,2019-06-30,606850,0,606850
19763,333,$ENBR3,2019-09-30,606850,0,606850
19763,333,$ENBR3,2019-12-31,604806,0,604806
19763,333,$ENBR3,2020-03-31,604806,0,604806
19763,333,$ENBR3,2020-06-30,604877,0,604877
19763,333,$ENBR3,2020-09-30,606850,0,606850
19836,335,$CSAN3,2011-03-31,407214,0,407214
19836,335,$CSAN3,2011-06-30,407214,0,407214
19836,335,$CSAN3,2011-09-30,407214,0,407214
19836,335,$CSAN3,2011-12-31,407214,0,407214
19836,335,$CSAN3,2012-03-31,407214,0,407214
19836,335,$CSAN3,2012-06-30,407214,0,407214
19836,335,$CSAN3,2012-09-30,407214,0,407214
19836,335,$CSAN3,2012-12-31,407214353,0,407214353
19836,335,$CSAN3,2013-03-31,407214353,0,407214353
19836,335,$CSAN3,2013-06-30,407214353,0,407214353
19836,335,$CSAN3,2013-09-30,407214353,0,407214353
19836,335,$CSAN3,2013-12-31,407214353,0,407214353
19836,335,$CSAN3,2014-03-31,407214353,0,407214353
19836,335,$CSAN3,2014-06-30,407214353,0,407214353
19836,335,$CSAN3,2014-09-30,407214353,0,407214353
19836,335,$CSAN3,2014-12-31,407214353,0,407214353
19836,335,$CSAN3,2015-03-31,407214353,0,407214353
19836,335,$CSAN3,2015-06-30,407214353,0,407214353
19836,335,$CSAN3,2015-09-30,407214353,0,407214353
19836,335,$CSAN3,2015-12-31,407214353,0,407214353
19836,335,$CSAN3,2016-03-31,407214353,0,407214353
19836,335,$CSAN3,2016-06-30,407214353,0,407214353
19836,335,$CSAN3,2016-09-30,407214353,0,407214353
19836,335,$CSAN3,2016-12-31,407294353,0,407294353
19836,335,$CSAN3,2017-03-31,407904353,0,407904353
19836,335,$CSAN3,2017-06-30,407904353,0,407904353
19836,335,$CSAN3,2017-09-30,407904353,0,407904353
19836,335,$CSAN3,2017-12-31,407904353,0,407904353
19836,335,$CSAN3,2018-03-31,407904353,0,407904353
19836,335,$CSAN3,2018-06-30,407904353,0,407904353
19836,335,$CSAN3,2018-09-30,407904353,0,407904353
19836,335,$CSAN3,2018-12-31,407904353,0,407904353
19836,335,$CSAN3,2019-03-31,398904353,0,398904353
19836,335,$CSAN3,2019-06-30,398904353,0,398904353
19836,335,$CSAN3,2019-09-30,398904353,0,398904353
19836,335,$CSAN3,2019-12-31,394210000,0,394210000
19836,335,$CSAN3,2020-03-31,394210000,0,394210000
19836,335,$CSAN3,2020-06-30,394210000,0,394210000
19836,335,$CSAN3,2020-09-30,394210000,0,394210000
19879,337,$LIGT3,2010-12-31,203934060,0,203934060
19879,337,$LIGT3,2011-03-31,203934060,0,203934060
19879,337,$LIGT3,2011-06-30,203934060,0,203934060
19879,337,$LIGT3,2011-09-30,203934060,0,203934060
19879,337,$LIGT3,2011-12-31,203934060,0,203934060
19879,337,$LIGT3,2012-03-31,203934060,0,203934060
19879,337,$LIGT3,2012-06-30,203934060,0,203934060
19879,337,$LIGT3,2012-09-30,203934060,0,203934060
19879,337,$LIGT3,2012-12-31,203934060,0,203934060
19879,337,$LIGT3,2013-03-31,203934060,0,203934060
19879,337,$LIGT3,2013-06-30,203934060,0,203934060
19879,337,$LIGT3,2013-09-30,203934060,0,203934060
19879,337,$LIGT3,2013-12-31,203934060,0,203934060
19879,337,$LIGT3,2014-03-31,203934060,0,203934060
19879,337,$LIGT3,2014-06-30,203934060,0,203934060
19879,337,$LIGT3,2014-09-30,203934060,0,203934060
19879,337,$LIGT3,2014-12-31,203934060,0,203934060
19879,337,$LIGT3,2015-03-31,203934060,0,203934060
19879,337,$LIGT3,2015-06-30,203934060,0,203934060
19879,337,$LIGT3,2015-09-30,203934060,0,203934060
19879,337,$LIGT3,2015-12-31,203934060,0,203934060
19879,337,$LIGT3,2016-03-31,203934060,0,203934060
19879,337,$LIGT3,2016-06-30,203934060,0,203934060
19879,337,$LIGT3,2016-09-30,203934060,0,203934060
19879,337,$LIGT3,2016-12-31,203934060,0,203934060
19879,337,$LIGT3,2017-03-31,203934060,0,203934060
19879,337,$LIGT3,2017-06-30,203934060,0,203934060
19879,337,$LIGT3,2017-09-30,203934060,0,203934060
19879,337,$LIGT3,2017-12-31,203934060,0,203934060
19879,337,$LIGT3,2018-03-31,203934060,0,203934060
19879,337,$LIGT3,2018-06-30,203934060,0,203934060
19879,337,$LIGT3,2018-09-30,203934060,0,203934060
19879,337,$LIGT3,2018-12-31,203934060,0,203934060
19879,337,$LIGT3,2019-03-31,203934060,0,203934060
19879,337,$LIGT3,2019-06-30,203934060,0,203934060
19879,337,$LIGT3,2019-09-30,303934060,0,303934060
19879,337,$LIGT3,2019-12-31,303934060,0,303934060
19879,337,$LIGT3,2020-03-31,303934060,0,303934060
19879,337,$LIGT3,2020-06-30,303934060,0,303934060
19879,337,$LIGT3,2020-09-30,303934060,0,303934060
19909,338,$BRML3,2010-12-31,406277,0,406277
19909,338,$BRML3,2011-03-31,406884,0,406884
19909,338,$BRML3,2011-06-30,449384,0,449384
19909,338,$BRML3,2011-09-30,449496,0,449496
19909,338,$BRML3,2011-12-31,449542,0,449542
19909,338,$BRML3,2012-03-31,452912,0,452912
19909,338,$BRML3,2012-06-30,453153,0,453153
19909,338,$BRML3,2012-09-30,453153,0,453153
19909,338,$BRML3,2012-12-31,453364,0,453364
19909,338,$BRML3,2013-03-31,457057,0,457057
19909,338,$BRML3,2013-06-30,457057,0,457057
19909,338,$BRML3,2013-09-30,457066,0,457066
19909,338,$BRML3,2013-12-31,457066,0,457066
19909,338,$BRML3,2014-03-31,460601,0,460601
19909,338,$BRML3,2014-06-30,460601,0,460601
19909,338,$BRML3,2014-09-30,460601,0,460601
19909,338,$BRML3,2014-12-31,460601,0,460601
19909,338,$BRML3,2015-03-31,463713,0,463713
19909,338,$BRML3,2015-06-30,463713,0,463713
19909,338,$BRML3,2015-09-30,463713,0,463713
19909,338,$BRML3,2015-12-31,463732,0,463732
19909,338,$BRML3,2016-03-31,467056,0,467056
19909,338,$BRML3,2016-06-30,607173,0,607173
19909,338,$BRML3,2016-09-30,607173,0,607173
19909,338,$BRML3,2016-12-31,611514,0,611514
19909,338,$BRML3,2017-03-31,619446,0,619446
19909,338,$BRML3,2017-06-30,870660,0,870660
19909,338,$BRML3,2017-09-30,870947,0,870947
19909,338,$BRML3,2017-12-31,872533,0,872533
19909,338,$BRML3,2018-03-31,872533,0,872533
19909,338,$BRML3,2018-06-30,873451,0,873451
19909,338,$BRML3,2018-09-30,871866,0,871866
19909,338,$BRML3,2018-12-31,871866,0,871866
19909,338,$BRML3,2019-03-31,872728,0,872728
19909,338,$BRML3,2019-06-30,872728,0,872728
19909,338,$BRML3,2019-09-30,872728,0,872728
19909,338,$BRML3,2019-12-31,872728,0,872728
19909,338,$BRML3,2020-03-31,873141,0,873141
19909,338,$BRML3,2020-06-30,873141,0,873141
19909,338,$BRML3,2020-09-30,873141,0,873141
19925,340,$BR3,2010-12-31,139512,0,139512
19925,340,$BR3,2011-03-31,139512,0,139512
19925,340,$BR3,2011-06-30,139754,0,139754
19925,340,$BR3,2011-09-30,180004,0,180004
19925,340,$BR3,2011-12-31,180004,0,180004
19925,340,$BR3,2012-03-31,309817,0,309817
19925,340,$BR3,2012-06-30,310307,0,310307
19925,340,$BR3,2012-09-30,310307,0,310307
19925,340,$BR3,2012-12-31,311613,0,311613
19925,340,$BR3,2013-03-31,311613,0,311613
19925,340,$BR3,2013-06-30,312653,0,312653
19925,340,$BR3,2013-09-30,312653,0,312653
19925,340,$BR3,2013-12-31,312653,0,312653
19925,340,$BR3,2014-03-31,312653,0,312653
19925,340,$BR3,2014-06-30,297539,0,297539
19925,340,$BR3,2014-09-30,298228,0,298228
19925,340,$BR3,2014-12-31,298228,0,298228
19925,340,$BR3,2015-03-31,298228,0,298228
19925,340,$BR3,2015-06-30,298228,0,298228
19925,340,$BR3,2015-09-30,298228,0,298228
19925,340,$BR3,2015-12-31,298228,0,298228
19925,340,$BR3,2016-03-31,298228,0,298228
19925,340,$BR3,2016-06-30,298228,0,298228
19925,340,$BR3,2016-09-30,298228,0,298228
19925,340,$BR3,2016-12-31,298228,0,298228
19925,340,$BR3,2017-03-31,298228,0,298228
19925,340,$BR3,2017-06-30,298228,0,298228
19925,340,$BR3,2017-09-30,407135,0,407135
19925,340,$BR3,2017-12-31,407135,0,407135
19925,340,$BR3,2018-03-31,407135,0,407135
19925,340,$BR3,2018-06-30,407135,0,407135
19925,340,$BR3,2018-09-30,407135,0,407135
19925,340,$BR3,2018-12-31,407135,0,407135
19925,340,$BR3,2019-03-31,407135,0,407135
19925,340,$BR3,2019-06-30,407135,0,407135
19925,340,$BR3,2019-09-30,407135,0,407135
19925,340,$BR3,2019-12-31,491510,0,491510
19925,340,$BR3,2020-03-31,491510,0,491510
19925,340,$BR3,2020-06-30,491510,0,491510
19925,340,$BR3,2020-09-30,491510,0,491510
19992,339,$TOTS3,2010-12-31,31459,0,31459
19992,339,$TOTS3,2011-03-31,157303220,0,157303220
19992,339,$TOTS3,2011-06-30,157556860,0,157556860
19992,339,$TOTS3,2011-09-30,159335866,0,159335866
19992,339,$TOTS3,2011-12-31,159466791,0,159466791
19992,339,$TOTS3,2012-03-31,159778198,0,159778198
19992,339,$TOTS3,2012-06-30,160270272,0,160270272
19992,339,$TOTS3,2012-09-30,161622528,0,161622528
19992,339,$TOTS3,2012-12-31,161629945,0,161629945
19992,339,$TOTS3,2013-03-31,162160872,0,162160872
19992,339,$TOTS3,2013-06-30,162206591,0,162206591
19992,339,$TOTS3,2013-09-30,163455154,0,163455154
19992,339,$TOTS3,2013-12-31,163467071,0,163467071
19992,339,$TOTS3,2014-03-31,163467071,0,163467071
19992,339,$TOTS3,2014-06-30,163467071,0,163467071
19992,339,$TOTS3,2014-09-30,163467071,0,163467071
19992,339,$TOTS3,2014-12-31,163467071,0,163467071
19992,339,$TOTS3,2015-03-31,163467071,0,163467071
19992,339,$TOTS3,2015-06-30,163467071,0,163467071
19992,339,$TOTS3,2015-09-30,163467071,0,163467071
19992,339,$TOTS3,2015-12-31,165637727,0,165637727
19992,339,$TOTS3,2016-03-31,165637727,0,165637727
19992,339,$TOTS3,2016-06-30,165637727,0,165637727
19992,339,$TOTS3,2016-09-30,165637727,0,165637727
19992,339,$TOTS3,2016-12-31,165637727,0,165637727
19992,339,$TOTS3,2017-03-31,165637727,0,165637727
19992,339,$TOTS3,2017-06-30,165637727,0,165637727
19992,339,$TOTS3,2017-09-30,165637727,0,165637727
19992,339,$TOTS3,2017-12-31,165637727,0,165637727
19992,339,$TOTS3,2018-03-31,165637727,0,165637727
19992,339,$TOTS3,2018-06-30,165637727,0,165637727
19992,339,$TOTS3,2018-09-30,165637727,0,165637727
19992,339,$TOTS3,2018-12-31,165637727,0,165637727
19992,339,$TOTS3,2019-03-31,165637727,0,165637727
19992,339,$TOTS3,2019-06-30,192637727,0,192637727
19992,339,$TOTS3,2019-09-30,192637727,0,192637727
19992,339,$TOTS3,2019-12-31,192637727,0,192637727
19992,339,$TOTS3,2020-03-31,192637727,0,192637727
19992,339,$TOTS3,2020-06-30,577913181,0,577913181
19992,339,$TOTS3,2020-09-30,577913181,0,577913181
20010,345,$EQTL3,2010-12-31,108826325,0,108826325
20010,345,$EQTL3,2011-03-31,109226672,0,109226672
20010,345,$EQTL3,2011-06-30,109226672,0,109226672
20010,345,$EQTL3,2011-09-30,109226672,0,109226672
20010,345,$EQTL3,2011-12-31,109226672,0,109226672
20010,345,$EQTL3,2012-03-31,109611778,0,109611778
20010,345,$EQTL3,2012-06-30,109611778,0,109611778
20010,345,$EQTL3,2012-09-30,109611778,0,109611778
20010,345,$EQTL3,2012-12-31,185243902,0,185243902
20010,345,$EQTL3,2013-03-31,198447352,0,198447352
20010,345,$EQTL3,2013-06-30,198447352,0,198447352
20010,345,$EQTL3,2013-09-30,198447352,0,198447352
20010,345,$EQTL3,2013-12-31,198447352,0,198447352
20010,345,$EQTL3,2014-03-31,198447352,0,198447352
20010,345,$EQTL3,2014-06-30,198447352,0,198447352
20010,345,$EQTL3,2014-09-30,198447352,0,198447352
20010,345,$EQTL3,2014-12-31,198447352,0,198447352
20010,345,$EQTL3,2015-03-31,198447352,0,198447352
20010,345,$EQTL3,2015-06-30,198447352,0,198447352
20010,345,$EQTL3,2015-09-30,198551102,0,198551102
20010,345,$EQTL3,2015-12-31,198587352,0,198587352
20010,345,$EQTL3,2016-03-31,198588467,0,198588467
20010,345,$EQTL3,2016-06-30,198675967,0,198675967
20010,345,$EQTL3,2016-09-30,198675967,0,198675967
20010,345,$EQTL3,2016-12-31,198675967,0,198675967
20010,345,$EQTL3,2017-03-31,198675967,0,198675967
20010,345,$EQTL3,2017-06-30,198693733,0,198693733
20010,345,$EQTL3,2017-09-30,198743467,0,198743467
20010,345,$EQTL3,2017-12-31,198743467,0,198743467
20010,345,$EQTL3,2018-03-31,198743467,0,198743467
20010,345,$EQTL3,2018-06-30,198743467,0,198743467
20010,345,$EQTL3,2018-09-30,198769717,0,198769717
20010,345,$EQTL3,2018-12-31,198769717,0,198769717
20010,345,$EQTL3,2019-03-31,201102217,0,201102217
20010,345,$EQTL3,2019-06-30,201747217,0,201747217
20010,345,$EQTL3,2019-09-30,201872217,0,201872217
20010,345,$EQTL3,2019-12-31,1010186085,0,1010186085
20010,345,$EQTL3,2020-03-31,1010186085,0,1010186085
20010,345,$EQTL3,2020-06-30,1010286085,0,1010286085
20010,345,$EQTL3,2020-09-30,1010511085,0,1010511085
20028,342,$VLID3,2010-12-31,51500,0,51500
20028,342,$VLID3,2011-03-31,51500,0,51500
20028,342,$VLID3,2011-06-30,56650,0,56650
20028,342,$VLID3,2011-09-30,56650,0,56650
20028,342,$VLID3,2011-12-31,55750,0,55750
20028,342,$VLID3,2012-03-31,55750,0,55750
20028,342,$VLID3,2012-06-30,55750,0,55750
20028,342,$VLID3,2012-09-30,55750,0,55750
20028,342,$VLID3,2012-12-31,55750,0,55750
20028,342,$VLID3,2013-03-31,55750,0,55750
20028,342,$VLID3,2013-06-30,55750,0,55750
20028,342,$VLID3,2013-09-30,55750,0,55750
20028,342,$VLID3,2013-12-31,55750,0,55750
20028,342,$VLID3,2014-03-31,55750,0,55750
20028,342,$VLID3,2014-06-30,55750,0,55750
20028,342,$VLID3,2014-09-30,55750,0,55750
20028,342,$VLID3,2014-12-31,55750,0,55750
20028,342,$VLID3,2015-03-31,55750,0,55750
20028,342,$VLID3,2015-06-30,55750,0,55750
20028,342,$VLID3,2015-09-30,64750,0,64750
20028,342,$VLID3,2015-12-31,64750,0,64750
20028,342,$VLID3,2016-03-31,64750,0,64750
20028,342,$VLID3,2016-06-30,64750,0,64750
20028,342,$VLID3,2016-09-30,64750,0,64750
20028,342,$VLID3,2016-12-31,64750,0,64750
20028,342,$VLID3,2017-03-31,64750,0,64750
20028,342,$VLID3,2017-06-30,71225,0,71225
20028,342,$VLID3,2017-09-30,71225,0,71225
20028,342,$VLID3,2017-12-31,71225,0,71225
20028,342,$VLID3,2018-03-31,71225,0,71225
20028,342,$VLID3,2018-06-30,71225,0,71225
20028,342,$VLID3,2018-09-30,71225,0,71225
20028,342,$VLID3,2018-12-31,71225,0,71225
20028,342,$VLID3,2019-03-31,71225,0,71225
20028,342,$VLID3,2019-06-30,71225,0,71225
20028,342,$VLID3,2019-09-30,71225,0,71225
20028,342,$VLID3,2019-12-31,71225,0,71225
20028,342,$VLID3,2020-03-31,71225,0,71225
20028,342,$VLID3,2020-06-30,71225,0,71225
20028,342,$VLID3,2020-09-30,71225,0,71225
20036,344,$AGRO3,2011-06-30,58422400,0,58422400
20036,344,$AGRO3,2011-09-30,58422400,0,58422400
20036,344,$AGRO3,2011-12-31,58422400,0,58422400
20036,344,$AGRO3,2012-03-31,58422400,0,58422400
20036,344,$AGRO3,2012-06-30,58422400,0,58422400
20036,344,$AGRO3,2012-09-30,58422400,0,58422400
20036,344,$AGRO3,2012-12-31,58422400,0,58422400
20036,344,$AGRO3,2013-03-31,58422400,0,58422400
20036,344,$AGRO3,2013-06-30,58422400,0,58422400
20036,344,$AGRO3,2013-09-30,58422400,0,58422400
20036,344,$AGRO3,2013-12-31,58422400,0,58422400
20036,344,$AGRO3,2014-03-31,58422400,0,58422400
20036,344,$AGRO3,2014-06-30,58422400,0,58422400
20036,344,$AGRO3,2014-09-30,58422400,0,58422400
20036,344,$AGRO3,2014-12-31,58422400,0,58422400
20036,344,$AGRO3,2015-03-31,58226600,0,58226600
20036,344,$AGRO3,2015-06-30,58226600,0,58226600
20036,344,$AGRO3,2015-09-30,58226600,0,58226600
20036,344,$AGRO3,2015-12-31,58226600,0,58226600
20036,344,$AGRO3,2016-03-31,58226600,0,58226600
20036,344,$AGRO3,2016-06-30,58226600,0,58226600
20036,344,$AGRO3,2016-09-30,56888916,0,56888916
20036,344,$AGRO3,2016-12-31,56888916,0,56888916
20036,344,$AGRO3,2017-03-31,56888916,0,56888916
20036,344,$AGRO3,2017-06-30,56888916,0,56888916
20036,344,$AGRO3,2017-09-30,56888916,0,56888916
20036,344,$AGRO3,2017-12-31,56888916,0,56888916
20036,344,$AGRO3,2018-03-31,56888916,0,56888916
20036,344,$AGRO3,2018-06-30,56888916,0,56888916
20036,344,$AGRO3,2018-09-30,56888916,0,56888916
20036,344,$AGRO3,2018-12-31,56888916,0,56888916
20036,344,$AGRO3,2019-03-31,56888916,0,56888916
20036,344,$AGRO3,2019-06-30,56888916,0,56888916
20036,344,$AGRO3,2019-09-30,56888916,0,56888916
20036,344,$AGRO3,2019-12-31,56888916,0,56888916
20036,344,$AGRO3,2020-03-31,62104301,0,62104301
20036,344,$AGRO3,2020-06-30,62104301,0,62104301
20036,344,$AGRO3,2020-09-30,62104301,0,62104301
20044,336,$CARD3,2010-12-31,48572,0,48572
20044,336,$CARD3,2011-03-31,48572,0,48572
20044,336,$CARD3,2011-06-30,48572,0,48572
20044,336,$CARD3,2011-09-30,48572,0,48572
20044,336,$CARD3,2011-12-31,46571,0,46571
20044,336,$CARD3,2012-03-31,46571,0,46571
20044,336,$CARD3,2012-06-30,46571,0,46571
20044,336,$CARD3,2012-09-30,46571,0,46571
20044,336,$CARD3,2012-12-31,46571,0,46571
20044,336,$CARD3,2013-03-31,46571,0,46571
20044,336,$CARD3,2013-06-30,45571,0,45571
20044,336,$CARD3,2013-09-30,44500,0,44500
20044,336,$CARD3,2013-12-31,42900,0,42900
20044,336,$CARD3,2014-03-31,41800,0,41800
20044,336,$CARD3,2014-06-30,41800,0,41800
20044,336,$CARD3,2014-09-30,41800,0,41800
20044,336,$CARD3,2014-12-31,41800,0,41800
20044,336,$CARD3,2015-03-31,41800,0,41800
20044,336,$CARD3,2015-06-30,41800,0,41800
20044,336,$CARD3,2015-09-30,41800,0,41800
20044,336,$CARD3,2015-12-31,41800,0,41800
20044,336,$CARD3,2016-03-31,41800,0,41800
20044,336,$CARD3,2016-06-30,41800,0,41800
20044,336,$CARD3,2016-09-30,41800,0,41800
20044,336,$CARD3,2016-12-31,41800,0,41800
20044,336,$CARD3,2017-03-31,41800,0,41800
20044,336,$CARD3,2017-06-30,41800,0,41800
20044,336,$CARD3,2017-09-30,41800,0,41800
20044,336,$CARD3,2017-12-31,41800,0,41800
20044,336,$CARD3,2018-03-31,41800,0,41800
20044,336,$CARD3,2018-06-30,41800,0,41800
20044,336,$CARD3,2018-09-30,41800,0,41800
20044,336,$CARD3,2018-12-31,41800,0,41800
20044,336,$CARD3,2019-03-31,41800,0,41800
20044,336,$CARD3,2019-06-30,41800,0,41800
20044,336,$CARD3,2019-09-30,41800,0,41800
20044,336,$CARD3,2019-12-31,41800,0,41800
20044,336,$CARD3,2020-03-31,41800,0,41800
20044,336,$CARD3,2020-06-30,41800,0,41800
20044,336,$CARD3,2020-09-30,41800,0,41800
20060,341,$LUPA3,2010-12-31,47737703,0,47737703
20060,341,$LUPA3,2011-03-31,47737703,0,47737703
20060,341,$LUPA3,2011-06-30,47737955,0,47737955
20060,341,$LUPA3,2011-09-30,47737955,0,47737955
20060,341,$LUPA3,2011-12-31,47737703,0,47737703
20060,341,$LUPA3,2012-03-31,47737955,0,47737955
20060,341,$LUPA3,2012-06-30,47737955,0,47737955
20060,341,$LUPA3,2012-09-30,60237955,0,60237955
20060,341,$LUPA3,2012-12-31,157003138,0,157003138
20060,341,$LUPA3,2013-03-31,157003401,0,157003401
20060,341,$LUPA3,2013-06-30,157004093,0,157004093
20060,341,$LUPA3,2013-09-30,157604619,0,157604619
20060,341,$LUPA3,2013-12-31,157604619,0,157604619
20060,341,$LUPA3,2014-03-31,157604619,0,157604619
20060,341,$LUPA3,2014-06-30,157604619,0,157604619
20060,341,$LUPA3,2014-09-30,4697054385,0,4697054385
20060,341,$LUPA3,2014-12-31,4697054385,0,4697054385
20060,341,$LUPA3,2015-03-31,4696917000,0,4696917000
20060,341,$LUPA3,2015-06-30,9393834,0,9393834
20060,341,$LUPA3,2015-09-30,9393834,0,9393834
20060,341,$LUPA3,2015-12-31,9393834,0,9393834
20060,341,$LUPA3,2016-03-31,9393834,0,9393834
20060,341,$LUPA3,2016-06-30,9393834,0,9393834
20060,341,$LUPA3,2016-09-30,9393834,0,9393834
20060,341,$LUPA3,2016-12-31,9393834,0,9393834
20060,341,$LUPA3,2017-03-31,9393834,0,9393834
20060,341,$LUPA3,2017-06-30,9393834,0,9393834
20060,341,$LUPA3,2017-09-30,9393834,0,9393834
20060,341,$LUPA3,2017-12-31,9393834,0,9393834
20060,341,$LUPA3,2018-03-31,15130239,0,15130239
20060,341,$LUPA3,2018-06-30,15488921,0,15488921
20060,341,$LUPA3,2018-09-30,15853203,0,15853203
20060,341,$LUPA3,2018-12-31,16222745,0,16222745
20060,341,$LUPA3,2019-03-31,16597970,0,16597970
20060,341,$LUPA3,2019-06-30,16978437,0,16978437
20060,341,$LUPA3,2019-09-30,22122908,0,22122908
20060,341,$LUPA3,2019-12-31,22515076,0,22515076
20060,341,$LUPA3,2020-03-31,25034015,0,25034015
20060,341,$LUPA3,2020-06-30,25437456,0,25437456
20060,341,$LUPA3,2020-09-30,25847142,0,25847142
20087,348,$EMBR3,2010-12-31,740465,0,740465
20087,348,$EMBR3,2011-03-31,740465,0,740465
20087,348,$EMBR3,2011-06-30,740465,0,740465
20087,348,$EMBR3,2011-09-30,740465,0,740465
20087,348,$EMBR3,2011-12-31,740465,0,740465
20087,348,$EMBR3,2012-03-31,740465,0,740465
20087,348,$EMBR3,2012-06-30,740465,0,740465
20087,348,$EMBR3,2012-09-30,740465,0,740465
20087,348,$EMBR3,2012-12-31,740465,0,740465
20087,348,$EMBR3,2013-03-31,740465,0,740465
20087,348,$EMBR3,2013-06-30,740465,0,740465
20087,348,$EMBR3,2013-09-30,740465,0,740465
20087,348,$EMBR3,2013-12-31,740465,0,740465
20087,348,$EMBR3,2014-03-31,740465,0,740465
20087,348,$EMBR3,2014-06-30,740465,0,740465
20087,348,$EMBR3,2014-09-30,740465,0,740465
20087,348,$EMBR3,2014-12-31,740465,0,740465
20087,348,$EMBR3,2015-03-31,740465,0,740465
20087,348,$EMBR3,2015-06-30,740465,0,740465
20087,348,$EMBR3,2015-09-30,740465,0,740465
20087,348,$EMBR3,2015-12-31,740465,0,740465
20087,348,$EMBR3,2016-03-31,740465,0,740465
20087,348,$EMBR3,2016-06-30,740465,0,740465
20087,348,$EMBR3,2016-09-30,740465,0,740465
20087,348,$EMBR3,2016-12-31,740465,0,740465
20087,348,$EMBR3,2017-03-31,740465,0,740465
20087,348,$EMBR3,2017-06-30,740465,0,740465
20087,348,$EMBR3,2017-09-30,740465,0,740465
20087,348,$EMBR3,2017-12-31,740465,0,740465
20087,348,$EMBR3,2018-03-31,740465,0,740465
20087,348,$EMBR3,2018-06-30,740465,0,740465
20087,348,$EMBR3,2018-09-30,740465,0,740465
20087,348,$EMBR3,2018-12-31,740765,0,740765
20087,348,$EMBR3,2019-03-31,740465,0,740465
20087,348,$EMBR3,2019-06-30,740465,0,740465
20087,348,$EMBR3,2019-09-30,740465,0,740465
20087,348,$EMBR3,2019-12-31,740465,0,740465
20087,348,$EMBR3,2020-03-31,740465,0,740465
20087,348,$EMBR3,2020-06-30,740465,0,740465
20087,348,$EMBR3,2020-09-30,740465,0,740465
20125,346,$ODPV3,2010-12-31,177098264,0,177098264
20125,346,$ODPV3,2011-03-31,177098264,0,177098264
20125,346,$ODPV3,2011-06-30,177098264,0,177098264
20125,346,$ODPV3,2011-09-30,177098264,0,177098264
20125,346,$ODPV3,2011-12-31,177098264,0,177098264
20125,346,$ODPV3,2012-03-31,177098264,0,177098264
20125,346,$ODPV3,2012-06-30,531294792,0,531294792
20125,346,$ODPV3,2012-09-30,531294792,0,531294792
20125,346,$ODPV3,2012-12-31,531294792,0,531294792
20125,346,$ODPV3,2013-03-31,531294792,0,531294792
20125,346,$ODPV3,2013-06-30,531294792,0,531294792
20125,346,$ODPV3,2013-09-30,531294792,0,531294792
20125,346,$ODPV3,2013-12-31,531294792,0,531294792
20125,346,$ODPV3,2014-03-31,531294792,0,531294792
20125,346,$ODPV3,2014-06-30,531294792,0,531294792
20125,346,$ODPV3,2014-09-30,531294792,0,531294792
20125,346,$ODPV3,2014-12-31,531294792,0,531294792
20125,346,$ODPV3,2015-03-31,531294792,0,531294792
20125,346,$ODPV3,2015-06-30,531294792,0,531294792
20125,346,$ODPV3,2015-09-30,531294792,0,531294792
20125,346,$ODPV3,2015-12-31,531294792,0,531294792
20125,346,$ODPV3,2016-03-31,531294792,0,531294792
20125,346,$ODPV3,2016-06-30,531294792,0,531294792
20125,346,$ODPV3,2016-09-30,531294792,0,531294792
20125,346,$ODPV3,2016-12-31,531294792,0,531294792
20125,346,$ODPV3,2017-03-31,531294792,0,531294792
20125,346,$ODPV3,2017-06-30,531294792,0,531294792
20125,346,$ODPV3,2017-09-30,531294792,0,531294792
20125,346,$ODPV3,2017-12-31,531294792,0,531294792
20125,346,$ODPV3,2018-03-31,531294792,0,531294792
20125,346,$ODPV3,2018-06-30,531294792,0,531294792
20125,346,$ODPV3,2018-09-30,531294792,0,531294792
20125,346,$ODPV3,2018-12-31,531294792,0,531294792
20125,346,$ODPV3,2019-03-31,531294792,0,531294792
20125,346,$ODPV3,2019-06-30,531294792,0,531294792
20125,346,$ODPV3,2019-09-30,531294792,0,531294792
20125,346,$ODPV3,2019-12-31,531294792,0,531294792
20125,346,$ODPV3,2020-03-31,531294792,0,531294792
20125,346,$ODPV3,2020-06-30,531294792,0,531294792
20125,346,$ODPV3,2020-09-30,531294792,0,531294792
20184,343,$CCXC3,2010-12-31,3776809,0,3776809
20184,343,$CCXC3,2011-03-31,3776809,0,3776809
20184,343,$CCXC3,2011-06-30,3776809,0,3776809
20184,343,$CCXC3,2011-09-30,3776809,0,3776809
20184,343,$CCXC3,2011-12-31,63776809,0,63776809
20184,343,$CCXC3,2012-03-31,63776809,0,63776809
20184,343,$CCXC3,2012-06-30,170123,0,170123
20184,343,$CCXC3,2012-09-30,170123,0,170123
20184,343,$CCXC3,2012-12-31,170122934,0,170122934
20184,343,$CCXC3,2013-03-31,170123,0,170123
20184,343,$CCXC3,2013-06-30,170123,0,170123
20184,343,$CCXC3,2013-09-30,170123,0,170123
20184,343,$CCXC3,2013-12-31,170122934,0,170122934
20184,343,$CCXC3,2014-03-31,170123,0,170123
20184,343,$CCXC3,2014-06-30,170123,0,170123
20184,343,$CCXC3,2014-09-30,170123,0,170123
20184,343,$CCXC3,2014-12-31,170122934,0,170122934
20184,343,$CCXC3,2015-03-31,170123,0,170123
20184,343,$CCXC3,2015-06-30,170123,0,170123
20184,343,$CCXC3,2015-09-30,17012,0,17012
20184,343,$CCXC3,2015-12-31,17012293,0,17012293
20184,343,$CCXC3,2016-03-31,17012,0,17012
20184,343,$CCXC3,2016-06-30,17012,0,17012
20184,343,$CCXC3,2016-09-30,17012,0,17012
20184,343,$CCXC3,2016-12-31,17012293,0,17012293
20184,343,$CCXC3,2017-03-31,17012,0,17012
20184,343,$CCXC3,2017-06-30,17012,0,17012
20184,343,$CCXC3,2017-09-30,17012,0,17012
20184,343,$CCXC3,2017-12-31,17012293,0,17012293
20184,343,$CCXC3,2018-03-31,17012,0,17012
20184,343,$CCXC3,2018-06-30,1701,0,1701
20184,343,$CCXC3,2018-09-30,1701,0,1701
20184,343,$CCXC3,2018-12-31,1701229,0,1701229
20184,343,$CCXC3,2019-03-31,1701,0,1701
20184,343,$CCXC3,2019-06-30,1701,0,1701
20184,343,$CCXC3,2019-09-30,1701,0,1701
20184,343,$CCXC3,2019-12-31,1701229,0,1701229
20257,349,$TAEE3,2010-12-31,203518,59981,263499
20257,349,$TAEE3,2011-03-31,203518,59981,263499
20257,349,$TAEE3,2011-06-30,203518,59981,263499
20257,349,$TAEE3,2011-09-30,203518,59981,263499
20257,349,$TAEE3,2011-12-31,203518,59981,263499
20257,349,$TAEE3,2012-03-31,203518,59981,263499
20257,349,$TAEE3,2012-06-30,203518,59981,263499
20257,349,$TAEE3,2012-09-30,230518,113981,344499
20257,349,$TAEE3,2012-12-31,691553,341944,1033497
20257,349,$TAEE3,2013-03-31,691553,341944,1033497
20257,349,$TAEE3,2013-06-30,691553,341944,1033497
20257,349,$TAEE3,2013-09-30,691553,341944,1033497
20257,349,$TAEE3,2013-12-31,691553,341944,1033497
20257,349,$TAEE3,2014-03-31,691553,341944,1033497
20257,349,$TAEE3,2014-06-30,691553,341944,1033497
20257,349,$TAEE3,2014-09-30,691553,341944,1033497
20257,349,$TAEE3,2014-12-31,640714,392783,1033497
20257,349,$TAEE3,2015-03-31,640714,392783,1033497
20257,349,$TAEE3,2015-06-30,640714,392783,1033497
20257,349,$TAEE3,2015-09-30,640714,392783,1033497
20257,349,$TAEE3,2015-12-31,640714,392783,1033497
20257,349,$TAEE3,2016-03-31,640714,392783,1033497
20257,349,$TAEE3,2016-06-30,640714,392783,1033497
20257,349,$TAEE3,2016-09-30,590714,442783,1033497
20257,349,$TAEE3,2016-12-31,590714,442783,1033497
20257,349,$TAEE3,2017-03-31,590714,442783,1033497
20257,349,$TAEE3,2017-06-30,590714,442783,1033497
20257,349,$TAEE3,2017-09-30,590714,442783,1033497
20257,349,$TAEE3,2017-12-31,590714,442783,1033497
20257,349,$TAEE3,2018-03-31,590714,442783,1033497
20257,349,$TAEE3,2018-06-30,590714,442783,1033497
20257,349,$TAEE3,2018-09-30,590714,442783,1033497
20257,349,$TAEE3,2018-12-31,590714,442783,1033497
20257,349,$TAEE3,2019-03-31,590714,442783,1033497
20257,349,$TAEE3,2019-06-30,590714,442783,1033497
20257,349,$TAEE3,2019-09-30,590714,442783,1033497
20257,349,$TAEE3,2019-12-31,590714,442783,1033497
20257,349,$TAEE3,2020-03-31,590714,442783,1033497
20257,349,$TAEE3,2020-06-30,590714,442783,1033497
20257,349,$TAEE3,2020-09-30,590714,442783,1033497
20257,350,$TAEE4,2010-12-31,203518,59981,263499
20257,350,$TAEE4,2011-03-31,203518,59981,263499
20257,350,$TAEE4,2011-06-30,203518,59981,263499
20257,350,$TAEE4,2011-09-30,203518,59981,263499
20257,350,$TAEE4,2011-12-31,203518,59981,263499
20257,350,$TAEE4,2012-03-31,203518,59981,263499
20257,350,$TAEE4,2012-06-30,203518,59981,263499
20257,350,$TAEE4,2012-09-30,230518,113981,344499
20257,350,$TAEE4,2012-12-31,691553,341944,1033497
20257,350,$TAEE4,2013-03-31,691553,341944,1033497
20257,350,$TAEE4,2013-06-30,691553,341944,1033497
20257,350,$TAEE4,2013-09-30,691553,341944,1033497
20257,350,$TAEE4,2013-12-31,691553,341944,1033497
20257,350,$TAEE4,2014-03-31,691553,341944,1033497
20257,350,$TAEE4,2014-06-30,691553,341944,1033497
20257,350,$TAEE4,2014-09-30,691553,341944,1033497
20257,350,$TAEE4,2014-12-31,640714,392783,1033497
20257,350,$TAEE4,2015-03-31,640714,392783,1033497
20257,350,$TAEE4,2015-06-30,640714,392783,1033497
20257,350,$TAEE4,2015-09-30,640714,392783,1033497
20257,350,$TAEE4,2015-12-31,640714,392783,1033497
20257,350,$TAEE4,2016-03-31,640714,392783,1033497
20257,350,$TAEE4,2016-06-30,640714,392783,1033497
20257,350,$TAEE4,2016-09-30,590714,442783,1033497
20257,350,$TAEE4,2016-12-31,590714,442783,1033497
20257,350,$TAEE4,2017-03-31,590714,442783,1033497
20257,350,$TAEE4,2017-06-30,590714,442783,1033497
20257,350,$TAEE4,2017-09-30,590714,442783,1033497
20257,350,$TAEE4,2017-12-31,590714,442783,1033497
20257,350,$TAEE4,2018-03-31,590714,442783,1033497
20257,350,$TAEE4,2018-06-30,590714,442783,1033497
20257,350,$TAEE4,2018-09-30,590714,442783,1033497
20257,350,$TAEE4,2018-12-31,590714,442783,1033497
20257,350,$TAEE4,2019-03-31,590714,442783,1033497
20257,350,$TAEE4,2019-06-30,590714,442783,1033497
20257,350,$TAEE4,2019-09-30,590714,442783,1033497
20257,350,$TAEE4,2019-12-31,590714,442783,1033497
20257,350,$TAEE4,2020-03-31,590714,442783,1033497
20257,350,$TAEE4,2020-06-30,590714,442783,1033497
20257,350,$TAEE4,2020-09-30,590714,442783,1033497
20257,598,$TAEE11,2010-12-31,203518,59981,263499
20257,598,$TAEE11,2011-03-31,203518,59981,263499
20257,598,$TAEE11,2011-06-30,203518,59981,263499
20257,598,$TAEE11,2011-09-30,203518,59981,263499
20257,598,$TAEE11,2011-12-31,203518,59981,263499
20257,598,$TAEE11,2012-03-31,203518,59981,263499
20257,598,$TAEE11,2012-06-30,203518,59981,263499
20257,598,$TAEE11,2012-09-30,230518,113981,344499
20257,598,$TAEE11,2012-12-31,691553,341944,1033497
20257,598,$TAEE11,2013-03-31,691553,341944,1033497
20257,598,$TAEE11,2013-06-30,691553,341944,1033497
20257,598,$TAEE11,2013-09-30,691553,341944,1033497
20257,598,$TAEE11,2013-12-31,691553,341944,1033497
20257,598,$TAEE11,2014-03-31,691553,341944,1033497
20257,598,$TAEE11,2014-06-30,691553,341944,1033497
20257,598,$TAEE11,2014-09-30,691553,341944,1033497
20257,598,$TAEE11,2014-12-31,640714,392783,1033497
20257,598,$TAEE11,2015-03-31,640714,392783,1033497
20257,598,$TAEE11,2015-06-30,640714,392783,1033497
20257,598,$TAEE11,2015-09-30,640714,392783,1033497
20257,598,$TAEE11,2015-12-31,640714,392783,1033497
20257,598,$TAEE11,2016-03-31,640714,392783,1033497
20257,598,$TAEE11,2016-06-30,640714,392783,1033497
20257,598,$TAEE11,2016-09-30,590714,442783,1033497
20257,598,$TAEE11,2016-12-31,590714,442783,1033497
20257,598,$TAEE11,2017-03-31,590714,442783,1033497
20257,598,$TAEE11,2017-06-30,590714,442783,1033497
20257,598,$TAEE11,2017-09-30,590714,442783,1033497
20257,598,$TAEE11,2017-12-31,590714,442783,1033497
20257,598,$TAEE11,2018-03-31,590714,442783,1033497
20257,598,$TAEE11,2018-06-30,590714,442783,1033497
20257,598,$TAEE11,2018-09-30,590714,442783,1033497
20257,598,$TAEE11,2018-12-31,590714,442783,1033497
20257,598,$TAEE11,2019-03-31,590714,442783,1033497
20257,598,$TAEE11,2019-06-30,590714,442783,1033497
20257,598,$TAEE11,2019-09-30,590714,442783,1033497
20257,598,$TAEE11,2019-12-31,590714,442783,1033497
20257,598,$TAEE11,2020-03-31,590714,442783,1033497
20257,598,$TAEE11,2020-06-30,590714,442783,1033497
20257,598,$TAEE11,2020-09-30,590714,442783,1033497
20338,347,$MDIA3,2010-12-31,113450,0,113450
20338,347,$MDIA3,2011-03-31,113450000,0,113450000
20338,347,$MDIA3,2011-06-30,113450000,0,113450000
20338,347,$MDIA3,2011-09-30,113450000,0,113450000
20338,347,$MDIA3,2011-12-31,113450000,0,113450000
20338,347,$MDIA3,2012-03-31,113450000,0,113450000
20338,347,$MDIA3,2012-06-30,113450000,0,113450000
20338,347,$MDIA3,2012-09-30,113450000,0,113450000
20338,347,$MDIA3,2012-12-31,113450000,0,113450000
20338,347,$MDIA3,2013-03-31,113450000,0,113450000
20338,347,$MDIA3,2013-06-30,113450000,0,113450000
20338,347,$MDIA3,2013-09-30,113450000,0,113450000
20338,347,$MDIA3,2013-12-31,113450000,0,113450000
20338,347,$MDIA3,2014-03-31,113450000,0,113450000
20338,347,$MDIA3,2014-06-30,113450000,0,113450000
20338,347,$MDIA3,2014-09-30,113450000,0,113450000
20338,347,$MDIA3,2014-12-31,113450000,0,113450000
20338,347,$MDIA3,2015-03-31,113450000,0,113450000
20338,347,$MDIA3,2015-06-30,113450000,0,113450000
20338,347,$MDIA3,2015-09-30,113450000,0,113450000
20338,347,$MDIA3,2015-12-31,113000000,0,113000000
20338,347,$MDIA3,2016-03-31,113000000,0,113000000
20338,347,$MDIA3,2016-06-30,113000000,0,113000000
20338,347,$MDIA3,2016-09-30,113000000,0,113000000
20338,347,$MDIA3,2016-12-31,113000000,0,113000000
20338,347,$MDIA3,2017-03-31,113000000,0,113000000
20338,347,$MDIA3,2017-06-30,339000000,0,339000000
20338,347,$MDIA3,2017-09-30,339000000,0,339000000
20338,347,$MDIA3,2017-12-31,339000000,0,339000000
20338,347,$MDIA3,2018-03-31,339000000,0,339000000
20338,347,$MDIA3,2018-06-30,339000000,0,339000000
20338,347,$MDIA3,2018-09-30,339000000,0,339000000
20338,347,$MDIA3,2018-12-31,339000000,0,339000000
20338,347,$MDIA3,2019-03-31,339000000,0,339000000
20338,347,$MDIA3,2019-06-30,339000000,0,339000000
20338,347,$MDIA3,2019-09-30,339000000,0,339000000
20338,347,$MDIA3,2019-12-31,339000000,0,339000000
20338,347,$MDIA3,2020-03-31,339000000,0,339000000
20338,347,$MDIA3,2020-06-30,339000000,0,339000000
20338,347,$MDIA3,2020-09-30,339000000,0,339000000
20346,354,$PFRM3,2010-12-31,33164,0,33164
20346,354,$PFRM3,2011-03-31,33164,0,33164
20346,354,$PFRM3,2011-06-30,33164,0,33164
20346,354,$PFRM3,2011-09-30,33164,0,33164
20346,354,$PFRM3,2011-12-31,33299,0,33299
20346,354,$PFRM3,2012-03-31,33299,0,33299
20346,354,$PFRM3,2012-06-30,33299,0,33299
20346,354,$PFRM3,2012-09-30,33543,0,33543
20346,354,$PFRM3,2012-12-31,33543,0,33543
20346,354,$PFRM3,2013-03-31,33543,0,33543
20346,354,$PFRM3,2013-06-30,33543,0,33543
20346,354,$PFRM3,2013-09-30,33708,0,33708
20346,354,$PFRM3,2013-12-31,33208,0,33208
20346,354,$PFRM3,2014-03-31,33208,0,33208
20346,354,$PFRM3,2014-06-30,41509,0,41509
20346,354,$PFRM3,2014-09-30,41509,0,41509
20346,354,$PFRM3,2014-12-31,41509,0,41509
20346,354,$PFRM3,2015-03-31,41509,0,41509
20346,354,$PFRM3,2015-06-30,41509,0,41509
20346,354,$PFRM3,2015-09-30,41509,0,41509
20346,354,$PFRM3,2015-12-31,41509,0,41509
20346,354,$PFRM3,2016-03-31,41509,0,41509
20346,354,$PFRM3,2016-06-30,64838,0,64838
20346,354,$PFRM3,2016-09-30,64838,0,64838
20346,354,$PFRM3,2016-12-31,64838,0,64838
20346,354,$PFRM3,2017-03-31,64838,0,64838
20346,354,$PFRM3,2017-06-30,76310,0,76310
20346,354,$PFRM3,2017-09-30,76310,0,76310
20346,354,$PFRM3,2017-12-31,76310,0,76310
20346,354,$PFRM3,2018-03-31,123813,0,123813
20346,354,$PFRM3,2018-06-30,123813,0,123813
20346,354,$PFRM3,2018-09-30,123813,0,123813
20346,354,$PFRM3,2018-12-31,123813,0,123813
20346,354,$PFRM3,2019-03-31,123813,0,123813
20346,354,$PFRM3,2019-06-30,123813,0,123813
20346,354,$PFRM3,2019-09-30,123813,0,123813
20346,354,$PFRM3,2019-12-31,123813,0,123813
20346,354,$PFRM3,2020-03-31,123813,0,123813
20346,354,$PFRM3,2020-06-30,123813,0,123813
20346,354,$PFRM3,2020-09-30,123813,0,123813
20354,418,$TESA3,2010-12-31,1084190,0,1084190
20354,418,$TESA3,2011-03-31,1084190,0,1084190
20354,418,$TESA3,2011-06-30,1084190,0,1084190
20354,418,$TESA3,2011-09-30,2320145,0,2320145
20354,418,$TESA3,2011-12-31,2320145,0,2320145
20354,418,$TESA3,2012-03-31,2320145,0,2320145
20354,418,$TESA3,2012-06-30,2320145,0,2320145
20354,418,$TESA3,2012-09-30,2320145,0,2320145
20354,418,$TESA3,2012-12-31,3486812,0,3486812
20354,418,$TESA3,2013-03-31,3486812,0,3486812
20354,418,$TESA3,2013-06-30,387424,0,387424
20354,418,$TESA3,2013-09-30,387424,0,387424
20354,418,$TESA3,2013-12-31,387424,0,387424
20354,418,$TESA3,2014-03-31,387424,0,387424
20354,418,$TESA3,2014-06-30,387424,0,387424
20354,418,$TESA3,2014-09-30,387424,0,387424
20354,418,$TESA3,2014-12-31,537424,0,537424
20354,418,$TESA3,2015-03-31,537424,0,537424
20354,418,$TESA3,2015-06-30,537424,0,537424
20354,418,$TESA3,2015-09-30,17914,0,17914
20354,418,$TESA3,2015-12-31,17914,0,17914
20354,418,$TESA3,2016-03-31,17914,0,17914
20354,418,$TESA3,2016-06-30,17914,0,17914
20354,418,$TESA3,2016-09-30,17914,0,17914
20354,418,$TESA3,2016-12-31,17914,0,17914
20354,418,$TESA3,2017-03-31,17914,0,17914
20354,418,$TESA3,2017-06-30,17914,0,17914
20354,418,$TESA3,2017-09-30,17914,0,17914
20354,418,$TESA3,2017-12-31,17914,0,17914
20354,418,$TESA3,2018-03-31,17914,0,17914
20354,418,$TESA3,2018-06-30,17914,0,17914
20354,418,$TESA3,2018-09-30,17914,0,17914
20354,418,$TESA3,2018-12-31,17914,0,17914
20354,418,$TESA3,2019-03-31,17914,0,17914
20354,418,$TESA3,2019-06-30,21615,0,21615
20354,418,$TESA3,2019-09-30,21639,0,21639
20354,418,$TESA3,2019-12-31,21640,0,21640
20354,418,$TESA3,2020-03-31,21656,0,21656
20354,418,$TESA3,2020-06-30,21657,0,21657
20354,418,$TESA3,2020-09-30,21657,0,21657
20362,352,$POSI3,2010-12-31,87800,0,87800
20362,352,$POSI3,2011-03-31,87800,0,87800
20362,352,$POSI3,2011-06-30,87800,0,87800
20362,352,$POSI3,2011-09-30,87800,0,87800
20362,352,$POSI3,2011-12-31,87800,0,87800
20362,352,$POSI3,2012-03-31,87800,0,87800
20362,352,$POSI3,2012-06-30,87800,0,87800
20362,352,$POSI3,2012-09-30,87800,0,87800
20362,352,$POSI3,2012-12-31,87800,0,87800
20362,352,$POSI3,2013-03-31,87800,0,87800
20362,352,$POSI3,2013-06-30,87800,0,87800
20362,352,$POSI3,2013-09-30,87800,0,87800
20362,352,$POSI3,2013-12-31,87800,0,87800
20362,352,$POSI3,2014-03-31,87800,0,87800
20362,352,$POSI3,2014-06-30,87800,0,87800
20362,352,$POSI3,2014-09-30,87800,0,87800
20362,352,$POSI3,2014-12-31,87800,0,87800
20362,352,$POSI3,2015-03-31,87800,0,87800
20362,352,$POSI3,2015-06-30,87800,0,87800
20362,352,$POSI3,2015-09-30,87800,0,87800
20362,352,$POSI3,2015-12-31,87800,0,87800
20362,352,$POSI3,2016-03-31,87800,0,87800
20362,352,$POSI3,2016-06-30,87800,0,87800
20362,352,$POSI3,2016-09-30,87800,0,87800
20362,352,$POSI3,2016-12-31,87800,0,87800
20362,352,$POSI3,2017-03-31,87800,0,87800
20362,352,$POSI3,2017-06-30,87800,0,87800
20362,352,$POSI3,2017-09-30,87800,0,87800
20362,352,$POSI3,2017-12-31,87800,0,87800
20362,352,$POSI3,2018-03-31,87800,0,87800
20362,352,$POSI3,2018-06-30,87800,0,87800
20362,352,$POSI3,2018-09-30,87800,0,87800
20362,352,$POSI3,2018-12-31,87800,0,87800
20362,352,$POSI3,2019-03-31,87800,0,87800
20362,352,$POSI3,2019-06-30,87800,0,87800
20362,352,$POSI3,2019-09-30,87800,0,87800
20362,352,$POSI3,2019-12-31,87800,0,87800
20362,352,$POSI3,2020-03-31,141800,0,141800
20362,352,$POSI3,2020-06-30,142112,0,142112
20362,352,$POSI3,2020-09-30,141800,0,141800
20370,356,$LPSB3,2010-12-31,55202,0,55202
20370,356,$LPSB3,2011-03-31,55266,0,55266
20370,356,$LPSB3,2011-06-30,55845,0,55845
20370,356,$LPSB3,2011-09-30,56562,0,56562
20370,356,$LPSB3,2011-12-31,56562,0,56562
20370,356,$LPSB3,2012-03-31,56668,0,56668
20370,356,$LPSB3,2012-06-30,56668,0,56668
20370,356,$LPSB3,2012-09-30,57079,0,57079
20370,356,$LPSB3,2012-12-31,57079,0,57079
20370,356,$LPSB3,2013-03-31,114157,0,114157
20370,356,$LPSB3,2013-06-30,114157,0,114157
20370,356,$LPSB3,2013-09-30,114382,0,114382
20370,356,$LPSB3,2013-12-31,114382,0,114382
20370,356,$LPSB3,2014-03-31,114382,0,114382
20370,356,$LPSB3,2014-06-30,114382,0,114382
20370,356,$LPSB3,2014-09-30,114382,0,114382
20370,356,$LPSB3,2014-12-31,114382,0,114382
20370,356,$LPSB3,2015-03-31,114382,0,114382
20370,356,$LPSB3,2015-06-30,114519,0,114519
20370,356,$LPSB3,2015-09-30,114528,0,114528
20370,356,$LPSB3,2015-12-31,114577,0,114577
20370,356,$LPSB3,2016-03-31,114587,0,114587
20370,356,$LPSB3,2016-06-30,114615,0,114615
20370,356,$LPSB3,2016-09-30,114615,0,114615
20370,356,$LPSB3,2016-12-31,124731,0,124731
20370,356,$LPSB3,2017-03-31,124731,0,124731
20370,356,$LPSB3,2017-06-30,125133,0,125133
20370,356,$LPSB3,2017-09-30,125143,0,125143
20370,356,$LPSB3,2017-12-31,125143,0,125143
20370,356,$LPSB3,2018-03-31,125143,0,125143
20370,356,$LPSB3,2018-06-30,125653,0,125653
20370,356,$LPSB3,2018-09-30,125653,0,125653
20370,356,$LPSB3,2018-12-31,125663,0,125663
20370,356,$LPSB3,2019-03-31,125773,0,125773
20370,356,$LPSB3,2019-06-30,126555,0,126555
20370,356,$LPSB3,2019-09-30,126555,0,126555
20370,356,$LPSB3,2019-12-31,147555,0,147555
20370,356,$LPSB3,2020-03-31,147555,0,147555
20370,356,$LPSB3,2020-06-30,147555,0,147555
20370,356,$LPSB3,2020-09-30,147555,0,147555
20435,359,$TCSA3,2010-12-31,145383,0,145383
20435,359,$TCSA3,2011-03-31,185265,0,185265
20435,359,$TCSA3,2011-06-30,185265,0,185265
20435,359,$TCSA3,2011-09-30,185265,0,185265
20435,359,$TCSA3,2011-12-31,185967,0,185967
20435,359,$TCSA3,2012-03-31,185967,0,185967
20435,359,$TCSA3,2012-06-30,185967,0,185967
20435,359,$TCSA3,2012-09-30,185967,0,185967
20435,359,$TCSA3,2012-12-31,185967,0,185967
20435,359,$TCSA3,2013-03-31,185967,0,185967
20435,359,$TCSA3,2013-06-30,185967,0,185967
20435,359,$TCSA3,2013-09-30,185967,0,185967
20435,359,$TCSA3,2013-12-31,185967,0,185967
20435,359,$TCSA3,2014-03-31,180000,0,180000
20435,359,$TCSA3,2014-06-30,180000,0,180000
20435,359,$TCSA3,2014-09-30,180000,0,180000
20435,359,$TCSA3,2014-12-31,180000,0,180000
20435,359,$TCSA3,2015-03-31,180000,0,180000
20435,359,$TCSA3,2015-06-30,180000,0,180000
20435,359,$TCSA3,2015-09-30,180000,0,180000
20435,359,$TCSA3,2015-12-31,180000,0,180000
20435,359,$TCSA3,2016-03-31,173500,0,173500
20435,359,$TCSA3,2016-06-30,173500,0,173500
20435,359,$TCSA3,2016-09-30,191340,0,191340
20435,359,$TCSA3,2016-12-31,273500,0,273500
20435,359,$TCSA3,2017-03-31,296744,0,296744
20435,359,$TCSA3,2017-06-30,331192,0,331192
20435,359,$TCSA3,2017-09-30,331192,0,331192
20435,359,$TCSA3,2017-12-31,331192,0,331192
20435,359,$TCSA3,2018-03-31,331192,0,331192
20435,359,$TCSA3,2018-06-30,331192,0,331192
20435,359,$TCSA3,2018-09-30,331192,0,331192
20435,359,$TCSA3,2018-12-31,331192,0,331192
20435,359,$TCSA3,2019-03-31,331192,0,331192
20435,359,$TCSA3,2019-06-30,331192,0,331192
20435,359,$TCSA3,2019-09-30,736192,0,736192
20435,359,$TCSA3,2019-12-31,736192,0,736192
20435,359,$TCSA3,2020-03-31,736192,0,736192
20435,359,$TCSA3,2020-06-30,73619,0,73619
20435,359,$TCSA3,2020-09-30,73619,0,73619
20451,355,$RDNI3,2010-12-31,48575,0,48575
20451,355,$RDNI3,2011-03-31,48575,0,48575
20451,355,$RDNI3,2011-06-30,48575,0,48575
20451,355,$RDNI3,2011-09-30,48575,0,48575
20451,355,$RDNI3,2011-12-31,48575,0,48575
20451,355,$RDNI3,2012-03-31,48575,0,48575
20451,355,$RDNI3,2012-06-30,48575,0,48575
20451,355,$RDNI3,2012-09-30,48575,0,48575
20451,355,$RDNI3,2012-12-31,48575,0,48575
20451,355,$RDNI3,2013-03-31,48575,0,48575
20451,355,$RDNI3,2013-06-30,48575,0,48575
20451,355,$RDNI3,2013-09-30,48575,0,48575
20451,355,$RDNI3,2013-12-31,48575,0,48575
20451,355,$RDNI3,2014-03-31,48575,0,48575
20451,355,$RDNI3,2014-06-30,48575,0,48575
20451,355,$RDNI3,2014-09-30,48575,0,48575
20451,355,$RDNI3,2014-12-31,44270,0,44270
20451,355,$RDNI3,2015-03-31,44270,0,44270
20451,355,$RDNI3,2015-06-30,44267,0,44267
20451,355,$RDNI3,2015-09-30,44270,0,44270
20451,355,$RDNI3,2015-12-31,43770,0,43770
20451,355,$RDNI3,2016-03-31,43770,0,43770
20451,355,$RDNI3,2016-06-30,43770,0,43770
20451,355,$RDNI3,2016-09-30,43770,0,43770
20451,355,$RDNI3,2016-12-31,43770,0,43770
20451,355,$RDNI3,2017-03-31,43770,0,43770
20451,355,$RDNI3,2017-06-30,43770,0,43770
20451,355,$RDNI3,2017-09-30,43770,0,43770
20451,355,$RDNI3,2017-12-31,43770,0,43770
20451,355,$RDNI3,2018-03-31,43770,0,43770
20451,355,$RDNI3,2018-06-30,43770,0,43770
20451,355,$RDNI3,2018-09-30,43770,0,43770
20451,355,$RDNI3,2018-12-31,43770,0,43770
20451,355,$RDNI3,2019-03-31,43770,0,43770
20451,355,$RDNI3,2019-06-30,43770,0,43770
20451,355,$RDNI3,2019-09-30,43770,0,43770
20451,355,$RDNI3,2019-12-31,43770,0,43770
20451,355,$RDNI3,2020-03-31,43770,0,43770
20451,355,$RDNI3,2020-06-30,43770,0,43770
20451,355,$RDNI3,2020-09-30,43770,0,43770
20478,361,$PDGR3,2010-12-31,1106242,0,1106242
20478,361,$PDGR3,2011-03-31,1108170,0,1108170
20478,361,$PDGR3,2011-06-30,1123516,0,1123516
20478,361,$PDGR3,2011-09-30,1123632,0,1123632
20478,361,$PDGR3,2011-12-31,1123632,0,1123632
20478,361,$PDGR3,2012-03-31,1133129,0,1133129
20478,361,$PDGR3,2012-06-30,1140642,0,1140642
20478,361,$PDGR3,2012-09-30,1333648,0,1333648
20478,361,$PDGR3,2012-12-31,1333648,0,1333648
20478,361,$PDGR3,2013-03-31,1333648,0,1333648
20478,361,$PDGR3,2013-06-30,1339547,0,1339547
20478,361,$PDGR3,2013-09-30,1339547,0,1339547
20478,361,$PDGR3,2013-12-31,1339547,0,1339547
20478,361,$PDGR3,2014-03-31,1323264,0,1323264
20478,361,$PDGR3,2014-06-30,1323264,0,1323264
20478,361,$PDGR3,2014-09-30,1323264,0,1323264
20478,361,$PDGR3,2014-12-31,1323264,0,1323264
20478,361,$PDGR3,2015-03-31,1323264,0,1323264
20478,361,$PDGR3,2015-06-30,2459628,0,2459628
20478,361,$PDGR3,2015-09-30,2459627,0,2459627
20478,361,$PDGR3,2015-12-31,491932,0,491932
20478,361,$PDGR3,2016-03-31,49192,0,49192
20478,361,$PDGR3,2016-06-30,49192,0,49192
20478,361,$PDGR3,2016-09-30,49192,0,49192
20478,361,$PDGR3,2016-12-31,49192,0,49192
20478,361,$PDGR3,2017-03-31,49192,0,49192
20478,361,$PDGR3,2017-06-30,49192,0,49192
20478,361,$PDGR3,2017-09-30,49192,0,49192
20478,361,$PDGR3,2017-12-31,49192,0,49192
20478,361,$PDGR3,2018-03-31,49192,0,49192
20478,361,$PDGR3,2018-06-30,80669,0,80669
20478,361,$PDGR3,2018-09-30,80669,0,80669
20478,361,$PDGR3,2018-12-31,80669,0,80669
20478,361,$PDGR3,2019-03-31,8066,0,8066
20478,361,$PDGR3,2019-06-30,8066,0,8066
20478,361,$PDGR3,2019-09-30,8066,0,8066
20478,361,$PDGR3,2019-12-31,8066,0,8066
20478,361,$PDGR3,2020-03-31,8066,0,8066
20478,361,$PDGR3,2020-06-30,8066,0,8066
20478,361,$PDGR3,2020-09-30,8066,0,8066
20494,357,$IGTA3,2010-12-31,79255489,0,79255489
20494,357,$IGTA3,2011-03-31,79255894,0,79255894
20494,357,$IGTA3,2011-06-30,79255894,0,79255894
20494,357,$IGTA3,2011-09-30,79255489,0,79255489
20494,357,$IGTA3,2011-12-31,79255489,0,79255489
20494,357,$IGTA3,2012-03-31,79255489,0,79255489
20494,357,$IGTA3,2012-06-30,79255489,0,79255489
20494,357,$IGTA3,2012-09-30,79255489,0,79255489
20494,357,$IGTA3,2012-12-31,158510978,0,158510978
20494,357,$IGTA3,2013-03-31,158510978,0,158510978
20494,357,$IGTA3,2013-06-30,174510978,0,174510978
20494,357,$IGTA3,2013-09-30,176611578,0,176611578
20494,357,$IGTA3,2013-12-31,176611578,0,176611578
20494,357,$IGTA3,2014-03-31,176611578,0,176611578
20494,357,$IGTA3,2014-06-30,176611578,0,176611578
20494,357,$IGTA3,2014-09-30,176611578,0,176611578
20494,357,$IGTA3,2014-12-31,176611578,0,176611578
20494,357,$IGTA3,2015-03-31,176611578,0,176611578
20494,357,$IGTA3,2015-06-30,176611578,0,176611578
20494,357,$IGTA3,2015-09-30,176611578,0,176611578
20494,357,$IGTA3,2015-12-31,176611578,0,176611578
20494,357,$IGTA3,2016-03-31,176611578,0,176611578
20494,357,$IGTA3,2016-06-30,176611578,0,176611578
20494,357,$IGTA3,2016-09-30,176611578,0,176611578
20494,357,$IGTA3,2016-12-31,176611578,0,176611578
20494,357,$IGTA3,2017-03-31,176611578,0,176611578
20494,357,$IGTA3,2017-06-30,176611578,0,176611578
20494,357,$IGTA3,2017-09-30,176611578,0,176611578
20494,357,$IGTA3,2017-12-31,176611578,0,176611578
20494,357,$IGTA3,2018-03-31,176611578,0,176611578
20494,357,$IGTA3,2018-06-30,176611578,0,176611578
20494,357,$IGTA3,2018-09-30,176611578,0,176611578
20494,357,$IGTA3,2018-12-31,176611578,0,176611578
20494,357,$IGTA3,2019-03-31,176611578,0,176611578
20494,357,$IGTA3,2019-06-30,176611578,0,176611578
20494,357,$IGTA3,2019-09-30,176611578,0,176611578
20494,357,$IGTA3,2019-12-31,176611578,0,176611578
20494,357,$IGTA3,2020-03-31,176611578,0,176611578
20494,357,$IGTA3,2020-06-30,176611578,0,176611578
20494,357,$IGTA3,2020-09-30,176611578,0,176611578
20516,353,$SMTO3,2011-03-31,113000000,0,113000000
20516,353,$SMTO3,2011-06-30,113000000,0,113000000
20516,353,$SMTO3,2011-09-30,113000000,0,113000000
20516,353,$SMTO3,2011-12-31,113000000,0,113000000
20516,353,$SMTO3,2012-03-31,113000000,0,113000000
20516,353,$SMTO3,2012-06-30,113000000,0,113000000
20516,353,$SMTO3,2012-09-30,113000000,0,113000000
20516,353,$SMTO3,2012-12-31,113000000,0,113000000
20516,353,$SMTO3,2013-03-31,113000000,0,113000000
20516,353,$SMTO3,2013-06-30,113000000,0,113000000
20516,353,$SMTO3,2013-09-30,113000000,0,113000000
20516,353,$SMTO3,2013-12-31,113000000,0,113000000
20516,353,$SMTO3,2014-03-31,113000000,0,113000000
20516,353,$SMTO3,2014-06-30,113000000,0,113000000
20516,353,$SMTO3,2014-09-30,113000000,0,113000000
20516,353,$SMTO3,2014-12-31,113329207,0,113329207
20516,353,$SMTO3,2015-03-31,113329207,0,113329207
20516,353,$SMTO3,2015-06-30,113329207,0,113329207
20516,353,$SMTO3,2015-09-30,113329207,0,113329207
20516,353,$SMTO3,2015-12-31,113329207,0,113329207
20516,353,$SMTO3,2016-03-31,113329207,0,113329207
20516,353,$SMTO3,2016-06-30,113329207,0,113329207
20516,353,$SMTO3,2016-09-30,113329207,0,113329207
20516,353,$SMTO3,2016-12-31,339987621,0,339987621
20516,353,$SMTO3,2017-03-31,364011329,0,364011329
20516,353,$SMTO3,2017-06-30,364011329,0,364011329
20516,353,$SMTO3,2017-09-30,364011329,0,364011329
20516,353,$SMTO3,2017-12-31,364011329,0,364011329
20516,353,$SMTO3,2018-03-31,364011329,0,364011329
20516,353,$SMTO3,2018-06-30,364011329,0,364011329
20516,353,$SMTO3,2018-09-30,364011329,0,364011329
20516,353,$SMTO3,2018-12-31,364011329,0,364011329
20516,353,$SMTO3,2019-03-31,364011329,0,364011329
20516,353,$SMTO3,2019-06-30,351011329,0,351011329
20516,353,$SMTO3,2019-09-30,354011329,0,354011329
20516,353,$SMTO3,2019-12-31,354011329,0,354011329
20516,353,$SMTO3,2020-03-31,354011329,0,354011329
20516,353,$SMTO3,2020-06-30,354011329,0,354011329
20516,353,$SMTO3,2020-09-30,354011329,0,354011329
20524,363,$EVEN3,2010-12-31,233293408,0,233293408
20524,363,$EVEN3,2011-03-31,223293408,0,223293408
20524,363,$EVEN3,2011-06-30,233293408,0,233293408
20524,363,$EVEN3,2011-09-30,233293408,0,233293408
20524,363,$EVEN3,2011-12-31,233293408,0,233293408
20524,363,$EVEN3,2012-03-31,233293408,0,233293408
20524,363,$EVEN3,2012-06-30,233293,0,233293
20524,363,$EVEN3,2012-09-30,233293,0,233293
20524,363,$EVEN3,2012-12-31,233293408,0,233293408
20524,363,$EVEN3,2013-03-31,233293408,0,233293408
20524,363,$EVEN3,2013-06-30,233293408,0,233293408
20524,363,$EVEN3,2013-09-30,233293408,0,233293408
20524,363,$EVEN3,2013-12-31,233293408,0,233293408
20524,363,$EVEN3,2014-03-31,233293408,0,233293408
20524,363,$EVEN3,2014-06-30,233293408,0,233293408
20524,363,$EVEN3,2014-09-30,233293408,0,233293408
20524,363,$EVEN3,2014-12-31,233293408,0,233293408
20524,363,$EVEN3,2015-03-31,233293408,0,233293408
20524,363,$EVEN3,2015-06-30,233293408,0,233293408
20524,363,$EVEN3,2015-09-30,233293408,0,233293408
20524,363,$EVEN3,2015-12-31,233293408,0,233293408
20524,363,$EVEN3,2016-03-31,225000000,0,225000000
20524,363,$EVEN3,2016-06-30,225000000,0,225000000
20524,363,$EVEN3,2016-09-30,225000000,0,225000000
20524,363,$EVEN3,2016-12-31,225000000,0,225000000
20524,363,$EVEN3,2017-03-31,225000000,0,225000000
20524,363,$EVEN3,2017-06-30,225000000,0,225000000
20524,363,$EVEN3,2017-09-30,225000000,0,225000000
20524,363,$EVEN3,2017-12-31,225000000,0,225000000
20524,363,$EVEN3,2018-03-31,225000000,0,225000000
20524,363,$EVEN3,2018-06-30,225000000,0,225000000
20524,363,$EVEN3,2018-09-30,225000000,0,225000000
20524,363,$EVEN3,2018-12-31,217000000,0,217000000
20524,363,$EVEN3,2019-03-31,217000000,0,217000000
20524,363,$EVEN3,2019-06-30,217000000,0,217000000
20524,363,$EVEN3,2019-09-30,217000000,0,217000000
20524,363,$EVEN3,2019-12-31,217000000,0,217000000
20524,363,$EVEN3,2020-03-31,217000000,0,217000000
20524,363,$EVEN3,2020-06-30,212000000,0,212000000
20524,363,$EVEN3,2020-09-30,212000000,0,212000000
20524,363,$EVEN3,2020-09-30,212000000,0,212000000
20532,603,$SANB11,2010-12-31,212841732,186202385,399044117
20532,603,$SANB11,2011-03-31,212841732,186202385,399044117
20532,603,$SANB11,2011-06-30,212841732,186202385,399044117
20532,603,$SANB11,2011-09-30,212841732,186202385,399044117
20532,603,$SANB11,2011-12-31,212841732,186202385,399044117
20532,603,$SANB11,2012-03-31,212841732,186202385,399044117
20532,603,$SANB11,2012-06-30,212841732,186202385,399044117
20532,603,$SANB11,2012-09-30,212841732,186202385,399044117
20532,603,$SANB11,2012-12-31,212841732,186202385,399044117
20532,603,$SANB11,2013-03-31,212841732,186202385,399044117
20532,603,$SANB11,2013-06-30,212841732,186202385,399044117
20532,603,$SANB11,2013-09-30,212841732,186202385,399044117
20532,603,$SANB11,2013-12-31,212841732,186202385,399044117
20532,603,$SANB11,2014-03-31,212841732,186202385,399044117
20532,603,$SANB11,2014-06-30,3869850,3730990,7600840
20532,603,$SANB11,2014-09-30,3844766,3705906,7550672
20532,603,$SANB11,2014-12-31,3840238,3701378,7541616
20532,603,$SANB11,2015-03-31,3842577,3703717,7546294
20532,603,$SANB11,2015-06-30,3869850,3730990,7600840
20532,603,$SANB11,2015-09-30,3869849,3730991,7600840
20532,603,$SANB11,2015-12-31,3830753,3691894,7522647
20532,603,$SANB11,2016-03-31,3829491,3690632,7520123
20532,603,$SANB11,2016-06-30,3826465,3687605,7514070
20532,603,$SANB11,2016-09-30,3827637,3688778,7516415
20532,603,$SANB11,2016-12-31,3825185,3686326,7511511
20532,603,$SANB11,2017-03-31,3829485,3690626,7520111
20532,603,$SANB11,2017-06-30,3850971,3712111,7563082
20532,603,$SANB11,2017-09-30,3818695,3679836,7498531
20532,603,$SANB11,2017-12-31,3812850,3673991,7486841
20532,603,$SANB11,2018-03-31,3818695,3679836,7498531
20532,603,$SANB11,2018-06-30,3818695,3679836,7498531
20532,603,$SANB11,2018-09-30,3807635,3668776,7476411
20532,603,$SANB11,2018-12-31,3805378,3666519,7471897
20532,603,$SANB11,2019-03-31,3805067,3666208,7471275
20532,603,$SANB11,2019-06-30,3818695,3679836,7498531
20532,603,$SANB11,2019-09-30,3818695,3679836,7498531
20532,603,$SANB11,2019-12-31,3818695,3679836,7498531
20532,603,$SANB11,2020-03-31,3818695,3679836,7498531
20532,603,$SANB11,2020-06-30,3818695,3679836,7498531
20532,603,$SANB11,2020-09-30,3818695,3679836,7498531
20540,414,$CPRE3,2010-12-31,708403499,0,708403499
20540,414,$CPRE3,2011-03-31,708403499,0,708403499
20540,414,$CPRE3,2011-06-30,708403499,0,708403499
20540,414,$CPRE3,2011-09-30,1676101458,0,1676101458
20540,414,$CPRE3,2011-12-31,2061370145,0,2061370145
20540,414,$CPRE3,2012-03-31,2061370145,0,2061370145
20540,414,$CPRE3,2012-06-30,412274029,0,412274029
20540,414,$CPRE3,2012-09-30,412274029,0,412274029
20540,414,$CPRE3,2012-12-31,412274029,0,412274029
20540,414,$CPRE3,2013-03-31,412274029,0,412274029
20540,414,$CPRE3,2013-06-30,412274029,0,412274029
20540,414,$CPRE3,2013-09-30,441425692,0,441425692
20540,414,$CPRE3,2013-12-31,441425692,0,441425692
20540,414,$CPRE3,2014-03-31,441486996,0,441486996
20540,414,$CPRE3,2014-06-30,441529878,0,441529878
20540,414,$CPRE3,2014-09-30,441529878,0,441529878
20540,414,$CPRE3,2014-12-31,503308389,0,503308389
20540,414,$CPRE3,2015-03-31,503308389,0,503308389
20540,414,$CPRE3,2015-06-30,503308389,0,503308389
20540,414,$CPRE3,2015-09-30,503308389,0,503308389
20540,414,$CPRE3,2015-12-31,503308389,0,503308389
20540,414,$CPRE3,2016-03-31,503308389,0,503308389
20540,414,$CPRE3,2016-06-30,503308389,0,503308389
20540,414,$CPRE3,2016-09-30,503351271,0,503351271
20540,414,$CPRE3,2016-12-31,503351271,0,503351271
20540,414,$CPRE3,2017-03-31,503351271,0,503351271
20540,414,$CPRE3,2017-06-30,503351271,0,503351271
20540,414,$CPRE3,2017-09-30,503351271,0,503351271
20540,414,$CPRE3,2017-12-31,503351271,0,503351271
20540,414,$CPRE3,2018-03-31,503351271,0,503351271
20540,414,$CPRE3,2018-06-30,503351271,0,503351271
20540,414,$CPRE3,2018-09-30,503351271,0,503351271
20540,414,$CPRE3,2018-12-31,503811489,0,503811489
20540,414,$CPRE3,2019-03-31,503811489,0,503811489
20540,414,$CPRE3,2019-06-30,521315091,0,521315091
20540,414,$CPRE3,2019-09-30,521315091,0,521315091
20540,414,$CPRE3,2019-12-31,521315091,0,521315091
20540,414,$CPRE3,2020-03-31,521315091,0,521315091
20540,414,$CPRE3,2020-06-30,521315091,0,521315091
20540,414,$CPRE3,2020-09-30,593782504,0,593782504
20567,362,$PINE4,2010-12-31,45444,39965,85409
20567,362,$PINE4,2011-03-31,45444,39965,85409
20567,362,$PINE4,2011-06-30,45444,39965,85409
20567,362,$PINE4,2011-09-30,45443872,38590394,84034266
20567,362,$PINE4,2011-12-31,45443872,38590394,84034266
20567,362,$PINE4,2012-03-31,51886766,46966008,98852774
20567,362,$PINE4,2012-06-30,51886766,46966008,98852774
20567,362,$PINE4,2012-09-30,51886766,46966008,98852774
20567,362,$PINE4,2012-12-31,58444889,50186211,108631100
20567,362,$PINE4,2013-03-31,58444889,50186211,108631100
20567,362,$PINE4,2013-06-30,58444889,52397424,110842313
20567,362,$PINE4,2013-09-30,58444889,52397424,110842313
20567,362,$PINE4,2013-12-31,58444889,52397424,110842313
20567,362,$PINE4,2014-03-31,65178483,55869285,121047768
20567,362,$PINE4,2014-06-30,65178483,55993541,121172024
20567,362,$PINE4,2014-09-30,65178483,55993541,121172024
20567,362,$PINE4,2014-12-31,65178483,55993541,121172024
20567,362,$PINE4,2015-03-31,65178483,55993541,121172024
20567,362,$PINE4,2015-06-30,65178483,55993541,121172024
20567,362,$PINE4,2015-09-30,65178483,55993541,121172024
20567,362,$PINE4,2015-12-31,65178483,55993541,121172024
20567,362,$PINE4,2016-03-31,65178483,55993541,121172024
20567,362,$PINE4,2016-06-30,65178483,55993541,121172024
20567,362,$PINE4,2016-09-30,65178483,55993541,121172024
20567,362,$PINE4,2016-12-31,65178483,55993541,121172024
20567,362,$PINE4,2017-03-31,65178483,55993541,121172024
20567,362,$PINE4,2017-06-30,65178483,55993541,121172024
20567,362,$PINE4,2017-09-30,65178483,55993541,121172024
20567,362,$PINE4,2017-12-31,65178483,55993541,121172024
20567,362,$PINE4,2018-03-31,65178483,55993541,121172024
20567,362,$PINE4,2018-06-30,65178483,55993541,121172024
20567,362,$PINE4,2018-09-30,65178483,55993541,121172024
20567,362,$PINE4,2018-12-31,65178483,55993541,121172024
20567,362,$PINE4,2019-03-31,65178483,55993541,121172024
20567,362,$PINE4,2019-06-30,65178483,55993541,121172024
20567,362,$PINE4,2019-09-30,65178483,55992912,121171395
20567,362,$PINE4,2019-12-31,75577842,72579922,148157764
20567,362,$PINE4,2020-03-31,75577842,72579922,148157764
20567,362,$PINE4,2020-06-30,75577842,72579922,148157764
20567,362,$PINE4,2020-09-30,75577842,72579922,148157764
20575,366,$JBSS3,2010-12-31,2567471476,0,2567471476
20575,366,$JBSS3,2011-03-31,2567471476,0,2567471476
20575,366,$JBSS3,2011-06-30,2567471476,0,2567471476
20575,366,$JBSS3,2011-09-30,3061444191,0,3061444191
20575,366,$JBSS3,2011-12-31,3061444191,0,3061444191
20575,366,$JBSS3,2012-03-31,2963924296,0,2963924296
20575,366,$JBSS3,2012-06-30,2963924296,0,2963924296
20575,366,$JBSS3,2012-09-30,2943644008,0,2943644008
20575,366,$JBSS3,2012-12-31,2943644008,0,2943644008
20575,366,$JBSS3,2013-03-31,2943644008,0,2943644008
20575,366,$JBSS3,2013-06-30,2943644008,0,2943644008
20575,366,$JBSS3,2013-09-30,2943644008,0,2943644008
20575,366,$JBSS3,2013-12-31,2943644008,0,2943644008
20575,366,$JBSS3,2014-03-31,2943644008,0,2943644008
20575,366,$JBSS3,2014-06-30,2943644008,0,2943644008
20575,366,$JBSS3,2014-09-30,2943644008,0,2943644008
20575,366,$JBSS3,2014-12-31,2943644008,0,2943644008
20575,366,$JBSS3,2015-03-31,2944389270,0,2944389270
20575,366,$JBSS3,2015-06-30,2944425560,0,2944425560
20575,366,$JBSS3,2015-09-30,2856857505,0,2856857505
20575,366,$JBSS3,2015-12-31,2856857505,0,2856857505
20575,366,$JBSS3,2016-03-31,2856857505,0,2856857505
20575,366,$JBSS3,2016-06-30,2856857505,0,2856857505
20575,366,$JBSS3,2016-09-30,2856857505,0,2856857505
20575,366,$JBSS3,2016-12-31,2856857505,0,2856857505
20575,366,$JBSS3,2017-03-31,2728747412,0,2728747412
20575,366,$JBSS3,2017-06-30,2728747412,0,2728747412
20575,366,$JBSS3,2017-09-30,2728747412,0,2728747412
20575,366,$JBSS3,2017-12-31,2728747412,0,2728747412
20575,366,$JBSS3,2018-03-31,2728747412,0,2728747412
20575,366,$JBSS3,2018-06-30,2728747412,0,2728747412
20575,366,$JBSS3,2018-09-30,2728747412,0,2728747412
20575,366,$JBSS3,2018-12-31,2728747412,0,2728747412
20575,366,$JBSS3,2019-03-31,2728747412,0,2728747412
20575,366,$JBSS3,2019-06-30,2728747412,0,2728747412
20575,366,$JBSS3,2019-09-30,2728747412,0,2728747412
20575,366,$JBSS3,2019-12-31,2728747412,0,2728747412
20575,366,$JBSS3,2020-03-31,2728747412,0,2728747412
20575,366,$JBSS3,2020-06-30,2728747412,0,2728747412
20575,366,$JBSS3,2020-09-30,2666079023,0,2666079023
20605,360,$JHSF3,2010-12-31,426374825,0,426374825
20605,360,$JHSF3,2011-03-31,426374825,0,426374825
20605,360,$JHSF3,2011-06-30,426374825,0,426374825
20605,360,$JHSF3,2011-09-30,427074825,0,427074825
20605,360,$JHSF3,2011-12-31,428762581,0,428762581
20605,360,$JHSF3,2012-03-31,428989318,0,428989318
20605,360,$JHSF3,2012-06-30,429999185,0,429999185
20605,360,$JHSF3,2012-09-30,430264187,0,430264187
20605,360,$JHSF3,2012-12-31,430550735,0,430550735
20605,360,$JHSF3,2013-03-31,431327816,0,431327816
20605,360,$JHSF3,2013-06-30,431434183,0,431434183
20605,360,$JHSF3,2013-09-30,431816420,0,431816420
20605,360,$JHSF3,2013-12-31,432043157,0,432043157
20605,360,$JHSF3,2014-03-31,432043157,0,432043157
20605,360,$JHSF3,2014-06-30,432043157,0,432043157
20605,360,$JHSF3,2014-09-30,432269894,0,432269894
20605,360,$JHSF3,2014-12-31,432269894,0,432269894
20605,360,$JHSF3,2015-03-31,432269894,0,432269894
20605,360,$JHSF3,2015-06-30,525000000,0,525000000
20605,360,$JHSF3,2015-09-30,525000000,0,525000000
20605,360,$JHSF3,2015-12-31,525000000,0,525000000
20605,360,$JHSF3,2016-03-31,525000000,0,525000000
20605,360,$JHSF3,2016-06-30,525000000,0,525000000
20605,360,$JHSF3,2016-09-30,525000000,0,525000000
20605,360,$JHSF3,2016-12-31,525000000,0,525000000
20605,360,$JHSF3,2017-03-31,525661247,0,525661247
20605,360,$JHSF3,2017-06-30,525661247,0,525661247
20605,360,$JHSF3,2017-09-30,525661247,0,525661247
20605,360,$JHSF3,2017-12-31,525661247,0,525661247
20605,360,$JHSF3,2018-03-31,526383839,0,526383839
20605,360,$JHSF3,2018-06-30,526383839,0,526383839
20605,360,$JHSF3,2018-09-30,526383839,0,526383839
20605,360,$JHSF3,2018-12-31,526383839,0,526383839
20605,360,$JHSF3,2019-03-31,527233245,0,527233245
20605,360,$JHSF3,2019-06-30,530059981,0,530059981
20605,360,$JHSF3,2019-09-30,530059981,0,530059981
20605,360,$JHSF3,2019-12-31,638059981,0,638059981
20605,360,$JHSF3,2020-03-31,641241829,0,641241829
20605,360,$JHSF3,2020-06-30,641241829,0,641241829
20605,360,$JHSF3,2020-09-30,685530641,0,685530641
20613,358,$FRIO3,2010-12-31,41439,0,41439
20613,358,$FRIO3,2011-03-31,41439,0,41439
20613,358,$FRIO3,2011-06-30,41439,0,41439
20613,358,$FRIO3,2011-09-30,41439,0,41439
20613,358,$FRIO3,2011-12-31,41439,0,41439
20613,358,$FRIO3,2012-03-31,41439,0,41439
20613,358,$FRIO3,2012-06-30,41439,0,41439
20613,358,$FRIO3,2012-09-30,41439,0,41439
20613,358,$FRIO3,2012-12-31,41439,0,41439
20613,358,$FRIO3,2013-03-31,41439,0,41439
20613,358,$FRIO3,2013-06-30,41439,0,41439
20613,358,$FRIO3,2013-09-30,41439,0,41439
20613,358,$FRIO3,2013-12-31,41439,0,41439
20613,358,$FRIO3,2014-03-31,41439,0,41439
20613,358,$FRIO3,2014-06-30,41439,0,41439
20613,358,$FRIO3,2014-09-30,41439,0,41439
20613,358,$FRIO3,2014-12-31,41439,0,41439
20613,358,$FRIO3,2015-03-31,41439,0,41439
20613,358,$FRIO3,2015-06-30,40804,0,40804
20613,358,$FRIO3,2015-09-30,40804,0,40804
20613,358,$FRIO3,2015-12-31,13601,0,13601
20613,358,$FRIO3,2016-03-31,13601,0,13601
20613,358,$FRIO3,2016-06-30,13601,0,13601
20613,358,$FRIO3,2016-09-30,61601,0,61601
20613,358,$FRIO3,2016-12-31,61601,0,61601
20613,358,$FRIO3,2017-03-31,61601,0,61601
20613,358,$FRIO3,2017-06-30,4106754,0,4106754
20613,358,$FRIO3,2017-09-30,4106754,0,4106754
20613,358,$FRIO3,2017-12-31,4106754,0,4106754
20613,358,$FRIO3,2018-03-31,4106754,0,4106754
20613,358,$FRIO3,2018-06-30,4106754,0,4106754
20613,358,$FRIO3,2018-09-30,4106754,0,4106754
20613,358,$FRIO3,2018-12-31,4106754,0,4106754
20613,358,$FRIO3,2019-03-31,4106754,0,4106754
20613,358,$FRIO3,2019-06-30,4106754,0,4106754
20613,358,$FRIO3,2019-09-30,4106754,0,4106754
20613,358,$FRIO3,2019-12-31,4106754,0,4106754
20613,358,$FRIO3,2020-03-31,4106754,0,4106754
20613,358,$FRIO3,2020-06-30,4106754,0,4106754
20613,358,$FRIO3,2020-09-30,4106754,0,4106754
20621,365,$FHER3,2010-12-31,48471,0,48471
20621,365,$FHER3,2011-03-31,48471,0,48471
20621,365,$FHER3,2011-06-30,48471,0,48471
20621,365,$FHER3,2011-09-30,48471,0,48471
20621,365,$FHER3,2011-12-31,48471,0,48471
20621,365,$FHER3,2012-03-31,48471,0,48471
20621,365,$FHER3,2012-06-30,48471407,0,48471407
20621,365,$FHER3,2012-09-30,48471407,0,48471407
20621,365,$FHER3,2012-12-31,48471407,0,48471407
20621,365,$FHER3,2013-03-31,48471407,0,48471407
20621,365,$FHER3,2013-06-30,48471,0,48471
20621,365,$FHER3,2013-09-30,48471,0,48471
20621,365,$FHER3,2013-12-31,48471407,0,48471407
20621,365,$FHER3,2014-03-31,48471407,0,48471407
20621,365,$FHER3,2014-06-30,48471407,0,48471407
20621,365,$FHER3,2014-09-30,48471407,0,48471407
20621,365,$FHER3,2014-12-31,48471407,0,48471407
20621,365,$FHER3,2015-03-31,53857284,0,53857284
20621,365,$FHER3,2015-06-30,53857284,0,53857284
20621,365,$FHER3,2015-09-30,53857284,0,53857284
20621,365,$FHER3,2015-12-31,53857284,0,53857284
20621,365,$FHER3,2016-03-31,53857284,0,53857284
20621,365,$FHER3,2016-06-30,53857284,0,53857284
20621,365,$FHER3,2016-09-30,53857284,0,53857284
20621,365,$FHER3,2016-12-31,53857284,0,53857284
20621,365,$FHER3,2017-03-31,53857284,0,53857284
20621,365,$FHER3,2017-06-30,53857284,0,53857284
20621,365,$FHER3,2017-09-30,53857284,0,53857284
20621,365,$FHER3,2017-12-31,53857284,0,53857284
20621,365,$FHER3,2018-03-31,53857284,0,53857284
20621,365,$FHER3,2018-06-30,53857284,0,53857284
20621,365,$FHER3,2018-09-30,53857284,0,53857284
20621,365,$FHER3,2018-12-31,53857284,0,53857284
20621,365,$FHER3,2019-03-31,53857284,0,53857284
20621,365,$FHER3,2019-06-30,53857284,0,53857284
20621,365,$FHER3,2019-09-30,53857284,0,53857284
20621,365,$FHER3,2019-12-31,53857284,0,53857284
20621,365,$FHER3,2020-03-31,53857284,0,53857284
20621,365,$FHER3,2020-06-30,53857284,0,53857284
20621,365,$FHER3,2020-09-30,53857284,0,53857284
20630,364,$CRDE3,2010-12-31,46136250,0,46136250
20630,364,$CRDE3,2011-03-31,48443062,0,48443062
20630,364,$CRDE3,2011-06-30,48443062,0,48443062
20630,364,$CRDE3,2011-09-30,48443062,0,48443062
20630,364,$CRDE3,2011-12-31,48443062,0,48443062
20630,364,$CRDE3,2012-03-31,48443062,0,48443062
20630,364,$CRDE3,2012-06-30,48443062,0,48443062
20630,364,$CRDE3,2012-09-30,48443062,0,48443062
20630,364,$CRDE3,2012-12-31,48443062,0,48443062
20630,364,$CRDE3,2013-03-31,48443062,0,48443062
20630,364,$CRDE3,2013-06-30,48443062,0,48443062
20630,364,$CRDE3,2013-09-30,48443062,0,48443062
20630,364,$CRDE3,2013-12-31,48443062,0,48443062
20630,364,$CRDE3,2014-03-31,48443062,0,48443062
20630,364,$CRDE3,2014-06-30,48443062,0,48443062
20630,364,$CRDE3,2014-09-30,48443062,0,48443062
20630,364,$CRDE3,2014-12-31,48443062,0,48443062
20630,364,$CRDE3,2015-03-31,48443062,0,48443062
20630,364,$CRDE3,2015-06-30,48443062,0,48443062
20630,364,$CRDE3,2015-09-30,48443062,0,48443062
20630,364,$CRDE3,2015-12-31,48443062,0,48443062
20630,364,$CRDE3,2016-03-31,48443062,0,48443062
20630,364,$CRDE3,2016-06-30,48443062,0,48443062
20630,364,$CRDE3,2016-09-30,48443062,0,48443062
20630,364,$CRDE3,2016-12-31,48443062,0,48443062
20630,364,$CRDE3,2017-03-31,48443062,0,48443062
20630,364,$CRDE3,2017-06-30,48443062,0,48443062
20630,364,$CRDE3,2017-09-30,48443062,0,48443062
20630,364,$CRDE3,2017-12-31,48443062,0,48443062
20630,364,$CRDE3,2018-03-31,48443062,0,48443062
20630,364,$CRDE3,2018-06-30,48443062,0,48443062
20630,364,$CRDE3,2018-09-30,48443062,0,48443062
20630,364,$CRDE3,2018-12-31,48443062,0,48443062
20630,364,$CRDE3,2019-03-31,2422153,0,2422153
20630,364,$CRDE3,2019-06-30,2422153,0,2422153
20630,364,$CRDE3,2019-09-30,2422153,0,2422153
20630,364,$CRDE3,2019-12-31,2422153,0,2422153
20630,364,$CRDE3,2020-03-31,2422153,0,2422153
20630,364,$CRDE3,2020-06-30,2422153,0,2422153
20630,364,$CRDE3,2020-09-30,2422153,0,2422153
20648,479,$ceed3,2010-12-31,380669270,6560558,387229828
20648,479,$ceed3,2011-03-31,380669270,6560558,387229828
20648,479,$ceed3,2011-06-30,380669270,6560558,387229828
20648,479,$ceed3,2011-09-30,380669270,6560558,387229828
20648,479,$ceed3,2011-12-31,380669270,6560558,387229828
20648,479,$ceed3,2012-03-31,380669270,6560558,387229828
20648,479,$ceed3,2012-06-30,380669270,6560558,387229828
20648,479,$ceed3,2012-09-30,380669270,6560558,387229828
20648,479,$ceed3,2012-12-31,380669270,6560558,387229828
20648,479,$ceed3,2013-03-31,380669270,6560558,387229828
20648,479,$ceed3,2013-06-30,380669270,6560558,387229828
20648,479,$ceed3,2013-09-30,380669270,6560558,387229828
20648,479,$ceed3,2013-12-31,380669270,6560558,387229828
20648,479,$ceed3,2014-03-31,380669270,6560558,387229828
20648,479,$ceed3,2014-06-30,380669270,6560558,387229828
20648,479,$ceed3,2014-09-30,380669270,6560558,387229828
20648,479,$ceed3,2014-12-31,380669270,6560558,387229828
20648,479,$ceed3,2015-03-31,380669270,6560558,387229828
20648,479,$ceed3,2015-06-30,380669270,6560558,387229828
20648,479,$ceed3,2015-09-30,380669270,6560558,387229828
20648,479,$ceed3,2015-12-31,380669270,6560558,387229828
20648,479,$ceed3,2016-03-31,380669270,6560558,387229828
20648,479,$ceed3,2016-06-30,9516732,164014,9680746
20648,479,$ceed3,2016-09-30,9516732,164014,9680746
20648,479,$ceed3,2016-12-31,9516732,164014,9680746
20648,479,$ceed3,2017-03-31,9516732,164014,9680746
20648,479,$ceed3,2017-06-30,9516732,164014,9680746
20648,479,$ceed3,2017-09-30,9516732,164014,9680746
20648,479,$ceed3,2017-12-31,9516732,164014,9680746
20648,479,$ceed3,2018-03-31,9516732,164014,9680746
20648,479,$ceed3,2018-06-30,9516732,164014,9680746
20648,479,$ceed3,2018-09-30,9516732,164014,9680746
20648,479,$ceed3,2018-12-31,9516732,164014,9680746
20648,479,$ceed3,2019-03-31,9516732,164014,9680746
20648,479,$ceed3,2019-06-30,9516732,164014,9680746
20648,479,$ceed3,2019-09-30,9516732,164014,9680746
20648,479,$ceed3,2019-12-31,9516732,164014,9680746
20648,479,$ceed3,2020-03-31,9516732,164014,9680746
20648,479,$ceed3,2020-06-30,9516732,164014,9680746
20648,479,$ceed3,2020-09-30,9516732,164014,9680746
20648,480,$ceed4,2010-12-31,380669270,6560558,387229828
20648,480,$ceed4,2011-03-31,380669270,6560558,387229828
20648,480,$ceed4,2011-06-30,380669270,6560558,387229828
20648,480,$ceed4,2011-09-30,380669270,6560558,387229828
20648,480,$ceed4,2011-12-31,380669270,6560558,387229828
20648,480,$ceed4,2012-03-31,380669270,6560558,387229828
20648,480,$ceed4,2012-06-30,380669270,6560558,387229828
20648,480,$ceed4,2012-09-30,380669270,6560558,387229828
20648,480,$ceed4,2012-12-31,380669270,6560558,387229828
20648,480,$ceed4,2013-03-31,380669270,6560558,387229828
20648,480,$ceed4,2013-06-30,380669270,6560558,387229828
20648,480,$ceed4,2013-09-30,380669270,6560558,387229828
20648,480,$ceed4,2013-12-31,380669270,6560558,387229828
20648,480,$ceed4,2014-03-31,380669270,6560558,387229828
20648,480,$ceed4,2014-06-30,380669270,6560558,387229828
20648,480,$ceed4,2014-09-30,380669270,6560558,387229828
20648,480,$ceed4,2014-12-31,380669270,6560558,387229828
20648,480,$ceed4,2015-03-31,380669270,6560558,387229828
20648,480,$ceed4,2015-06-30,380669270,6560558,387229828
20648,480,$ceed4,2015-09-30,380669270,6560558,387229828
20648,480,$ceed4,2015-12-31,380669270,6560558,387229828
20648,480,$ceed4,2016-03-31,380669270,6560558,387229828
20648,480,$ceed4,2016-06-30,9516732,164014,9680746
20648,480,$ceed4,2016-09-30,9516732,164014,9680746
20648,480,$ceed4,2016-12-31,9516732,164014,9680746
20648,480,$ceed4,2017-03-31,9516732,164014,9680746
20648,480,$ceed4,2017-06-30,9516732,164014,9680746
20648,480,$ceed4,2017-09-30,9516732,164014,9680746
20648,480,$ceed4,2017-12-31,9516732,164014,9680746
20648,480,$ceed4,2018-03-31,9516732,164014,9680746
20648,480,$ceed4,2018-06-30,9516732,164014,9680746
20648,480,$ceed4,2018-09-30,9516732,164014,9680746
20648,480,$ceed4,2018-12-31,9516732,164014,9680746
20648,480,$ceed4,2019-03-31,9516732,164014,9680746
20648,480,$ceed4,2019-06-30,9516732,164014,9680746
20648,480,$ceed4,2019-09-30,9516732,164014,9680746
20648,480,$ceed4,2019-12-31,9516732,164014,9680746
20648,480,$ceed4,2020-03-31,9516732,164014,9680746
20648,480,$ceed4,2020-06-30,9516732,164014,9680746
20648,480,$ceed4,2020-09-30,9516732,164014,9680746
20702,413,$INPR3,2010-12-31,285309,0,285309
20702,413,$INPR3,2011-03-31,285309,0,285309
20702,413,$INPR3,2011-06-30,285309,0,285309
20702,413,$INPR3,2011-09-30,285309,0,285309
20702,413,$INPR3,2011-12-31,285309,0,285309
20702,413,$INPR3,2012-03-31,285309,0,285309
20702,413,$INPR3,2012-06-30,285309,0,285309
20702,413,$INPR3,2012-09-30,285309,0,285309
20702,413,$INPR3,2012-12-31,334965,0,334965
20702,413,$INPR3,2013-03-31,334965,0,334965
20702,413,$INPR3,2013-06-30,334965,0,334965
20702,413,$INPR3,2013-09-30,335309,0,335309
20702,413,$INPR3,2013-12-31,335309,0,335309
20702,413,$INPR3,2014-03-31,335309,0,335309
20702,413,$INPR3,2014-06-30,335309,0,335309
20702,413,$INPR3,2014-09-30,335309,0,335309
20702,413,$INPR3,2014-12-31,335309,0,335309
20702,413,$INPR3,2015-03-31,335309,0,335309
20702,413,$INPR3,2015-06-30,335309,0,335309
20702,413,$INPR3,2015-09-30,339122,0,339122
20702,413,$INPR3,2015-12-31,339392,0,339392
20702,413,$INPR3,2016-03-31,341240,0,341240
20702,413,$INPR3,2016-06-30,3414,0,3414
20702,413,$INPR3,2016-09-30,3482,0,3482
20702,413,$INPR3,2016-12-31,4298,0,4298
20702,413,$INPR3,2017-03-31,4299,0,4299
20702,413,$INPR3,2017-06-30,4299,0,4299
20702,413,$INPR3,2017-09-30,4299,0,4299
20702,413,$INPR3,2017-12-31,4301,0,4301
20702,413,$INPR3,2018-03-31,4301,0,4301
20702,413,$INPR3,2018-06-30,292810,0,292810
20702,413,$INPR3,2018-09-30,292810,0,292810
20702,413,$INPR3,2018-12-31,445395,0,445395
20702,413,$INPR3,2019-03-31,463170,0,463170
20702,413,$INPR3,2019-06-30,46317,0,46317
20702,413,$INPR3,2019-09-30,46317,0,46317
20702,413,$INPR3,2019-12-31,46572,0,46572
20702,413,$INPR3,2020-03-31,46572,0,46572
20702,413,$INPR3,2020-06-30,60430,0,60430
20702,413,$INPR3,2020-09-30,95168,0,95168
20702,415,$VIVR3,2010-12-31,285309,0,285309
20702,415,$VIVR3,2011-03-31,285309,0,285309
20702,415,$VIVR3,2011-06-30,285309,0,285309
20702,415,$VIVR3,2011-09-30,285309,0,285309
20702,415,$VIVR3,2011-12-31,285309,0,285309
20702,415,$VIVR3,2012-03-31,285309,0,285309
20702,415,$VIVR3,2012-06-30,285309,0,285309
20702,415,$VIVR3,2012-09-30,285309,0,285309
20702,415,$VIVR3,2012-12-31,334965,0,334965
20702,415,$VIVR3,2013-03-31,334965,0,334965
20702,415,$VIVR3,2013-06-30,334965,0,334965
20702,415,$VIVR3,2013-09-30,335309,0,335309
20702,415,$VIVR3,2013-12-31,335309,0,335309
20702,415,$VIVR3,2014-03-31,335309,0,335309
20702,415,$VIVR3,2014-06-30,335309,0,335309
20702,415,$VIVR3,2014-09-30,335309,0,335309
20702,415,$VIVR3,2014-12-31,335309,0,335309
20702,415,$VIVR3,2015-03-31,335309,0,335309
20702,415,$VIVR3,2015-06-30,335309,0,335309
20702,415,$VIVR3,2015-09-30,339122,0,339122
20702,415,$VIVR3,2015-12-31,339392,0,339392
20702,415,$VIVR3,2016-03-31,341240,0,341240
20702,415,$VIVR3,2016-06-30,3414,0,3414
20702,415,$VIVR3,2016-09-30,3482,0,3482
20702,415,$VIVR3,2016-12-31,4298,0,4298
20702,415,$VIVR3,2017-03-31,4299,0,4299
20702,415,$VIVR3,2017-06-30,4299,0,4299
20702,415,$VIVR3,2017-09-30,4299,0,4299
20702,415,$VIVR3,2017-12-31,4301,0,4301
20702,415,$VIVR3,2018-03-31,4301,0,4301
20702,415,$VIVR3,2018-06-30,292810,0,292810
20702,415,$VIVR3,2018-09-30,292810,0,292810
20702,415,$VIVR3,2018-12-31,445395,0,445395
20702,415,$VIVR3,2019-03-31,463170,0,463170
20702,415,$VIVR3,2019-06-30,46317,0,46317
20702,415,$VIVR3,2019-09-30,46317,0,46317
20702,415,$VIVR3,2019-12-31,46572,0,46572
20702,415,$VIVR3,2020-03-31,46572,0,46572
20702,415,$VIVR3,2020-06-30,60430,0,60430
20702,415,$VIVR3,2020-09-30,95168,0,95168
20710,481,$LOGN3,2010-12-31,91712,0,91712
20710,481,$LOGN3,2011-03-31,91712,0,91712
20710,481,$LOGN3,2011-06-30,91711620,0,91711620
20710,481,$LOGN3,2011-09-30,91711620,0,91711620
20710,481,$LOGN3,2011-12-31,91712,0,91712
20710,481,$LOGN3,2012-03-31,91712,0,91712
20710,481,$LOGN3,2012-06-30,91712,0,91712
20710,481,$LOGN3,2012-09-30,91712,0,91712
20710,481,$LOGN3,2012-12-31,91712,0,91712
20710,481,$LOGN3,2013-03-31,91712,0,91712
20710,481,$LOGN3,2013-06-30,91712,0,91712
20710,481,$LOGN3,2013-09-30,91712,0,91712
20710,481,$LOGN3,2013-12-31,91712,0,91712
20710,481,$LOGN3,2014-03-31,91712,0,91712
20710,481,$LOGN3,2014-06-30,91712,0,91712
20710,481,$LOGN3,2014-09-30,91712,0,91712
20710,481,$LOGN3,2014-12-31,91712,0,91712
20710,481,$LOGN3,2015-03-31,91712,0,91712
20710,481,$LOGN3,2015-06-30,91712,0,91712
20710,481,$LOGN3,2015-09-30,91712,0,91712
20710,481,$LOGN3,2015-12-31,91712,0,91712
20710,481,$LOGN3,2016-03-31,91712,0,91712
20710,481,$LOGN3,2016-06-30,18342,0,18342
20710,481,$LOGN3,2016-09-30,18342,0,18342
20710,481,$LOGN3,2016-12-31,18342,0,18342
20710,481,$LOGN3,2017-03-31,23357,0,23357
20710,481,$LOGN3,2017-06-30,23357,0,23357
20710,481,$LOGN3,2017-09-30,23357,0,23357
20710,481,$LOGN3,2017-12-31,23357,0,23357
20710,481,$LOGN3,2018-03-31,23357,0,23357
20710,481,$LOGN3,2018-06-30,36040,0,36040
20710,481,$LOGN3,2018-09-30,37089,0,37089
20710,481,$LOGN3,2018-12-31,38075,0,38075
20710,481,$LOGN3,2019-03-31,38387,0,38387
20710,481,$LOGN3,2019-06-30,37771,0,37771
20710,481,$LOGN3,2019-09-30,48495751,0,48495751
20710,481,$LOGN3,2019-12-31,104199191,0,104199191
20710,481,$LOGN3,2020-03-31,104199191,0,104199191
20710,481,$LOGN3,2020-06-30,105489191,0,105489191
20710,481,$LOGN3,2020-09-30,105489191,0,105489191
20745,370,$SLCE3,2010-12-31,98897500,0,98897500
20745,370,$SLCE3,2011-03-31,98897500,0,98897500
20745,370,$SLCE3,2011-06-30,98897500,0,98897500
20745,370,$SLCE3,2011-09-30,98897500,0,98897500
20745,370,$SLCE3,2011-12-31,98897500,0,98897500
20745,370,$SLCE3,2012-03-31,98897500,0,98897500
20745,370,$SLCE3,2012-06-30,98897500,0,98897500
20745,370,$SLCE3,2012-09-30,98897500,0,98897500
20745,370,$SLCE3,2012-12-31,98897500,0,98897500
20745,370,$SLCE3,2013-03-31,98897500,0,98897500
20745,370,$SLCE3,2013-06-30,98897500,0,98897500
20745,370,$SLCE3,2013-09-30,98897500,0,98897500
20745,370,$SLCE3,2013-12-31,98897500,0,98897500
20745,370,$SLCE3,2014-03-31,98897500,0,98897500
20745,370,$SLCE3,2014-06-30,98897500,0,98897500
20745,370,$SLCE3,2014-09-30,98897500,0,98897500
20745,370,$SLCE3,2014-12-31,98879500,0,98879500
20745,370,$SLCE3,2015-03-31,98897500,0,98897500
20745,370,$SLCE3,2015-06-30,98897500,0,98897500
20745,370,$SLCE3,2015-09-30,98897500,0,98897500
20745,370,$SLCE3,2015-12-31,98897500,0,98897500
20745,370,$SLCE3,2016-03-31,98897500,0,98897500
20745,370,$SLCE3,2016-06-30,98897500,0,98897500
20745,370,$SLCE3,2016-09-30,98897500,0,98897500
20745,370,$SLCE3,2016-12-31,98897500,0,98897500
20745,370,$SLCE3,2017-03-31,98897500,0,98897500
20745,370,$SLCE3,2017-06-30,98897500,0,98897500
20745,370,$SLCE3,2017-09-30,98897500,0,98897500
20745,370,$SLCE3,2017-12-31,98897500,0,98897500
20745,370,$SLCE3,2018-03-31,95297500,0,95297500
20745,370,$SLCE3,2018-06-30,95297500,0,95297500
20745,370,$SLCE3,2018-09-30,95297500,0,95297500
20745,370,$SLCE3,2018-12-31,95297500,0,95297500
20745,370,$SLCE3,2019-03-31,95297500,0,95297500
20745,370,$SLCE3,2019-06-30,190595000,0,190595000
20745,370,$SLCE3,2019-09-30,190595000,0,190595000
20745,370,$SLCE3,2019-12-31,190595000,0,190595000
20745,370,$SLCE3,2020-03-31,190595000,0,190595000
20745,370,$SLCE3,2020-06-30,190595000,0,190595000
20745,370,$SLCE3,2020-09-30,190595000,0,190595000
20770,367,$EZTC3,2010-12-31,146724120,0,146724120
20770,367,$EZTC3,2011-03-31,146724120,0,146724120
20770,367,$EZTC3,2011-06-30,146724120,0,146724120
20770,367,$EZTC3,2011-09-30,146724120,0,146724120
20770,367,$EZTC3,2011-12-31,146724120,0,146724120
20770,367,$EZTC3,2012-03-31,146724120,0,146724120
20770,367,$EZTC3,2012-06-30,146724120,0,146724120
20770,367,$EZTC3,2012-09-30,146724120,0,146724120
20770,367,$EZTC3,2012-12-31,146724120,0,146724120
20770,367,$EZTC3,2013-03-31,146724120,0,146724120
20770,367,$EZTC3,2013-06-30,146724120,0,146724120
20770,367,$EZTC3,2013-09-30,146724120,0,146724120
20770,367,$EZTC3,2013-12-31,146724120,0,146724120
20770,367,$EZTC3,2014-03-31,146724120,0,146724120
20770,367,$EZTC3,2014-06-30,146724120,0,146724120
20770,367,$EZTC3,2014-09-30,146724120,0,146724120
20770,367,$EZTC3,2014-12-31,146724120,0,146724120
20770,367,$EZTC3,2015-03-31,146724120,0,146724120
20770,367,$EZTC3,2015-06-30,157058466,0,157058466
20770,367,$EZTC3,2015-09-30,157058466,0,157058466
20770,367,$EZTC3,2015-12-31,157058466,0,157058466
20770,367,$EZTC3,2016-03-31,165001783,0,165001783
20770,367,$EZTC3,2016-06-30,165001783,0,165001783
20770,367,$EZTC3,2016-09-30,165001783,0,165001783
20770,367,$EZTC3,2016-12-31,165001783,0,165001783
20770,367,$EZTC3,2017-03-31,165001783,0,165001783
20770,367,$EZTC3,2017-06-30,165001783,0,165001783
20770,367,$EZTC3,2017-09-30,165001783,0,165001783
20770,367,$EZTC3,2017-12-31,165001783,0,165001783
20770,367,$EZTC3,2018-03-31,165001783,0,165001783
20770,367,$EZTC3,2018-06-30,165001783,0,165001783
20770,367,$EZTC3,2018-09-30,165001783,0,165001783
20770,367,$EZTC3,2018-12-31,165001783,0,165001783
20770,367,$EZTC3,2019-03-31,165001783,0,165001783
20770,367,$EZTC3,2019-06-30,200000000,0,200000000
20770,367,$EZTC3,2019-09-30,227000,0,227000
20770,367,$EZTC3,2019-12-31,227000000,0,227000000
20770,367,$EZTC3,2020-03-31,227000000,0,227000000
20770,367,$EZTC3,2020-06-30,227000000,0,227000000
20770,367,$EZTC3,2020-09-30,227000000,0,227000000
20788,373,$MRFG3,2010-12-31,346983954,0,346983954
20788,373,$MRFG3,2011-03-31,346983954,0,346983954
20788,373,$MRFG3,2011-06-30,346983954,0,346983954
20788,373,$MRFG3,2011-09-30,346983954,0,346983954
20788,373,$MRFG3,2011-12-31,346983954,0,346983954
20788,373,$MRFG3,2012-03-31,346983954,0,346983954
20788,373,$MRFG3,2012-06-30,346983954,0,346983954
20788,373,$MRFG3,2012-09-30,345747405,0,345747405
20788,373,$MRFG3,2012-12-31,476997405,0,476997405
20788,373,$MRFG3,2013-03-31,520747405,0,520747405
20788,373,$MRFG3,2013-06-30,520747405,0,520747405
20788,373,$MRFG3,2013-09-30,520747405,0,520747405
20788,373,$MRFG3,2013-12-31,520747405,0,520747405
20788,373,$MRFG3,2014-03-31,520747405,0,520747405
20788,373,$MRFG3,2014-06-30,520747405,0,520747405
20788,373,$MRFG3,2014-09-30,520747405,0,520747405
20788,373,$MRFG3,2014-12-31,520747405,0,520747405
20788,373,$MRFG3,2015-03-31,520747405,0,520747405
20788,373,$MRFG3,2015-06-30,520747405,0,520747405
20788,373,$MRFG3,2015-09-30,520747405,0,520747405
20788,373,$MRFG3,2015-12-31,520747405,0,520747405
20788,373,$MRFG3,2016-03-31,520747405,0,520747405
20788,373,$MRFG3,2016-06-30,521065385,0,521065385
20788,373,$MRFG3,2016-09-30,521300754,0,521300754
20788,373,$MRFG3,2016-12-31,521300754,0,521300754
20788,373,$MRFG3,2017-03-31,621279822,0,621279822
20788,373,$MRFG3,2017-06-30,621279822,0,621279822
20788,373,$MRFG3,2017-09-30,621279822,0,621279822
20788,373,$MRFG3,2017-12-31,621279822,0,621279822
20788,373,$MRFG3,2018-03-31,621279822,0,621279822
20788,373,$MRFG3,2018-06-30,621279822,0,621279822
20788,373,$MRFG3,2018-09-30,621279822,0,621279822
20788,373,$MRFG3,2018-12-31,621279822,0,621279822
20788,373,$MRFG3,2019-03-31,621279822,0,621279822
20788,373,$MRFG3,2019-06-30,621279822,0,621279822
20788,373,$MRFG3,2019-09-30,621279822,0,621279822
20788,373,$MRFG3,2019-12-31,711369913,0,711369913
20788,373,$MRFG3,2020-03-31,711369913,0,711369913
20788,373,$MRFG3,2020-06-30,711369913,0,711369913
20788,373,$MRFG3,2020-09-30,711369913,0,711369913
20788,378,$ADR,2010-12-31,346983954,0,346983954
20788,378,$ADR,2011-03-31,346983954,0,346983954
20788,378,$ADR,2011-06-30,346983954,0,346983954
20788,378,$ADR,2011-09-30,346983954,0,346983954
20788,378,$ADR,2011-12-31,346983954,0,346983954
20788,378,$ADR,2012-03-31,346983954,0,346983954
20788,378,$ADR,2012-06-30,346983954,0,346983954
20788,378,$ADR,2012-09-30,345747405,0,345747405
20788,378,$ADR,2012-12-31,476997405,0,476997405
20788,378,$ADR,2013-03-31,520747405,0,520747405
20788,378,$ADR,2013-06-30,520747405,0,520747405
20788,378,$ADR,2013-09-30,520747405,0,520747405
20788,378,$ADR,2013-12-31,520747405,0,520747405
20788,378,$ADR,2014-03-31,520747405,0,520747405
20788,378,$ADR,2014-06-30,520747405,0,520747405
20788,378,$ADR,2014-09-30,520747405,0,520747405
20788,378,$ADR,2014-12-31,520747405,0,520747405
20788,378,$ADR,2015-03-31,520747405,0,520747405
20788,378,$ADR,2015-06-30,520747405,0,520747405
20788,378,$ADR,2015-09-30,520747405,0,520747405
20788,378,$ADR,2015-12-31,520747405,0,520747405
20788,378,$ADR,2016-03-31,520747405,0,520747405
20788,378,$ADR,2016-06-30,521065385,0,521065385
20788,378,$ADR,2016-09-30,521300754,0,521300754
20788,378,$ADR,2016-12-31,521300754,0,521300754
20788,378,$ADR,2017-03-31,621279822,0,621279822
20788,378,$ADR,2017-06-30,621279822,0,621279822
20788,378,$ADR,2017-09-30,621279822,0,621279822
20788,378,$ADR,2017-12-31,621279822,0,621279822
20788,378,$ADR,2018-03-31,621279822,0,621279822
20788,378,$ADR,2018-06-30,621279822,0,621279822
20788,378,$ADR,2018-09-30,621279822,0,621279822
20788,378,$ADR,2018-12-31,621279822,0,621279822
20788,378,$ADR,2019-03-31,621279822,0,621279822
20788,378,$ADR,2019-06-30,621279822,0,621279822
20788,378,$ADR,2019-09-30,621279822,0,621279822
20788,378,$ADR,2019-12-31,711369913,0,711369913
20788,378,$ADR,2020-03-31,711369913,0,711369913
20788,378,$ADR,2020-06-30,711369913,0,711369913
20788,378,$ADR,2020-09-30,711369913,0,711369913
20800,372,$tgma3,2010-12-31,66003,0,66003
20800,372,$tgma3,2011-03-31,66003,0,66003
20800,372,$tgma3,2011-06-30,66003,0,66003
20800,372,$tgma3,2011-09-30,66003,0,66003
20800,372,$tgma3,2011-12-31,66003,0,66003
20800,372,$tgma3,2012-03-31,66002,0,66002
20800,372,$tgma3,2012-06-30,66002,0,66002
20800,372,$tgma3,2012-09-30,66003,0,66003
20800,372,$tgma3,2012-12-31,66002,0,66002
20800,372,$tgma3,2013-03-31,66002,0,66002
20800,372,$tgma3,2013-06-30,66002,0,66002
20800,372,$tgma3,2013-09-30,66002,0,66002
20800,372,$tgma3,2013-12-31,66002915,0,66002915
20800,372,$tgma3,2014-03-31,66002915,0,66002915
20800,372,$tgma3,2014-06-30,66002915,0,66002915
20800,372,$tgma3,2014-09-30,66002915,0,66002915
20800,372,$tgma3,2014-12-31,66002915,0,66002915
20800,372,$tgma3,2015-03-31,66002915,0,66002915
20800,372,$tgma3,2015-06-30,66002915,0,66002915
20800,372,$tgma3,2015-09-30,66002915,0,66002915
20800,372,$tgma3,2015-12-31,66002915,0,66002915
20800,372,$tgma3,2016-03-31,66002915,0,66002915
20800,372,$tgma3,2016-06-30,66002915,0,66002915
20800,372,$tgma3,2016-09-30,66002915,0,66002915
20800,372,$tgma3,2016-12-31,66002915,0,66002915
20800,372,$tgma3,2017-03-31,66002915,0,66002915
20800,372,$tgma3,2017-06-30,66002915,0,66002915
20800,372,$tgma3,2017-09-30,66002915,0,66002915
20800,372,$tgma3,2017-12-31,66002915,0,66002915
20800,372,$tgma3,2018-03-31,66002915,0,66002915
20800,372,$tgma3,2018-06-30,66002915,0,66002915
20800,372,$tgma3,2018-09-30,66002915,0,66002915
20800,372,$tgma3,2018-12-31,66002915,0,66002915
20800,372,$tgma3,2019-03-31,66002915,0,66002915
20800,372,$tgma3,2019-06-30,66002915,0,66002915
20800,372,$tgma3,2019-09-30,66002915,0,66002915
20800,372,$tgma3,2019-12-31,66002915,0,66002915
20800,372,$tgma3,2020-03-31,66002815,0,66002815
20800,372,$tgma3,2020-06-30,66002815,0,66002815
20800,372,$tgma3,2020-09-30,66002815,0,66002815
20877,375,$HBOR3,2010-12-31,65097,0,65097
20877,375,$HBOR3,2011-03-31,65097,0,65097
20877,375,$HBOR3,2011-06-30,65097,0,65097
20877,375,$HBOR3,2011-09-30,65097,0,65097
20877,375,$HBOR3,2011-12-31,65097,0,65097
20877,375,$HBOR3,2012-03-31,65097,0,65097
20877,375,$HBOR3,2012-06-30,195291,0,195291
20877,375,$HBOR3,2012-09-30,195291,0,195291
20877,375,$HBOR3,2012-12-31,195291,0,195291
20877,375,$HBOR3,2013-03-31,198231,0,198231
20877,375,$HBOR3,2013-06-30,257700,0,257700
20877,375,$HBOR3,2013-09-30,257700,0,257700
20877,375,$HBOR3,2013-12-31,257700,0,257700
20877,375,$HBOR3,2014-03-31,257700,0,257700
20877,375,$HBOR3,2014-06-30,257700,0,257700
20877,375,$HBOR3,2014-09-30,257700,0,257700
20877,375,$HBOR3,2014-12-31,257700,0,257700
20877,375,$HBOR3,2015-03-31,257700,0,257700
20877,375,$HBOR3,2015-06-30,257700,0,257700
20877,375,$HBOR3,2015-09-30,257700,0,257700
20877,375,$HBOR3,2015-12-31,257700,0,257700
20877,375,$HBOR3,2016-03-31,257700,0,257700
20877,375,$HBOR3,2016-06-30,257700,0,257700
20877,375,$HBOR3,2016-09-30,257700,0,257700
20877,375,$HBOR3,2016-12-31,325882,0,325882
20877,375,$HBOR3,2017-03-31,325882,0,325882
20877,375,$HBOR3,2017-06-30,325882,0,325882
20877,375,$HBOR3,2017-09-30,325882,0,325882
20877,375,$HBOR3,2017-12-31,457913,0,457913
20877,375,$HBOR3,2018-03-31,457913,0,457913
20877,375,$HBOR3,2018-06-30,457913,0,457913
20877,375,$HBOR3,2018-09-30,457913,0,457913
20877,375,$HBOR3,2018-12-31,457913,0,457913
20877,375,$HBOR3,2019-03-31,457913,0,457913
20877,375,$HBOR3,2019-06-30,457913,0,457913
20877,375,$HBOR3,2019-09-30,457913,0,457913
20877,375,$HBOR3,2019-12-31,669255,0,669255
20877,375,$HBOR3,2020-03-31,669255,0,669255
20877,375,$HBOR3,2020-06-30,669255,0,669255
20877,375,$HBOR3,2020-09-30,133851,0,133851
20885,368,$IDVL3,2010-12-31,27000000,14212984,41212984
20885,368,$IDVL3,2011-03-31,27000000,14212984,41212984
20885,368,$IDVL3,2011-06-30,27000000,14212984,41212984
20885,368,$IDVL3,2011-09-30,36945649,26160044,63105693
20885,368,$IDVL3,2011-12-31,36945649,26160044,63105693
20885,368,$IDVL3,2012-03-31,36945649,26160044,63105693
20885,368,$IDVL3,2012-06-30,36945649,26160044,63105693
20885,368,$IDVL3,2012-09-30,36945649,26160044,63105693
20885,368,$IDVL3,2012-12-31,36945649,26160044,63105693
20885,368,$IDVL3,2013-03-31,36945649,26160044,63105693
20885,368,$IDVL3,2013-06-30,36945649,26160044,63105693
20885,368,$IDVL3,2013-09-30,44410897,31021907,75432804
20885,368,$IDVL3,2013-12-31,44410897,31021907,75432804
20885,368,$IDVL3,2014-03-31,58513218,31021907,89535125
20885,368,$IDVL3,2014-06-30,58513218,31021907,89535125
20885,368,$IDVL3,2014-09-30,58513218,31021907,89535125
20885,368,$IDVL3,2014-12-31,58513218,31021907,89535125
20885,368,$IDVL3,2015-03-31,58513218,31021907,89535125
20885,368,$IDVL3,2015-06-30,58513218,31021907,89535125
20885,368,$IDVL3,2015-09-30,58513218,31021907,89535125
20885,368,$IDVL3,2015-12-31,115033148,37494103,152527251
20885,368,$IDVL3,2016-03-31,115033148,37494103,152527251
20885,368,$IDVL3,2016-06-30,115033148,37494103,152527251
20885,368,$IDVL3,2016-09-30,115033148,37494103,152527251
20885,368,$IDVL3,2016-12-31,115033148,37494103,152527251
20885,368,$IDVL3,2017-03-31,115033148,37494103,152527251
20885,368,$IDVL3,2017-06-30,115033148,37494103,152527251
20885,368,$IDVL3,2017-09-30,115033148,37494103,152527251
20885,368,$IDVL3,2017-12-31,115033148,37494103,152527251
20885,368,$IDVL3,2018-03-31,115033148,37494103,152527251
20885,368,$IDVL3,2018-06-30,115033148,37494103,152527251
20885,368,$IDVL3,2018-09-30,115033148,37494103,152527251
20885,368,$IDVL3,2018-12-31,115033148,37494103,152527251
20885,368,$IDVL3,2019-03-31,11503315,3749410,15252725
20885,368,$IDVL3,2019-06-30,83049425,3749410,86798835
20885,368,$IDVL3,2019-09-30,83049425,3749410,86798835
20885,368,$IDVL3,2019-12-31,83049425,3749410,86798835
20885,368,$IDVL3,2020-03-31,83049425,3749410,86798835
20885,368,$IDVL3,2020-06-30,99072523,3749410,102821933
20885,368,$IDVL3,2020-09-30,99072523,3749410,102821933
20885,369,$IDVL4,2010-12-31,27000000,14212984,41212984
20885,369,$IDVL4,2011-03-31,27000000,14212984,41212984
20885,369,$IDVL4,2011-06-30,27000000,14212984,41212984
20885,369,$IDVL4,2011-09-30,36945649,26160044,63105693
20885,369,$IDVL4,2011-12-31,36945649,26160044,63105693
20885,369,$IDVL4,2012-03-31,36945649,26160044,63105693
20885,369,$IDVL4,2012-06-30,36945649,26160044,63105693
20885,369,$IDVL4,2012-09-30,36945649,26160044,63105693
20885,369,$IDVL4,2012-12-31,36945649,26160044,63105693
20885,369,$IDVL4,2013-03-31,36945649,26160044,63105693
20885,369,$IDVL4,2013-06-30,36945649,26160044,63105693
20885,369,$IDVL4,2013-09-30,44410897,31021907,75432804
20885,369,$IDVL4,2013-12-31,44410897,31021907,75432804
20885,369,$IDVL4,2014-03-31,58513218,31021907,89535125
20885,369,$IDVL4,2014-06-30,58513218,31021907,89535125
20885,369,$IDVL4,2014-09-30,58513218,31021907,89535125
20885,369,$IDVL4,2014-12-31,58513218,31021907,89535125
20885,369,$IDVL4,2015-03-31,58513218,31021907,89535125
20885,369,$IDVL4,2015-06-30,58513218,31021907,89535125
20885,369,$IDVL4,2015-09-30,58513218,31021907,89535125
20885,369,$IDVL4,2015-12-31,115033148,37494103,152527251
20885,369,$IDVL4,2016-03-31,115033148,37494103,152527251
20885,369,$IDVL4,2016-06-30,115033148,37494103,152527251
20885,369,$IDVL4,2016-09-30,115033148,37494103,152527251
20885,369,$IDVL4,2016-12-31,115033148,37494103,152527251
20885,369,$IDVL4,2017-03-31,115033148,37494103,152527251
20885,369,$IDVL4,2017-06-30,115033148,37494103,152527251
20885,369,$IDVL4,2017-09-30,115033148,37494103,152527251
20885,369,$IDVL4,2017-12-31,115033148,37494103,152527251
20885,369,$IDVL4,2018-03-31,115033148,37494103,152527251
20885,369,$IDVL4,2018-06-30,115033148,37494103,152527251
20885,369,$IDVL4,2018-09-30,115033148,37494103,152527251
20885,369,$IDVL4,2018-12-31,115033148,37494103,152527251
20885,369,$IDVL4,2019-03-31,11503315,3749410,15252725
20885,369,$IDVL4,2019-06-30,83049425,3749410,86798835
20885,369,$IDVL4,2019-09-30,83049425,3749410,86798835
20885,369,$IDVL4,2019-12-31,83049425,3749410,86798835
20885,369,$IDVL4,2020-03-31,83049425,3749410,86798835
20885,369,$IDVL4,2020-06-30,99072523,3749410,102821933
20885,369,$IDVL4,2020-09-30,99072523,3749410,102821933
20915,376,$MRVE3,2010-12-31,482435,0,482435
20915,376,$MRVE3,2011-03-31,482435,0,482435
20915,376,$MRVE3,2011-06-30,482700,0,482700
20915,376,$MRVE3,2011-09-30,482709,0,482709
20915,376,$MRVE3,2011-12-31,482710,0,482710
20915,376,$MRVE3,2012-03-31,482744,0,482744
20915,376,$MRVE3,2012-06-30,482744,0,482744
20915,376,$MRVE3,2012-09-30,482744,0,482744
20915,376,$MRVE3,2012-12-31,482744,0,482744
20915,376,$MRVE3,2013-03-31,482880,0,482880
20915,376,$MRVE3,2013-06-30,483102,0,483102
20915,376,$MRVE3,2013-09-30,483102,0,483102
20915,376,$MRVE3,2013-12-31,483102,0,483102
20915,376,$MRVE3,2014-03-31,477221,0,477221
20915,376,$MRVE3,2014-06-30,463139,0,463139
20915,376,$MRVE3,2014-09-30,463139,0,463139
20915,376,$MRVE3,2014-12-31,449139,0,449139
20915,376,$MRVE3,2015-03-31,449139,0,449139
20915,376,$MRVE3,2015-06-30,449139,0,449139
20915,376,$MRVE3,2015-09-30,449139,0,449139
20915,376,$MRVE3,2015-12-31,444139,0,444139
20915,376,$MRVE3,2016-03-31,444139,0,444139
20915,376,$MRVE3,2016-06-30,444139,0,444139
20915,376,$MRVE3,2016-09-30,444139,0,444139
20915,376,$MRVE3,2016-12-31,444139,0,444139
20915,376,$MRVE3,2017-03-31,444139,0,444139
20915,376,$MRVE3,2017-06-30,444139,0,444139
20915,376,$MRVE3,2017-09-30,444139,0,444139
20915,376,$MRVE3,2017-12-31,444139,0,444139
20915,376,$MRVE3,2018-03-31,444139,0,444139
20915,376,$MRVE3,2018-06-30,444139,0,444139
20915,376,$MRVE3,2018-09-30,444139,0,444139
20915,376,$MRVE3,2018-12-31,444139,0,444139
20915,376,$MRVE3,2019-03-31,444139,0,444139
20915,376,$MRVE3,2019-06-30,444139,0,444139
20915,376,$MRVE3,2019-09-30,444139,0,444139
20915,376,$MRVE3,2019-12-31,444139,0,444139
20915,376,$MRVE3,2020-03-31,481954,0,481954
20915,376,$MRVE3,2020-06-30,481954,0,481954
20915,376,$MRVE3,2020-09-30,481954,0,481954
20931,382,$BEEF3,2010-12-31,105793418,0,105793418
20931,382,$BEEF3,2011-03-31,105794018,0,105794018
20931,382,$BEEF3,2011-06-30,105794018,0,105794018
20931,382,$BEEF3,2011-09-30,105843818,0,105843818
20931,382,$BEEF3,2011-09-30,105843818,0,105843818
20931,382,$BEEF3,2011-12-31,105909718,0,105909718
20931,382,$BEEF3,2012-03-31,106650412,0,106650412
20931,382,$BEEF3,2012-06-30,105680310,0,105680310
20931,382,$BEEF3,2012-09-30,108807556,0,108807556
20931,382,$BEEF3,2012-12-31,146307556,0,146307556
20931,382,$BEEF3,2013-03-31,146575057,0,146575057
20931,382,$BEEF3,2013-06-30,146575057,0,146575057
20931,382,$BEEF3,2013-09-30,141344525,0,141344525
20931,382,$BEEF3,2013-12-31,145056023,0,145056023
20931,382,$BEEF3,2014-03-31,149000090,0,149000090
20931,382,$BEEF3,2014-06-30,149000090,0,149000090
20931,382,$BEEF3,2014-09-30,149000000,0,149000000
20931,382,$BEEF3,2014-09-30,149000000,0,149000000
20931,382,$BEEF3,2014-12-31,178000090,0,178000090
20931,382,$BEEF3,2014-12-31,178000090,0,178000090
20931,382,$BEEF3,2015-03-31,178002062,0,178002062
20931,382,$BEEF3,2015-06-30,191993702,0,191993702
20931,382,$BEEF3,2015-09-30,191993702,0,191993702
20931,382,$BEEF3,2015-12-31,191993702,0,191993702
20931,382,$BEEF3,2016-03-31,191993702,0,191993702
20931,382,$BEEF3,2016-03-31,191993702,0,191993702
20931,382,$BEEF3,2016-06-30,239844659,0,239844659
20931,382,$BEEF3,2016-09-30,239844659,0,239844659
20931,382,$BEEF3,2016-12-31,239844659,0,239844659
20931,382,$BEEF3,2016-12-31,239844659,0,239844659
20931,382,$BEEF3,2017-03-31,229860259,0,229860259
20931,382,$BEEF3,2017-03-31,229860259,0,229860259
20931,382,$BEEF3,2017-06-30,229860259,0,229860259
20931,382,$BEEF3,2017-09-30,229860259,0,229860259
20931,382,$BEEF3,2017-12-31,229860259,0,229860259
20931,382,$BEEF3,2018-03-31,223618459,0,223618459
20931,382,$BEEF3,2018-03-31,223618459,0,223618459
20931,382,$BEEF3,2018-06-30,223618459,0,223618459
20931,382,$BEEF3,2018-06-30,223618459,0,223618459
20931,382,$BEEF3,2018-09-30,226418459,0,226418459
20931,382,$BEEF3,2018-12-31,376687157,0,376687157
20931,382,$BEEF3,2019-03-31,376687410,0,376687410
20931,382,$BEEF3,2019-06-30,376729949,0,376729949
20931,382,$BEEF3,2019-09-30,376795131,0,376795131
20931,382,$BEEF3,2019-12-31,403596575,0,403596575
20931,382,$BEEF3,2020-03-31,485580177,0,485580177
20931,382,$BEEF3,2020-06-30,486478283,0,486478283
20931,382,$BEEF3,2020-09-30,548413533,0,548413533
20958,371,$ABCB4,2010-12-31,67822120,67822120,135644240
20958,371,$ABCB4,2011-03-31,67822120,67822120,135644240
20958,371,$ABCB4,2011-06-30,67822120,67822120,135644240
20958,371,$ABCB4,2011-09-30,67822120,67822120,135644240
20958,371,$ABCB4,2011-12-31,67822120,67822120,135644240
20958,371,$ABCB4,2012-03-31,67822120,67822120,135644240
20958,371,$ABCB4,2012-06-30,67822120,67822120,135644240
20958,371,$ABCB4,2012-09-30,70237948,70174452,140412400
20958,371,$ABCB4,2012-12-31,70237948,70174452,140412400
20958,371,$ABCB4,2013-03-31,71978166,71868932,143847098
20958,371,$ABCB4,2013-06-30,71978166,71868932,143847098
20958,371,$ABCB4,2013-09-30,73697646,73535003,147232649
20958,371,$ABCB4,2013-12-31,73697646,73535003,147232649
20958,371,$ABCB4,2014-03-31,75648913,75394106,151043019
20958,371,$ABCB4,2014-06-30,75648913,75394106,151043019
20958,371,$ABCB4,2014-09-30,77571835,77195646,154767481
20958,371,$ABCB4,2014-12-31,77571835,77195646,154767481
20958,371,$ABCB4,2015-03-31,79715509,79211404,158926913
20958,371,$ABCB4,2015-06-30,79715509,79211404,158926913
20958,371,$ABCB4,2015-09-30,82796043,82095379,164891422
20958,371,$ABCB4,2015-12-31,82796043,82095379,164891422
20958,371,$ABCB4,2016-03-31,87515454,86482563,173998017
20958,371,$ABCB4,2016-06-30,87515454,86482563,173998017
20958,371,$ABCB4,2016-09-30,91773827,90450702,182224529
20958,371,$ABCB4,2016-12-31,91773827,90450702,182224529
20958,371,$ABCB4,2017-03-31,95780135,94207966,189988101
20958,371,$ABCB4,2017-06-30,95780135,94207966,189988101
20958,371,$ABCB4,2017-09-30,99152654,97402193,196554847
20958,371,$ABCB4,2017-12-31,99152654,97402193,196554847
20958,371,$ABCB4,2018-03-31,102749196,100820048,203569244
20958,371,$ABCB4,2018-06-30,102749196,100820048,203569244
20958,371,$ABCB4,2018-09-30,106634935,104498015,211132950
20958,371,$ABCB4,2018-12-31,106634935,104498015,211132950
20958,371,$ABCB4,2019-03-31,109496432,108862625,218359057
20958,371,$ABCB4,2019-06-30,109496432,108862625,218359057
20958,371,$ABCB4,2019-09-30,109496432,108862625,218359057
20958,371,$ABCB4,2019-12-31,109496432,108862625,218359057
20958,371,$ABCB4,2020-03-31,109496432,108862625,218359057
20958,371,$ABCB4,2020-06-30,109496432,108862625,218359057
20958,371,$ABCB4,2020-09-30,109496432,108862625,218359057
20966,374,$SGPS3,2010-12-31,143647,0,143647
20966,374,$SGPS3,2011-03-31,143637,0,143637
20966,374,$SGPS3,2011-06-30,143637,0,143637
20966,374,$SGPS3,2011-09-30,143637,0,143637
20966,374,$SGPS3,2011-12-31,143647,0,143647
20966,374,$SGPS3,2012-03-31,143647,0,143647
20966,374,$SGPS3,2012-06-30,143647,0,143647
20966,374,$SGPS3,2012-09-30,143647,0,143647
20966,374,$SGPS3,2012-12-31,200000,0,200000
20966,374,$SGPS3,2013-03-31,200000,0,200000
20966,374,$SGPS3,2013-06-30,200000,0,200000
20966,374,$SGPS3,2013-09-30,200000,0,200000
20966,374,$SGPS3,2013-12-31,200000,0,200000
20966,374,$SGPS3,2014-03-31,200000,0,200000
20966,374,$SGPS3,2014-06-30,200000,0,200000
20966,374,$SGPS3,2014-09-30,200000,0,200000
20966,374,$SGPS3,2014-12-31,200000,0,200000
20966,374,$SGPS3,2015-03-31,200000,0,200000
20966,374,$SGPS3,2015-06-30,200000,0,200000
20966,374,$SGPS3,2015-09-30,200000,0,200000
20966,374,$SGPS3,2015-12-31,50000,0,50000
20966,374,$SGPS3,2016-03-31,50000,0,50000
20966,374,$SGPS3,2016-06-30,50000,0,50000
20966,374,$SGPS3,2016-09-30,50000,0,50000
20966,374,$SGPS3,2016-12-31,50000,0,50000
20966,374,$SGPS3,2017-03-31,50000,0,50000
20966,374,$SGPS3,2017-06-30,50000,0,50000
20966,374,$SGPS3,2017-09-30,50000,0,50000
20966,374,$SGPS3,2017-12-31,50000,0,50000
20966,374,$SGPS3,2018-03-31,50000,0,50000
20966,374,$SGPS3,2018-06-30,50000,0,50000
20966,374,$SGPS3,2018-09-30,50000,0,50000
20966,374,$SGPS3,2018-12-31,50000,0,50000
20966,374,$SGPS3,2019-03-31,50000,0,50000
20966,374,$SGPS3,2019-06-30,50000,0,50000
20966,374,$SGPS3,2019-09-30,50000,0,50000
20966,374,$SGPS3,2019-12-31,50000,0,50000
20966,374,$SGPS3,2020-03-31,50000,0,50000
20966,374,$SGPS3,2020-06-30,50000,0,50000
20966,374,$SGPS3,2020-09-30,50000,0,50000
20982,379,$MULT3,2010-12-31,167338867,11858347,179197214
20982,379,$MULT3,2011-03-31,167338867,11858347,179197214
20982,379,$MULT3,2011-06-30,167338867,11858347,179197214
20982,379,$MULT3,2011-09-30,167338867,11858347,179197214
20982,379,$MULT3,2011-12-31,167338867,11858347,179197214
20982,379,$MULT3,2012-03-31,167338867,11858347,179197214
20982,379,$MULT3,2012-06-30,167338867,11858347,179197214
20982,379,$MULT3,2012-09-30,167338867,11858347,179197214
20982,379,$MULT3,2012-12-31,167338867,11858347,179197214
20982,379,$MULT3,2013-03-31,167338867,11858347,179197214
20982,379,$MULT3,2013-06-30,178138867,11858347,189997214
20982,379,$MULT3,2013-09-30,178138867,11858347,189997214
20982,379,$MULT3,2013-12-31,178138867,11858347,189997214
20982,379,$MULT3,2014-03-31,178138867,11858347,189997214
20982,379,$MULT3,2014-06-30,178138867,11858347,189997214
20982,379,$MULT3,2014-09-30,178138867,11858347,189997214
20982,379,$MULT3,2014-12-31,178138867,11858347,189997214
20982,379,$MULT3,2015-03-31,178138867,11858347,189997214
20982,379,$MULT3,2015-06-30,178138867,11858347,189997214
20982,379,$MULT3,2015-09-30,178138867,11858347,189997214
20982,379,$MULT3,2015-12-31,178138867,11858347,189997214
20982,379,$MULT3,2016-03-31,178138867,11858347,189997214
20982,379,$MULT3,2016-06-30,178138867,11858347,189997214
20982,379,$MULT3,2016-09-30,178138867,11858347,189997214
20982,379,$MULT3,2016-12-31,178138867,11858347,189997214
20982,379,$MULT3,2017-03-31,188395278,11858347,200253625
20982,379,$MULT3,2017-06-30,188395278,11858347,200253625
20982,379,$MULT3,2017-09-30,188395278,11858347,200253625
20982,379,$MULT3,2017-12-31,188395278,11858347,200253625
20982,379,$MULT3,2018-03-31,188395278,11858347,200253625
20982,379,$MULT3,2018-06-30,188395278,11858347,200253625
20982,379,$MULT3,2018-09-30,565185834,35575041,600760875
20982,379,$MULT3,2018-12-31,565185834,35575041,600760875
20982,379,$MULT3,2019-03-31,565185834,35575041,600760875
20982,379,$MULT3,2019-06-30,565185834,35575041,600760875
20982,379,$MULT3,2019-09-30,565185834,35575041,600760875
20982,379,$MULT3,2019-12-31,565185834,35575041,600760875
20982,379,$MULT3,2020-03-31,565185834,35575041,600760875
20982,379,$MULT3,2020-06-30,565185834,35575041,600760875
20982,379,$MULT3,2020-09-30,565185834,35575041,600760875
20990,380,$BTOW3,2010-12-31,113562867,0,113562867
20990,380,$BTOW3,2011-03-31,113562867,0,113562867
20990,380,$BTOW3,2011-06-30,159816337,0,159816337
20990,380,$BTOW3,2011-09-30,159816337,0,159816337
20990,380,$BTOW3,2011-12-31,159816337,0,159816337
20990,380,$BTOW3,2012-03-31,156536355,0,156536355
20990,380,$BTOW3,2012-06-30,156536355,0,156536355
20990,380,$BTOW3,2012-09-30,156536355,0,156536355
20990,380,$BTOW3,2012-12-31,156536355,0,156536355
20990,380,$BTOW3,2013-03-31,156536355,0,156536355
20990,380,$BTOW3,2013-06-30,156536355,0,156536355
20990,380,$BTOW3,2013-09-30,158175707,0,158175707
20990,380,$BTOW3,2013-12-31,158999202,0,158999202
20990,380,$BTOW3,2014-03-31,158999202,0,158999202
20990,380,$BTOW3,2014-06-30,158999202,0,158999202
20990,380,$BTOW3,2014-09-30,255278825,0,255278825
20990,380,$BTOW3,2014-12-31,255484410,0,255484410
20990,380,$BTOW3,2015-03-31,255484410,0,255484410
20990,380,$BTOW3,2015-06-30,256581347,0,256581347
20990,380,$BTOW3,2015-09-30,257148812,0,257148812
20990,380,$BTOW3,2015-12-31,257318364,0,257318364
20990,380,$BTOW3,2016-03-31,257318364,0,257318364
20990,380,$BTOW3,2016-06-30,257318364,0,257318364
20990,380,$BTOW3,2016-09-30,341794262,0,341794262
20990,380,$BTOW3,2016-12-31,342463558,0,342463558
20990,380,$BTOW3,2017-03-31,342463558,0,342463558
20990,380,$BTOW3,2017-06-30,452463558,0,452463558
20990,380,$BTOW3,2017-09-30,453527272,0,453527272
20990,380,$BTOW3,2017-12-31,453723681,0,453723681
20990,380,$BTOW3,2018-03-31,453723681,0,453723681
20990,380,$BTOW3,2018-06-30,453723681,0,453723681
20990,380,$BTOW3,2018-09-30,456836739,0,456836739
20990,380,$BTOW3,2018-12-31,457280804,0,457280804
20990,380,$BTOW3,2019-03-31,457280804,0,457280804
20990,380,$BTOW3,2019-06-30,457280804,0,457280804
20990,380,$BTOW3,2019-09-30,458758661,0,458758661
20990,380,$BTOW3,2019-12-31,523229262,0,523229262
20990,380,$BTOW3,2020-03-31,523229262,0,523229262
20990,380,$BTOW3,2020-06-30,524654065,0,524654065
20990,380,$BTOW3,2020-09-30,559632528,0,559632528
21008,377,$GSHP3,2010-12-31,50480600,0,50480600
21008,377,$GSHP3,2011-03-31,50480600,0,50480600
21008,377,$GSHP3,2011-06-30,50480600,0,50480600
21008,377,$GSHP3,2011-09-30,50480600,0,50480600
21008,377,$GSHP3,2011-12-31,50480600,0,50480600
21008,377,$GSHP3,2012-03-31,50480600,0,50480600
21008,377,$GSHP3,2012-06-30,50480600,0,50480600
21008,377,$GSHP3,2012-09-30,50480600,0,50480600
21008,377,$GSHP3,2012-12-31,50480600,0,50480600
21008,377,$GSHP3,2013-03-31,50480600,0,50480600
21008,377,$GSHP3,2013-06-30,50480600,0,50480600
21008,377,$GSHP3,2013-09-30,50480600,0,50480600
21008,377,$GSHP3,2013-12-31,50480600,0,50480600
21008,377,$GSHP3,2014-03-31,50480600,0,50480600
21008,377,$GSHP3,2014-06-30,50480600,0,50480600
21008,377,$GSHP3,2014-09-30,50480600,0,50480600
21008,377,$GSHP3,2014-12-31,50480600,0,50480600
21008,377,$GSHP3,2015-03-31,50480600,0,50480600
21008,377,$GSHP3,2015-06-30,50480600,0,50480600
21008,377,$GSHP3,2015-09-30,50480600,0,50480600
21008,377,$GSHP3,2015-12-31,65000000,0,65000000
21008,377,$GSHP3,2016-03-31,65000000,0,65000000
21008,377,$GSHP3,2016-06-30,65000000,0,65000000
21008,377,$GSHP3,2016-09-30,76000000,0,76000000
21008,377,$GSHP3,2016-12-31,76000000,0,76000000
21008,377,$GSHP3,2017-03-31,76000000,0,76000000
21008,377,$GSHP3,2017-06-30,76000000,0,76000000
21008,377,$GSHP3,2017-09-30,69435699,0,69435699
21008,377,$GSHP3,2017-12-31,69435699,0,69435699
21008,377,$GSHP3,2018-03-31,69435699,0,69435699
21008,377,$GSHP3,2018-06-30,69435699,0,69435699
21008,377,$GSHP3,2018-09-30,69435699,0,69435699
21008,377,$GSHP3,2018-12-31,69435699,0,69435699
21008,377,$GSHP3,2019-03-31,69435699,0,69435699
21008,377,$GSHP3,2019-06-30,69435699,0,69435699
21008,377,$GSHP3,2019-09-30,69435699,0,69435699
21008,377,$GSHP3,2019-12-31,69435699,0,69435699
21008,377,$GSHP3,2020-03-31,1928769,0,1928769
21008,377,$GSHP3,2020-06-30,1928769,0,1928769
21008,377,$GSHP3,2020-09-30,1928769,0,1928769
21016,386,$ESTC3,2010-12-31,82038041,0,82038041
21016,386,$ESTC3,2011-03-31,82038041,0,82038041
21016,386,$ESTC3,2011-06-30,82251937,0,82251937
21016,386,$ESTC3,2011-09-30,82019,0,82019
21016,386,$ESTC3,2011-12-31,82252,0,82252
21016,386,$ESTC3,2012-03-31,82251937,0,82251937
21016,386,$ESTC3,2012-06-30,82434559,0,82434559
21016,386,$ESTC3,2012-09-30,82215,0,82215
21016,386,$ESTC3,2012-12-31,82505,0,82505
21016,386,$ESTC3,2013-03-31,97192,0,97192
21016,386,$ESTC3,2013-06-30,293698,0,293698
21016,386,$ESTC3,2013-09-30,295096,0,295096
21016,386,$ESTC3,2013-12-31,293415,0,293415
21016,386,$ESTC3,2014-03-31,293415,0,293415
21016,386,$ESTC3,2014-06-30,295598,0,295598
21016,386,$ESTC3,2014-09-30,313633,0,313633
21016,386,$ESTC3,2014-12-31,313077,0,313077
21016,386,$ESTC3,2015-03-31,307324,0,307324
21016,386,$ESTC3,2015-06-30,308778,0,308778
21016,386,$ESTC3,2015-09-30,308816,0,308816
21016,386,$ESTC3,2015-12-31,307788,0,307788
21016,386,$ESTC3,2016-03-31,307348,0,307348
21016,386,$ESTC3,2016-06-30,317178,0,317178
21016,386,$ESTC3,2016-09-30,317896,0,317896
21016,386,$ESTC3,2016-12-31,308398360,0,308398360
21016,386,$ESTC3,2017-03-31,317896,0,317896
21016,386,$ESTC3,2017-06-30,309206,0,309206
21016,386,$ESTC3,2017-09-30,309217,0,309217
21016,386,$ESTC3,2017-12-31,309434,0,309434
21016,386,$ESTC3,2018-03-31,317896,0,317896
21016,386,$ESTC3,2018-06-30,309089,0,309089
21016,386,$ESTC3,2018-09-30,309089,0,309089
21016,386,$ESTC3,2018-12-31,309089,0,309089
21016,386,$ESTC3,2019-03-31,309089,0,309089
21016,386,$ESTC3,2019-06-30,309089,0,309089
21016,386,$ESTC3,2019-09-30,309089,0,309089
21016,386,$ESTC3,2019-12-31,309089,0,309089
21016,386,$ESTC3,2020-03-31,309089,0,309089
21016,386,$ESTC3,2020-06-30,309089,0,309089
21016,386,$ESTC3,2020-09-30,309089,0,309089
21016,389,$YDUQ3,2010-12-31,82038041,0,82038041
21016,389,$YDUQ3,2011-03-31,82038041,0,82038041
21016,389,$YDUQ3,2011-06-30,82251937,0,82251937
21016,389,$YDUQ3,2011-09-30,82019,0,82019
21016,389,$YDUQ3,2011-12-31,82252,0,82252
21016,389,$YDUQ3,2012-03-31,82251937,0,82251937
21016,389,$YDUQ3,2012-06-30,82434559,0,82434559
21016,389,$YDUQ3,2012-09-30,82215,0,82215
21016,389,$YDUQ3,2012-12-31,82505,0,82505
21016,389,$YDUQ3,2013-03-31,97192,0,97192
21016,389,$YDUQ3,2013-06-30,293698,0,293698
21016,389,$YDUQ3,2013-09-30,295096,0,295096
21016,389,$YDUQ3,2013-12-31,293415,0,293415
21016,389,$YDUQ3,2014-03-31,293415,0,293415
21016,389,$YDUQ3,2014-06-30,295598,0,295598
21016,389,$YDUQ3,2014-09-30,313633,0,313633
21016,389,$YDUQ3,2014-12-31,313077,0,313077
21016,389,$YDUQ3,2015-03-31,307324,0,307324
21016,389,$YDUQ3,2015-06-30,308778,0,308778
21016,389,$YDUQ3,2015-09-30,308816,0,308816
21016,389,$YDUQ3,2015-12-31,307788,0,307788
21016,389,$YDUQ3,2016-03-31,307348,0,307348
21016,389,$YDUQ3,2016-06-30,317178,0,317178
21016,389,$YDUQ3,2016-09-30,317896,0,317896
21016,389,$YDUQ3,2016-12-31,308398360,0,308398360
21016,389,$YDUQ3,2017-03-31,317896,0,317896
21016,389,$YDUQ3,2017-06-30,309206,0,309206
21016,389,$YDUQ3,2017-09-30,309217,0,309217
21016,389,$YDUQ3,2017-12-31,309434,0,309434
21016,389,$YDUQ3,2018-03-31,317896,0,317896
21016,389,$YDUQ3,2018-06-30,309089,0,309089
21016,389,$YDUQ3,2018-09-30,309089,0,309089
21016,389,$YDUQ3,2018-12-31,309089,0,309089
21016,389,$YDUQ3,2019-03-31,309089,0,309089
21016,389,$YDUQ3,2019-06-30,309089,0,309089
21016,389,$YDUQ3,2019-09-30,309089,0,309089
21016,389,$YDUQ3,2019-12-31,309089,0,309089
21016,389,$YDUQ3,2020-03-31,309089,0,309089
21016,389,$YDUQ3,2020-06-30,309089,0,309089
21016,389,$YDUQ3,2020-09-30,309089,0,309089
21040,381,$CCPR3,2010-12-31,86500,0,86500
21040,381,$CCPR3,2011-03-31,86500,0,86500
21040,381,$CCPR3,2011-06-30,86500,0,86500
21040,381,$CCPR3,2011-09-30,86500,0,86500
21040,381,$CCPR3,2011-12-31,86500,0,86500
21040,381,$CCPR3,2012-03-31,83000,0,83000
21040,381,$CCPR3,2012-06-30,83000,0,83000
21040,381,$CCPR3,2012-09-30,83000,0,83000
21040,381,$CCPR3,2012-12-31,83000,0,83000
21040,381,$CCPR3,2013-03-31,83000,0,83000
21040,381,$CCPR3,2013-06-30,83000,0,83000
21040,381,$CCPR3,2013-09-30,83000,0,83000
21040,381,$CCPR3,2013-12-31,83000,0,83000
21040,381,$CCPR3,2014-03-31,83000,0,83000
21040,381,$CCPR3,2014-06-30,83000,0,83000
21040,381,$CCPR3,2014-09-30,83000,0,83000
21040,381,$CCPR3,2014-12-31,83000,0,83000
21040,381,$CCPR3,2015-03-31,83000,0,83000
21040,381,$CCPR3,2015-06-30,83000,0,83000
21040,381,$CCPR3,2015-09-30,83000,0,83000
21040,381,$CCPR3,2015-12-31,119664,0,119664
21040,381,$CCPR3,2016-03-31,119664,0,119664
21040,381,$CCPR3,2016-06-30,119664,0,119664
21040,381,$CCPR3,2016-09-30,119664,0,119664
21040,381,$CCPR3,2016-12-31,119664,0,119664
21040,381,$CCPR3,2017-03-31,119664,0,119664
21040,381,$CCPR3,2017-06-30,119664,0,119664
21040,381,$CCPR3,2017-09-30,119664,0,119664
21040,381,$CCPR3,2017-12-31,119664,0,119664
21040,381,$CCPR3,2018-03-31,119664,0,119664
21040,381,$CCPR3,2018-06-30,119664,0,119664
21040,381,$CCPR3,2018-09-30,119664,0,119664
21040,381,$CCPR3,2018-12-31,119664,0,119664
21040,381,$CCPR3,2019-03-31,119664,0,119664
21040,381,$CCPR3,2019-06-30,119664,0,119664
21040,381,$CCPR3,2019-09-30,119664,0,119664
21040,381,$CCPR3,2019-12-31,165113,0,165113
21040,381,$CCPR3,2020-03-31,165114,0,165114
21040,381,$CCPR3,2020-06-30,165114,0,165114
21040,381,$CCPR3,2020-09-30,158582,0,158582
21067,483,$MDNE3,2010-12-31,78993,0,78993
21067,483,$MDNE3,2011-03-31,78993,0,78993
21067,483,$MDNE3,2011-06-30,78993,0,78993
21067,483,$MDNE3,2011-09-30,355075,0,355075
21067,483,$MDNE3,2011-12-31,355075,0,355075
21067,483,$MDNE3,2012-03-31,355075,0,355075
21067,483,$MDNE3,2012-06-30,355076,0,355076
21067,483,$MDNE3,2012-09-30,355076,0,355076
21067,483,$MDNE3,2012-12-31,355076,0,355076
21067,483,$MDNE3,2013-03-31,355076,0,355076
21067,483,$MDNE3,2013-06-30,355076,0,355076
21067,483,$MDNE3,2013-09-30,355076,0,355076
21067,483,$MDNE3,2013-12-31,355076,0,355076
21067,483,$MDNE3,2014-03-31,377918,0,377918
21067,483,$MDNE3,2014-06-30,377918,0,377918
21067,483,$MDNE3,2014-09-30,377918,0,377918
21067,483,$MDNE3,2014-12-31,377918,0,377918
21067,483,$MDNE3,2015-03-31,377918,0,377918
21067,483,$MDNE3,2015-06-30,377918,0,377918
21067,483,$MDNE3,2015-09-30,377918,0,377918
21067,483,$MDNE3,2015-12-31,377918,0,377918
21067,483,$MDNE3,2016-03-31,377918,0,377918
21067,483,$MDNE3,2016-06-30,377918,0,377918
21067,483,$MDNE3,2016-09-30,377918,0,377918
21067,483,$MDNE3,2016-12-31,401377,0,401377
21067,483,$MDNE3,2017-03-31,401377,0,401377
21067,483,$MDNE3,2017-06-30,401377,0,401377
21067,483,$MDNE3,2017-09-30,401377,0,401377
21067,483,$MDNE3,2017-12-31,401377,0,401377
21067,483,$MDNE3,2018-03-31,401377,0,401377
21067,483,$MDNE3,2018-06-30,401377,0,401377
21067,483,$MDNE3,2018-09-30,401377,0,401377
21067,483,$MDNE3,2018-12-31,401377,0,401377
21067,483,$MDNE3,2019-03-31,401377,0,401377
21067,483,$MDNE3,2019-06-30,401377,0,401377
21067,483,$MDNE3,2019-09-30,401377,0,401377
21067,483,$MDNE3,2019-12-31,26758480,0,26758480
21067,483,$MDNE3,2020-03-31,84909375,0,84909375
21067,483,$MDNE3,2020-06-30,84909375,0,84909375
21067,483,$MDNE3,2020-09-30,84909375,0,84909375
21091,383,$DTEX3,2010-12-31,458362776,0,458362776
21091,383,$DTEX3,2011-03-31,458363,0,458363
21091,383,$DTEX3,2011-06-30,550035,0,550035
21091,383,$DTEX3,2011-09-30,550035,0,550035
21091,383,$DTEX3,2011-12-31,550035,0,550035
21091,383,$DTEX3,2012-03-31,550035,0,550035
21091,383,$DTEX3,2012-06-30,550038,0,550038
21091,383,$DTEX3,2012-09-30,550054,0,550054
21091,383,$DTEX3,2012-12-31,550054,0,550054
21091,383,$DTEX3,2013-03-31,550054,0,550054
21091,383,$DTEX3,2013-06-30,605059,0,605059
21091,383,$DTEX3,2013-09-30,605059,0,605059
21091,383,$DTEX3,2013-12-31,605059,0,605059
21091,383,$DTEX3,2014-03-31,605059,0,605059
21091,383,$DTEX3,2014-06-30,665565,0,665565
21091,383,$DTEX3,2014-09-30,665565,0,665565
21091,383,$DTEX3,2014-12-31,665565,0,665565
21091,383,$DTEX3,2015-03-31,665565,0,665565
21091,383,$DTEX3,2015-06-30,665565,0,665565
21091,383,$DTEX3,2015-09-30,665565,0,665565
21091,383,$DTEX3,2015-12-31,665565,0,665565
21091,383,$DTEX3,2016-03-31,665565,0,665565
21091,383,$DTEX3,2016-06-30,691785,0,691785
21091,383,$DTEX3,2016-09-30,691785,0,691785
21091,383,$DTEX3,2016-12-31,691785,0,691785
21091,383,$DTEX3,2017-03-31,691785,0,691785
21091,383,$DTEX3,2017-06-30,691785,0,691785
21091,383,$DTEX3,2017-09-30,691785,0,691785
21091,383,$DTEX3,2017-12-31,691785,0,691785
21091,383,$DTEX3,2018-03-31,691785,0,691785
21091,383,$DTEX3,2018-06-30,691785,0,691785
21091,383,$DTEX3,2018-09-30,691785,0,691785
21091,383,$DTEX3,2018-12-31,691785,0,691785
21091,383,$DTEX3,2019-03-31,691785,0,691785
21091,383,$DTEX3,2019-06-30,691785,0,691785
21091,383,$DTEX3,2019-09-30,691785,0,691785
21091,383,$DTEX3,2019-12-31,691785,0,691785
21091,383,$DTEX3,2020-03-31,691785,0,691785
21091,383,$DTEX3,2020-06-30,691785,0,691785
21091,383,$DTEX3,2020-09-30,691785,0,691785
21130,384,$21130,2010-12-31,81799,0,81799
21130,384,$21130,2011-03-31,81799,0,81799
21130,384,$21130,2011-06-30,81799,0,81799
21130,384,$21130,2011-09-30,81799,0,81799
21130,384,$21130,2011-12-31,81799,0,81799
21130,384,$21130,2012-03-31,81799,0,81799
21130,384,$21130,2012-06-30,81799,0,81799
21130,384,$21130,2012-09-30,81799,0,81799
21130,384,$21130,2012-12-31,81799,0,81799
21130,384,$21130,2013-03-31,81799,0,81799
21130,384,$21130,2013-06-30,81799,0,81799
21130,384,$21130,2013-09-30,81799,0,81799
21130,384,$21130,2013-12-31,81799,0,81799
21130,384,$21130,2014-03-31,81799,0,81799
21130,384,$21130,2014-06-30,81799,0,81799
21130,384,$21130,2014-09-30,81799,0,81799
21130,384,$21130,2014-12-31,81799,0,81799
21130,384,$21130,2015-03-31,78759,0,78759
21130,384,$21130,2015-06-30,78759,0,78759
21130,384,$21130,2015-09-30,78759,0,78759
21130,384,$21130,2015-12-31,75758,0,75758
21130,384,$21130,2016-03-31,75759,0,75759
21130,384,$21130,2016-06-30,73059,0,73059
21130,384,$21130,2016-09-30,73059,0,73059
21130,384,$21130,2016-12-31,73059,0,73059
21130,384,$21130,2017-03-31,73059,0,73059
21130,384,$21130,2017-06-30,73059,0,73059
21130,384,$21130,2017-09-30,73059,0,73059
21130,384,$21130,2017-12-31,73059,0,73059
21130,384,$21130,2018-03-31,73059,0,73059
21130,384,$21130,2018-06-30,146118,0,146118
21130,384,$21130,2018-09-30,146118,0,146118
21130,384,$21130,2018-12-31,146118,0,146118
21130,384,$21130,2019-03-31,146118,0,146118
21130,384,$21130,2019-06-30,146118,0,146118
21130,384,$21130,2019-09-30,186618,0,186618
21130,384,$21130,2019-12-31,186618,0,186618
21130,384,$21130,2020-03-31,186617,0,186617
21130,384,$21130,2020-06-30,186617,0,186617
21130,384,$21130,2020-09-30,186617,0,186617
21148,385,$TEND3,2010-12-31,400652,0,400652
21148,385,$TEND3,2011-03-31,523276,0,523276
21148,385,$TEND3,2011-06-30,523276,0,523276
21148,385,$TEND3,2011-09-30,633058,0,633058
21148,385,$TEND3,2011-12-31,633058,0,633058
21148,385,$TEND3,2012-03-31,633058,0,633058
21148,385,$TEND3,2012-06-30,633058,0,633058
21148,385,$TEND3,2012-09-30,633058,0,633058
21148,385,$TEND3,2012-12-31,633137,0,633137
21148,385,$TEND3,2013-03-31,633137,0,633137
21148,385,$TEND3,2013-06-30,633137,0,633137
21148,385,$TEND3,2013-09-30,633137,0,633137
21148,385,$TEND3,2013-12-31,633037801,0,633037801
21148,385,$TEND3,2014-03-31,633037,0,633037
21148,385,$TEND3,2014-06-30,633037,0,633037
21148,385,$TEND3,2014-09-30,633037,0,633037
21148,385,$TEND3,2014-12-31,633037,0,633037
21148,385,$TEND3,2015-03-31,633037,0,633037
21148,385,$TEND3,2015-06-30,633037,0,633037
21148,385,$TEND3,2015-09-30,633037,0,633037
21148,385,$TEND3,2015-12-31,633037,0,633037
21148,385,$TEND3,2016-03-31,633037,0,633037
21148,385,$TEND3,2016-06-30,633037,0,633037
21148,385,$TEND3,2016-09-30,633037,0,633037
21148,385,$TEND3,2016-12-31,54000,0,54000
21148,385,$TEND3,2017-03-31,54000,0,54000
21148,385,$TEND3,2017-06-30,54000,0,54000
21148,385,$TEND3,2017-09-30,54000,0,54000
21148,385,$TEND3,2017-12-31,54035,0,54035
21148,385,$TEND3,2018-03-31,54035,0,54035
21148,385,$TEND3,2018-06-30,54035,0,54035
21148,385,$TEND3,2018-09-30,54172,0,54172
21148,385,$TEND3,2018-12-31,52081,0,52081
21148,385,$TEND3,2019-03-31,104344,0,104344
21148,385,$TEND3,2019-06-30,104344,0,104344
21148,385,$TEND3,2019-09-30,104344,0,104344
21148,385,$TEND3,2019-12-31,104344,0,104344
21148,385,$TEND3,2020-03-31,104344,0,104344
21148,385,$TEND3,2020-06-30,104344,0,104344
21148,385,$TEND3,2020-09-30,104344,0,104344
21180,388,$BBRK3,2010-12-31,168877,0,168877
21180,388,$BBRK3,2011-03-31,192840,0,192840
21180,388,$BBRK3,2011-06-30,192840,0,192840
21180,388,$BBRK3,2011-09-30,192840,0,192840
21180,388,$BBRK3,2011-12-31,179043,0,179043
21180,388,$BBRK3,2012-03-31,191024,0,191024
21180,388,$BBRK3,2012-06-30,191024,0,191024
21180,388,$BBRK3,2012-09-30,190814,0,190814
21180,388,$BBRK3,2012-12-31,190814,0,190814
21180,388,$BBRK3,2013-03-31,190814,0,190814
21180,388,$BBRK3,2013-06-30,190814,0,190814
21180,388,$BBRK3,2013-09-30,190814,0,190814
21180,388,$BBRK3,2013-12-31,190814,0,190814
21180,388,$BBRK3,2014-03-31,190840,0,190840
21180,388,$BBRK3,2014-06-30,190840,0,190840
21180,388,$BBRK3,2014-09-30,192840,0,192840
21180,388,$BBRK3,2014-12-31,192840,0,192840
21180,388,$BBRK3,2015-03-31,192840,0,192840
21180,388,$BBRK3,2015-06-30,192840,0,192840
21180,388,$BBRK3,2015-09-30,192840,0,192840
21180,388,$BBRK3,2015-12-31,192840,0,192840
21180,388,$BBRK3,2016-03-31,192840,0,192840
21180,388,$BBRK3,2016-06-30,192840,0,192840
21180,388,$BBRK3,2016-09-30,192840,0,192840
21180,388,$BBRK3,2016-12-31,192840,0,192840
21180,388,$BBRK3,2017-03-31,192840,0,192840
21180,388,$BBRK3,2017-06-30,192840,0,192840
21180,388,$BBRK3,2017-09-30,255903,0,255903
21180,388,$BBRK3,2017-12-31,255903,0,255903
21180,388,$BBRK3,2018-03-31,255903,0,255903
21180,388,$BBRK3,2018-06-30,255903,0,255903
21180,388,$BBRK3,2018-09-30,36278,0,36278
21180,388,$BBRK3,2018-12-31,36278,0,36278
21180,388,$BBRK3,2019-03-31,36278,0,36278
21180,388,$BBRK3,2019-06-30,36278,0,36278
21180,388,$BBRK3,2019-09-30,36278,0,36278
21180,388,$BBRK3,2019-12-31,36278,0,36278
21180,388,$BBRK3,2020-03-31,36278,0,36278
21180,388,$BBRK3,2020-06-30,36278,0,36278
21180,388,$BBRK3,2020-09-30,36278,0,36278
21199,387,$BPAN4,2010-12-31,131881028,112462912,244343940
21199,387,$BPAN4,2011-03-31,131881028,112462912,244343940
21199,387,$BPAN4,2011-06-30,131881028,112462912,244343940
21199,387,$BPAN4,2011-09-30,131881028,112462912,244343940
21199,387,$BPAN4,2011-12-31,131881028,112462912,244343940
21199,387,$BPAN4,2012-03-31,131881028,112462912,244343940
21199,387,$BPAN4,2012-06-30,292463400,242612675,535076075
21199,387,$BPAN4,2012-09-30,292463400,242612675,535076075
21199,387,$BPAN4,2012-12-31,292463400,242612675,535076075
21199,387,$BPAN4,2013-03-31,292463400,242612675,535076075
21199,387,$BPAN4,2013-06-30,292463400,242612675,535076075
21199,387,$BPAN4,2013-09-30,292463400,242612675,535076075
21199,387,$BPAN4,2013-12-31,292463400,242612675,535076075
21199,387,$BPAN4,2014-03-31,292463400,242612675,535076075
21199,387,$BPAN4,2014-06-30,292463400,242612675,535076075
21199,387,$BPAN4,2014-09-30,535029747,394010416,929040163
21199,387,$BPAN4,2014-12-31,535029747,394010416,929040163
21199,387,$BPAN4,2015-03-31,535029747,394010416,929040163
21199,387,$BPAN4,2015-06-30,535029747,394010416,929040163
21199,387,$BPAN4,2015-09-30,535029747,394010416,929040163
21199,387,$BPAN4,2015-12-31,535029747,394010416,929040163
21199,387,$BPAN4,2016-03-31,535029747,394010416,929040163
21199,387,$BPAN4,2016-06-30,535029747,394010416,929040163
21199,387,$BPAN4,2016-09-30,535029747,394010416,929040163
21199,387,$BPAN4,2016-12-31,535029747,394010416,929040163
21199,387,$BPAN4,2017-03-31,535029747,394010416,929040163
21199,387,$BPAN4,2017-06-30,535029747,394010416,929040163
21199,387,$BPAN4,2017-09-30,535029747,394010416,929040163
21199,387,$BPAN4,2017-12-31,535029747,394010416,929040163
21199,387,$BPAN4,2018-03-31,535029747,394010416,929040163
21199,387,$BPAN4,2018-06-30,657560635,484245486,1141806121
21199,387,$BPAN4,2018-09-30,657560635,484245486,1141806121
21199,387,$BPAN4,2018-12-31,657560635,484245486,1141806121
21199,387,$BPAN4,2019-03-31,657560635,484245486,1141806121
21199,387,$BPAN4,2019-06-30,657560635,484245486,1141806121
21199,387,$BPAN4,2019-09-30,657560635,547495486,1205056121
21199,387,$BPAN4,2019-12-31,657560635,547495486,1205056121
21199,387,$BPAN4,2020-03-31,657560635,547495486,1205056121
21199,387,$BPAN4,2020-06-30,657560635,547495486,1205056121
21199,387,$BPAN4,2020-09-30,657560635,547495486,1205056121
21237,393,$ENEV3,2010-12-31,136693,0,136693
21237,393,$ENEV3,2011-03-31,136693,0,136693
21237,393,$ENEV3,2011-06-30,136721,0,136721
21237,393,$ENEV3,2011-09-30,136721,0,136721
21237,393,$ENEV3,2011-12-31,136721,0,136721
21237,393,$ENEV3,2012-03-31,136736,0,136736
21237,393,$ENEV3,2012-06-30,170123,0,170123
21237,393,$ENEV3,2012-09-30,578241,0,578241
21237,393,$ENEV3,2012-12-31,578242,0,578242
21237,393,$ENEV3,2013-03-31,578416,0,578416
21237,393,$ENEV3,2013-06-30,578480,0,578480
21237,393,$ENEV3,2013-09-30,702511,0,702511
21237,393,$ENEV3,2013-12-31,702524,0,702524
21237,393,$ENEV3,2014-03-31,702524,0,702524
21237,393,$ENEV3,2014-06-30,702524,0,702524
21237,393,$ENEV3,2014-09-30,840106,0,840106
21237,393,$ENEV3,2014-12-31,840106,0,840106
21237,393,$ENEV3,2015-03-31,840106,0,840106
21237,393,$ENEV3,2015-06-30,840106,0,840106
21237,393,$ENEV3,2015-09-30,840106,0,840106
21237,393,$ENEV3,2015-12-31,16176982,0,16176982
21237,393,$ENEV3,2016-03-31,16176982,0,16176982
21237,393,$ENEV3,2016-06-30,161770,0,161770
21237,393,$ENEV3,2016-09-30,161770,0,161770
21237,393,$ENEV3,2016-12-31,239128,0,239128
21237,393,$ENEV3,2017-03-31,239128,0,239128
21237,393,$ENEV3,2017-06-30,239128,0,239128
21237,393,$ENEV3,2017-09-30,239128,0,239128
21237,393,$ENEV3,2017-12-31,314990,0,314990
21237,393,$ENEV3,2018-03-31,314990,0,314990
21237,393,$ENEV3,2018-06-30,314990,0,314990
21237,393,$ENEV3,2018-09-30,314990,0,314990
21237,393,$ENEV3,2018-12-31,314990,0,314990
21237,393,$ENEV3,2019-03-31,314990,0,314990
21237,393,$ENEV3,2019-06-30,315276,0,315276
21237,393,$ENEV3,2019-09-30,315323,0,315323
21237,393,$ENEV3,2019-12-31,315483,0,315483
21237,393,$ENEV3,2020-03-31,315483,0,315483
21237,393,$ENEV3,2020-06-30,315768,0,315768
21237,393,$ENEV3,2020-09-30,315768,0,315768
21334,482,$NUTR3,2010-12-31,5212268,0,5212268
21334,482,$NUTR3,2011-03-31,5212268,0,5212268
21334,482,$NUTR3,2011-06-30,5212268,0,5212268
21334,482,$NUTR3,2011-09-30,5212268,0,5212268
21334,482,$NUTR3,2011-12-31,5212268,0,5212268
21334,482,$NUTR3,2012-03-31,5212268,0,5212268
21334,482,$NUTR3,2012-06-30,12409678,0,12409678
21334,482,$NUTR3,2012-09-30,12403678,0,12403678
21334,482,$NUTR3,2012-12-31,12414678,0,12414678
21334,482,$NUTR3,2013-03-31,12414678,0,12414678
21334,482,$NUTR3,2013-06-30,12414678,0,12414678
21334,482,$NUTR3,2013-09-30,12414678,0,12414678
21334,482,$NUTR3,2013-12-31,12414678,0,12414678
21334,482,$NUTR3,2014-03-31,12414678,0,12414678
21334,482,$NUTR3,2014-06-30,12414678,0,12414678
21334,482,$NUTR3,2014-09-30,12414678,0,12414678
21334,482,$NUTR3,2014-12-31,12794413,0,12794413
21334,482,$NUTR3,2015-03-31,12794413,0,12794413
21334,482,$NUTR3,2015-06-30,12794413,0,12794413
21334,482,$NUTR3,2015-09-30,127944,0,127944
21334,482,$NUTR3,2015-12-31,127944,0,127944
21334,482,$NUTR3,2016-03-31,127944,0,127944
21334,482,$NUTR3,2016-06-30,127944,0,127944
21334,482,$NUTR3,2016-09-30,127944,0,127944
21334,482,$NUTR3,2016-12-31,127944,0,127944
21334,482,$NUTR3,2017-03-31,127944,0,127944
21334,482,$NUTR3,2017-06-30,127944,0,127944
21334,482,$NUTR3,2017-09-30,127944,0,127944
21334,482,$NUTR3,2017-12-31,127944,0,127944
21334,482,$NUTR3,2018-03-31,127944,0,127944
21334,482,$NUTR3,2018-06-30,127944,0,127944
21334,482,$NUTR3,2018-09-30,127944,0,127944
21334,482,$NUTR3,2018-12-31,127944,0,127944
21334,482,$NUTR3,2019-03-31,127944,0,127944
21334,482,$NUTR3,2019-06-30,127944,0,127944
21334,482,$NUTR3,2019-09-30,127944,0,127944
21334,482,$NUTR3,2019-12-31,127944,0,127944
21334,482,$NUTR3,2020-03-31,127944,0,127944
21334,482,$NUTR3,2020-06-30,127944,0,127944
21334,482,$NUTR3,2020-09-30,127944,0,127944
21342,395,$OSXB3,2010-12-31,11212500,0,11212500
21342,395,$OSXB3,2011-03-31,11212500,0,11212500
21342,395,$OSXB3,2011-06-30,11212500,0,11212500
21342,395,$OSXB3,2011-09-30,11223009,0,11223009
21342,395,$OSXB3,2011-12-31,280575225,0,280575225
21342,395,$OSXB3,2012-03-31,280792758,0,280792758
21342,395,$OSXB3,2012-06-30,280792778,0,280792778
21342,395,$OSXB3,2012-09-30,280792778,0,280792778
21342,395,$OSXB3,2012-12-31,293712408,0,293712408
21342,395,$OSXB3,2013-03-31,306508560,0,306508560
21342,395,$OSXB3,2013-06-30,312563568,0,312563568
21342,395,$OSXB3,2013-09-30,312563568,0,312563568
21342,395,$OSXB3,2013-12-31,312564,0,312564
21342,395,$OSXB3,2014-03-31,312564,0,312564
21342,395,$OSXB3,2014-06-30,312564,0,312564
21342,395,$OSXB3,2014-09-30,312564,0,312564
21342,395,$OSXB3,2014-12-31,312564,0,312564
21342,395,$OSXB3,2015-03-31,312564,0,312564
21342,395,$OSXB3,2015-06-30,312564,0,312564
21342,395,$OSXB3,2015-09-30,312564,0,312564
21342,395,$OSXB3,2015-12-31,312564,0,312564
21342,395,$OSXB3,2016-03-31,312564,0,312564
21342,395,$OSXB3,2016-06-30,3148038,0,3148038
21342,395,$OSXB3,2016-09-30,3148038,0,3148038
21342,395,$OSXB3,2016-12-31,3148038,0,3148038
21342,395,$OSXB3,2017-03-31,3148038,0,3148038
21342,395,$OSXB3,2017-06-30,3148038,0,3148038
21342,395,$OSXB3,2017-09-30,3148038,0,3148038
21342,395,$OSXB3,2017-12-31,3148038,0,3148038
21342,395,$OSXB3,2018-03-31,3148038,0,3148038
21342,395,$OSXB3,2018-06-30,3148038,0,3148038
21342,395,$OSXB3,2018-09-30,3148038,0,3148038
21342,395,$OSXB3,2018-12-31,3148038,0,3148038
21342,395,$OSXB3,2019-03-31,3148038,0,3148038
21342,395,$OSXB3,2019-06-30,3148038,0,3148038
21342,395,$OSXB3,2019-09-30,3148038,0,3148038
21342,395,$OSXB3,2019-12-31,3148038,0,3148038
21342,395,$OSXB3,2020-03-31,3148038,0,3148038
21342,395,$OSXB3,2020-06-30,3148038,0,3148038
21342,395,$OSXB3,2020-09-30,3148038,0,3148038
21350,392,$DIRR3,2010-12-31,133407162,0,133407162
21350,392,$DIRR3,2011-03-31,154207162,0,154207162
21350,392,$DIRR3,2011-06-30,154610703,0,154610703
21350,392,$DIRR3,2011-09-30,153270932,0,153270932
21350,392,$DIRR3,2011-12-31,153244532,0,153244532
21350,392,$DIRR3,2012-03-31,153638549,0,153638549
21350,392,$DIRR3,2012-06-30,153703054,0,153703054
21350,392,$DIRR3,2012-09-30,153972578,0,153972578
21350,392,$DIRR3,2012-12-31,153972578,0,153972578
21350,392,$DIRR3,2013-03-31,154615224,0,154615224
21350,392,$DIRR3,2013-06-30,155298749,0,155298749
21350,392,$DIRR3,2013-09-30,155298749,0,155298749
21350,392,$DIRR3,2013-12-31,155298749,0,155298749
21350,392,$DIRR3,2014-03-31,155298749,0,155298749
21350,392,$DIRR3,2014-06-30,153176459,0,153176459
21350,392,$DIRR3,2014-09-30,153225983,0,153225983
21350,392,$DIRR3,2014-12-31,153265983,0,153265983
21350,392,$DIRR3,2015-03-31,151053983,0,151053983
21350,392,$DIRR3,2015-06-30,153398749,0,153398749
21350,392,$DIRR3,2015-09-30,153398749,0,153398749
21350,392,$DIRR3,2015-12-31,153398749,0,153398749
21350,392,$DIRR3,2016-03-31,153398749,0,153398749
21350,392,$DIRR3,2016-06-30,153398749,0,153398749
21350,392,$DIRR3,2016-09-30,146304437,0,146304437
21350,392,$DIRR3,2016-12-31,146315104,0,146315104
21350,392,$DIRR3,2017-03-31,146403554,0,146403554
21350,392,$DIRR3,2017-06-30,146403554,0,146403554
21350,392,$DIRR3,2017-09-30,146437554,0,146437554
21350,392,$DIRR3,2017-12-31,153398749,0,153398749
21350,392,$DIRR3,2018-03-31,153398749,0,153398749
21350,392,$DIRR3,2018-06-30,153398749,0,153398749
21350,392,$DIRR3,2018-09-30,153398749,0,153398749
21350,392,$DIRR3,2018-12-31,153398749,0,153398749
21350,392,$DIRR3,2019-03-31,153398749,0,153398749
21350,392,$DIRR3,2019-06-30,153398749,0,153398749
21350,392,$DIRR3,2019-09-30,153398749,0,153398749
21350,392,$DIRR3,2019-12-31,147925010,0,147925010
21350,392,$DIRR3,2020-03-31,153398749,0,153398749
21350,392,$DIRR3,2020-06-30,153398749,0,153398749
21350,392,$DIRR3,2020-09-30,153398749,0,153398749
21393,390,$GPAR3,2010-12-31,32774,0,32774
21393,390,$GPAR3,2011-03-31,32774,0,32774
21393,390,$GPAR3,2011-06-30,32774,0,32774
21393,390,$GPAR3,2011-09-30,32774,0,32774
21393,390,$GPAR3,2011-12-31,32774,0,32774
21393,390,$GPAR3,2012-03-31,32774,0,32774
21393,390,$GPAR3,2012-06-30,32774,0,32774
21393,390,$GPAR3,2012-09-30,32774,0,32774
21393,390,$GPAR3,2012-12-31,32774,0,32774
21393,390,$GPAR3,2013-03-31,32774,0,32774
21393,390,$GPAR3,2013-06-30,32774,0,32774
21393,390,$GPAR3,2013-09-30,32774,0,32774
21393,390,$GPAR3,2013-12-31,32774,0,32774
21393,390,$GPAR3,2014-03-31,32774,0,32774
21393,390,$GPAR3,2014-06-30,32774,0,32774
21393,390,$GPAR3,2014-09-30,32774,0,32774
21393,390,$GPAR3,2014-12-31,32774,0,32774
21393,390,$GPAR3,2015-03-31,32774,0,32774
21393,390,$GPAR3,2015-06-30,32774,0,32774
21393,390,$GPAR3,2015-09-30,32774,0,32774
21393,390,$GPAR3,2015-12-31,32774,0,32774
21393,390,$GPAR3,2016-03-31,32774,0,32774
21393,390,$GPAR3,2016-06-30,32774,0,32774
21393,390,$GPAR3,2016-09-30,32774,0,32774
21393,390,$GPAR3,2016-12-31,32774,0,32774
21393,390,$GPAR3,2017-03-31,32774,0,32774
21393,390,$GPAR3,2017-06-30,32774,0,32774
21393,390,$GPAR3,2017-09-30,32774,0,32774
21393,390,$GPAR3,2017-12-31,32774,0,32774
21393,390,$GPAR3,2018-03-31,32774,0,32774
21393,390,$GPAR3,2018-06-30,32774,0,32774
21393,390,$GPAR3,2018-09-30,32774,0,32774
21393,390,$GPAR3,2018-12-31,32774,0,32774
21393,390,$GPAR3,2019-03-31,32774,0,32774
21393,390,$GPAR3,2019-06-30,32774,0,32774
21393,390,$GPAR3,2019-09-30,32774,0,32774
21393,390,$GPAR3,2019-12-31,32774,0,32774
21393,390,$GPAR3,2020-03-31,32774,0,32774
21393,390,$GPAR3,2020-06-30,77928,0,77928
21393,390,$GPAR3,2020-09-30,77928,0,77928
21431,394,$HYPE3,2010-12-31,547846,0,547846
21431,394,$HYPE3,2011-03-31,625860,0,625860
21431,394,$HYPE3,2011-06-30,626785,0,626785
21431,394,$HYPE3,2011-09-30,626785,0,626785
21431,394,$HYPE3,2011-12-31,626784912,0,626784912
21431,394,$HYPE3,2012-03-31,627396559,0,627396559
21431,394,$HYPE3,2012-06-30,627396559,0,627396559
21431,394,$HYPE3,2012-09-30,627396559,0,627396559
21431,394,$HYPE3,2012-12-31,627396559,0,627396559
21431,394,$HYPE3,2013-03-31,627396559,0,627396559
21431,394,$HYPE3,2013-06-30,632100787,0,632100787
21431,394,$HYPE3,2013-09-30,632100787,0,632100787
21431,394,$HYPE3,2013-12-31,632100787,0,632100787
21431,394,$HYPE3,2014-03-31,632100787,0,632100787
21431,394,$HYPE3,2014-06-30,632100787,0,632100787
21431,394,$HYPE3,2014-09-30,632100787,0,632100787
21431,394,$HYPE3,2014-12-31,632100787,0,632100787
21431,394,$HYPE3,2015-03-31,632100787,0,632100787
21431,394,$HYPE3,2015-06-30,632117926,0,632117926
21431,394,$HYPE3,2015-09-30,632238060,0,632238060
21431,394,$HYPE3,2015-12-31,632238060,0,632238060
21431,394,$HYPE3,2016-03-31,632238060,0,632238060
21431,394,$HYPE3,2016-06-30,632238060,0,632238060
21431,394,$HYPE3,2016-09-30,632238060,0,632238060
21431,394,$HYPE3,2016-12-31,632238060,0,632238060
21431,394,$HYPE3,2017-03-31,632238060,0,632238060
21431,394,$HYPE3,2017-06-30,632238060,0,632238060
21431,394,$HYPE3,2017-09-30,632238060,0,632238060
21431,394,$HYPE3,2017-12-31,632238060,0,632238060
21431,394,$HYPE3,2018-03-31,632238060,0,632238060
21431,394,$HYPE3,2018-06-30,632238060,0,632238060
21431,394,$HYPE3,2018-09-30,632238060,0,632238060
21431,394,$HYPE3,2018-12-31,632238060,0,632238060
21431,394,$HYPE3,2019-03-31,632238060,0,632238060
21431,394,$HYPE3,2019-06-30,632238060,0,632238060
21431,394,$HYPE3,2019-09-30,632238060,0,632238060
21431,394,$HYPE3,2019-12-31,632238060,0,632238060
21431,394,$HYPE3,2020-03-31,632238060,0,632238060
21431,394,$HYPE3,2020-06-30,632238060,0,632238060
21431,394,$HYPE3,2020-09-30,633320423,0,633320423
21440,391,$LLIS3,2010-12-31,57250,0,57250
21440,391,$LLIS3,2011-03-31,57250,0,57250
21440,391,$LLIS3,2011-06-30,57250,0,57250
21440,391,$LLIS3,2011-09-30,57250,0,57250
21440,391,$LLIS3,2011-12-31,57250,0,57250
21440,391,$LLIS3,2012-03-31,57250,0,57250
21440,391,$LLIS3,2012-06-30,171750,0,171750
21440,391,$LLIS3,2012-09-30,171750,0,171750
21440,391,$LLIS3,2012-12-31,172171,0,172171
21440,391,$LLIS3,2013-03-31,172171,0,172171
21440,391,$LLIS3,2013-06-30,172171,0,172171
21440,391,$LLIS3,2013-09-30,172171,0,172171
21440,391,$LLIS3,2013-12-31,172171,0,172171
21440,391,$LLIS3,2014-03-31,172171,0,172171
21440,391,$LLIS3,2014-06-30,174931,0,174931
21440,391,$LLIS3,2014-09-30,174931,0,174931
21440,391,$LLIS3,2014-12-31,349863,0,349863
21440,391,$LLIS3,2015-03-31,349863,0,349863
21440,391,$LLIS3,2015-06-30,349863,0,349863
21440,391,$LLIS3,2015-09-30,349863,0,349863
21440,391,$LLIS3,2015-12-31,349863,0,349863
21440,391,$LLIS3,2016-03-31,349863,0,349863
21440,391,$LLIS3,2016-06-30,349863,0,349863
21440,391,$LLIS3,2016-09-30,349863,0,349863
21440,391,$LLIS3,2016-12-31,349863,0,349863
21440,391,$LLIS3,2017-03-31,326640,0,326640
21440,391,$LLIS3,2017-06-30,46663,0,46663
21440,391,$LLIS3,2017-09-30,46663,0,46663
21440,391,$LLIS3,2017-12-31,51601,0,51601
21440,391,$LLIS3,2018-03-31,51601,0,51601
21440,391,$LLIS3,2018-06-30,51601,0,51601
21440,391,$LLIS3,2018-09-30,51601,0,51601
21440,391,$LLIS3,2018-12-31,51601,0,51601
21440,391,$LLIS3,2019-03-31,51601,0,51601
21440,391,$LLIS3,2019-06-30,51601,0,51601
21440,391,$LLIS3,2019-09-30,51601,0,51601
21440,391,$LLIS3,2019-12-31,68851,0,68851
21440,391,$LLIS3,2020-03-31,68851,0,68851
21440,391,$LLIS3,2020-06-30,68851,0,68851
21440,391,$LLIS3,2020-09-30,68851,0,68851
21490,602,$ALUP11,2010-12-31,163910,0,163910
21490,602,$ALUP11,2011-03-31,163910,0,163910
21490,602,$ALUP11,2011-06-30,163910000,0,163910000
21490,602,$ALUP11,2011-09-30,163910000,0,163910000
21490,602,$ALUP11,2011-12-31,163910000,0,163910000
21490,602,$ALUP11,2012-03-31,193910000,0,193910000
21490,602,$ALUP11,2012-06-30,163910000,0,163910000
21490,602,$ALUP11,2012-09-30,163910000,0,163910000
21490,602,$ALUP11,2012-12-31,138951000,24959000,163910000
21490,602,$ALUP11,2013-03-31,416853000,74877000,491730000
21490,602,$ALUP11,2013-06-30,461243600,163658200,624901800
21490,602,$ALUP11,2013-09-30,461243600,163658200,624901800
21490,602,$ALUP11,2013-12-31,461243600,163658200,624901800
21490,602,$ALUP11,2014-03-31,461243596,163658204,624901800
21490,602,$ALUP11,2014-06-30,461243596,163658204,624901800
21490,602,$ALUP11,2014-09-30,461243596,163658204,624901800
21490,602,$ALUP11,2014-12-31,461243596,163658204,624901800
21490,602,$ALUP11,2015-03-31,461243596,163658204,624901800
21490,602,$ALUP11,2015-06-30,461243596,163658204,624901800
21490,602,$ALUP11,2015-09-30,461243596,163658204,624901800
21490,602,$ALUP11,2015-12-31,461243596,163658204,624901800
21490,602,$ALUP11,2016-03-31,461243596,163658204,624901800
21490,602,$ALUP11,2016-06-30,491224430,174295987,665520417
21490,602,$ALUP11,2016-09-30,554233455,196652815,750886270
21490,602,$ALUP11,2016-12-31,554233455,196652815,750886270
21490,602,$ALUP11,2017-03-31,554233455,196652815,750886270
21490,602,$ALUP11,2017-06-30,596955970,282155299,879111269
21490,602,$ALUP11,2017-09-30,596955970,282155299,879111269
21490,602,$ALUP11,2017-12-31,596955970,282155299,879111269
21490,602,$ALUP11,2018-03-31,596955970,282155299,879111269
21490,602,$ALUP11,2018-06-30,596955970,282155299,879111269
21490,602,$ALUP11,2018-09-30,596955970,282155299,879111269
21490,602,$ALUP11,2018-12-31,596955970,282155299,879111269
21490,602,$ALUP11,2019-03-31,596955970,282155299,879111269
21490,602,$ALUP11,2019-06-30,596955970,282155299,879111269
21490,602,$ALUP11,2019-09-30,596955970,282155299,879111269
21490,602,$ALUP11,2019-12-31,596955970,282155299,879111269
21490,602,$ALUP11,2020-03-31,596955970,282155299,879111269
21490,602,$ALUP11,2020-06-30,596955970,282155299,879111269
21490,602,$ALUP11,2020-09-30,596955970,282155299,879111269
21610,484,$BVMF3,2010-12-31,2044014295,0,2044014295
21610,484,$BVMF3,2011-03-31,2044014295,0,2044014295
21610,484,$BVMF3,2011-06-30,2044014295,0,2044014295
21610,484,$BVMF3,2011-09-30,2044014295,0,2044014295
21610,484,$BVMF3,2011-12-31,1980000000,0,1980000000
21610,484,$BVMF3,2012-03-31,1980000000,0,1980000000
21610,484,$BVMF3,2012-06-30,1980000000,0,1980000000
21610,484,$BVMF3,2012-09-30,1980000000,0,1980000000
21610,484,$BVMF3,2012-12-31,1980000000,0,1980000000
21610,484,$BVMF3,2013-03-31,1980000000,0,1980000000
21610,484,$BVMF3,2013-06-30,1980000000,0,1980000000
21610,484,$BVMF3,2013-09-30,1980000000,0,1980000000
21610,484,$BVMF3,2013-12-31,1980000000,0,1980000000
21610,484,$BVMF3,2014-03-31,1900000000,0,1900000000
21610,484,$BVMF3,2014-06-30,1900000000,0,1900000000
21610,484,$BVMF3,2014-09-30,1900000000,0,1900000000
21610,484,$BVMF3,2014-12-31,1900000000,0,1900000000
21610,484,$BVMF3,2015-03-31,1815000000,0,1815000000
21610,484,$BVMF3,2015-06-30,1815000000,0,1815000000
21610,484,$BVMF3,2015-09-30,1815000000,0,1815000000
21610,484,$BVMF3,2015-12-31,1815000000,0,1815000000
21610,484,$BVMF3,2016-03-31,1815000000,0,1815000000
21610,484,$BVMF3,2016-06-30,1815000000,0,1815000000
21610,484,$BVMF3,2016-09-30,1815000000,0,1815000000
21610,484,$BVMF3,2016-12-31,1815000000,0,1815000000
21610,484,$BVMF3,2017-03-31,2059138490,0,2059138490
21610,484,$BVMF3,2017-06-30,2059138490,0,2059138490
21610,484,$BVMF3,2017-09-30,2059138490,0,2059138490
21610,484,$BVMF3,2017-12-31,2059138490,0,2059138490
21610,484,$BVMF3,2018-03-31,2059138490,0,2059138490
21610,484,$BVMF3,2018-06-30,2059138490,0,2059138490
21610,484,$BVMF3,2018-09-30,2059138490,0,2059138490
21610,484,$BVMF3,2018-12-31,2059138490,0,2059138490
21610,484,$BVMF3,2019-03-31,2059138490,0,2059138490
21610,484,$BVMF3,2019-06-30,2059138490,0,2059138490
21610,484,$BVMF3,2019-09-30,2059138490,0,2059138490
21610,484,$BVMF3,2019-12-31,2059138490,0,2059138490
21610,484,$BVMF3,2020-03-31,2059138490,0,2059138490
21610,484,$BVMF3,2020-06-30,2059138490,0,2059138490
21610,484,$BVMF3,2020-09-30,2059138490,0,2059138490
21610,487,$B3SA3,2010-12-31,2044014295,0,2044014295
21610,487,$B3SA3,2011-03-31,2044014295,0,2044014295
21610,487,$B3SA3,2011-06-30,2044014295,0,2044014295
21610,487,$B3SA3,2011-09-30,2044014295,0,2044014295
21610,487,$B3SA3,2011-12-31,1980000000,0,1980000000
21610,487,$B3SA3,2012-03-31,1980000000,0,1980000000
21610,487,$B3SA3,2012-06-30,1980000000,0,1980000000
21610,487,$B3SA3,2012-09-30,1980000000,0,1980000000
21610,487,$B3SA3,2012-12-31,1980000000,0,1980000000
21610,487,$B3SA3,2013-03-31,1980000000,0,1980000000
21610,487,$B3SA3,2013-06-30,1980000000,0,1980000000
21610,487,$B3SA3,2013-09-30,1980000000,0,1980000000
21610,487,$B3SA3,2013-12-31,1980000000,0,1980000000
21610,487,$B3SA3,2014-03-31,1900000000,0,1900000000
21610,487,$B3SA3,2014-06-30,1900000000,0,1900000000
21610,487,$B3SA3,2014-09-30,1900000000,0,1900000000
21610,487,$B3SA3,2014-12-31,1900000000,0,1900000000
21610,487,$B3SA3,2015-03-31,1815000000,0,1815000000
21610,487,$B3SA3,2015-06-30,1815000000,0,1815000000
21610,487,$B3SA3,2015-09-30,1815000000,0,1815000000
21610,487,$B3SA3,2015-12-31,1815000000,0,1815000000
21610,487,$B3SA3,2016-03-31,1815000000,0,1815000000
21610,487,$B3SA3,2016-06-30,1815000000,0,1815000000
21610,487,$B3SA3,2016-09-30,1815000000,0,1815000000
21610,487,$B3SA3,2016-12-31,1815000000,0,1815000000
21610,487,$B3SA3,2017-03-31,2059138490,0,2059138490
21610,487,$B3SA3,2017-06-30,2059138490,0,2059138490
21610,487,$B3SA3,2017-09-30,2059138490,0,2059138490
21610,487,$B3SA3,2017-12-31,2059138490,0,2059138490
21610,487,$B3SA3,2018-03-31,2059138490,0,2059138490
21610,487,$B3SA3,2018-06-30,2059138490,0,2059138490
21610,487,$B3SA3,2018-09-30,2059138490,0,2059138490
21610,487,$B3SA3,2018-12-31,2059138490,0,2059138490
21610,487,$B3SA3,2019-03-31,2059138490,0,2059138490
21610,487,$B3SA3,2019-06-30,2059138490,0,2059138490
21610,487,$B3SA3,2019-09-30,2059138490,0,2059138490
21610,487,$B3SA3,2019-12-31,2059138490,0,2059138490
21610,487,$B3SA3,2020-03-31,2059138490,0,2059138490
21610,487,$B3SA3,2020-06-30,2059138490,0,2059138490
21610,487,$B3SA3,2020-09-30,2059138490,0,2059138490
21636,606,$RNEW11,2010-12-31,93033067,47730533,140763600
21636,606,$RNEW11,2011-03-31,93393118,48450635,141843753
21636,606,$RNEW11,2011-06-30,93518118,48700635,142218753
21636,606,$RNEW11,2011-09-30,146813876,49075491,195889367
21636,606,$RNEW11,2011-12-31,145066949,50529299,195596248
21636,606,$RNEW11,2012-03-31,145087187,50643731,195730918
21636,606,$RNEW11,2012-06-30,145100899,50697513,195798412
21636,606,$RNEW11,2012-09-30,170086432,59429640,229516072
21636,606,$RNEW11,2012-12-31,156469395,73445134,229914529
21636,606,$RNEW11,2013-03-31,156508015,73523850,230031865
21636,606,$RNEW11,2013-06-30,156477463,73554402,230031865
21636,606,$RNEW11,2013-09-30,156896011,74394006,231290017
21636,606,$RNEW11,2013-12-31,156899210,74408816,231308026
21636,606,$RNEW11,2014-03-31,150899210,80408816,231308026
21636,606,$RNEW11,2014-06-30,150899210,80408816,231308026
21636,606,$RNEW11,2014-09-30,150899210,80408816,231308026
21636,606,$RNEW11,2014-12-31,236845392,81810030,318655422
21636,606,$RNEW11,2015-03-31,236844286,81811136,318655422
21636,606,$RNEW11,2015-06-30,236844286,81811136,318655422
21636,606,$RNEW11,2015-09-30,236883455,81889474,318772929
21636,606,$RNEW11,2015-12-31,236874031,81898898,318772929
21636,606,$RNEW11,2016-03-31,236874031,81898898,318772929
21636,606,$RNEW11,2016-06-30,278916250,81899063,360815313
21636,606,$RNEW11,2016-09-30,278916250,81899063,360815313
21636,606,$RNEW11,2016-12-31,278916250,81899063,360815313
21636,606,$RNEW11,2017-03-31,278916250,81899063,360815313
21636,606,$RNEW11,2017-06-30,329805243,87392001,417197244
21636,606,$RNEW11,2017-09-30,329805243,87392001,417197244
21636,606,$RNEW11,2017-12-31,329805243,87392001,417197244
21636,606,$RNEW11,2018-03-31,329805243,87392001,417197244
21636,606,$RNEW11,2018-06-30,329805243,87392001,417197244
21636,606,$RNEW11,2018-09-30,329805243,87392001,417197244
21636,606,$RNEW11,2018-12-31,32980224,8739500,41719724
21636,606,$RNEW11,2019-03-31,32980224,8739500,41719724
21636,606,$RNEW11,2019-06-30,32980224,8739500,41719724
21636,606,$RNEW11,2019-09-30,32980224,8739500,41719724
21636,606,$RNEW11,2019-12-31,32980224,8739500,41719724
21636,606,$RNEW11,2020-03-31,31352518,10367206,41719724
21636,606,$RNEW11,2020-06-30,31352518,10367206,41719724
21636,606,$RNEW11,2020-09-30,31352518,10367206,41719724
21725,396,$021725,2010-12-31,80359,0,80359
21725,396,$021725,2011-03-31,80359,0,80359
21725,396,$021725,2011-06-30,80359,0,80359
21725,396,$021725,2011-09-30,80359,0,80359
21725,396,$021725,2011-12-31,80359,0,80359
21725,396,$021725,2012-03-31,80359,0,80359
21725,396,$021725,2012-06-30,80359,0,80359
21725,396,$021725,2012-09-30,80359,0,80359
21725,396,$021725,2012-12-31,80359,0,80359
21725,396,$021725,2013-03-31,80359,0,80359
21725,396,$021725,2013-06-30,80359,0,80359
21725,396,$021725,2013-09-30,80359,0,80359
21725,396,$021725,2013-12-31,81359,0,81359
21725,396,$021725,2014-03-31,81359,0,81359
21725,396,$021725,2014-06-30,81359,0,81359
21725,396,$021725,2014-09-30,81359,0,81359
21725,396,$021725,2014-12-31,81359,0,81359
21725,396,$021725,2015-03-31,81359,0,81359
21725,396,$021725,2015-06-30,81359,0,81359
21725,396,$021725,2015-09-30,81359,0,81359
21725,396,$021725,2015-12-31,81359,0,81359
21725,396,$021725,2016-03-31,81359,0,81359
21725,396,$021725,2016-06-30,30250,0,30250
21725,396,$021725,2016-09-30,30250,0,30250
21725,396,$021725,2016-12-31,30250395,0,30250395
21725,396,$021725,2017-03-31,7562598,0,7562598
21725,396,$021725,2017-06-30,7562598,0,7562598
21725,396,$021725,2017-09-30,7562598,0,7562598
21725,396,$021725,2017-12-31,7562598,0,7562598
21725,396,$021725,2018-03-31,7563,0,7563
21725,396,$021725,2018-06-30,7563,0,7563
21725,396,$021725,2018-09-30,7563,0,7563
21725,396,$021725,2018-12-31,7563,0,7563
21725,396,$021725,2019-03-31,7563,0,7563
21725,396,$021725,2019-06-30,7563,0,7563
21725,396,$021725,2019-09-30,7563,0,7563
21733,398,$CIEL3,2010-12-31,1364783800,0,1364783800
21733,398,$CIEL3,2011-03-31,1364783800,0,1364783800
21733,398,$CIEL3,2011-06-30,545913520,0,545913520
21733,398,$CIEL3,2011-09-30,545913520,0,545913520
21733,398,$CIEL3,2011-12-31,545913520,0,545913520
21733,398,$CIEL3,2012-03-31,545913520,0,545913520
21733,398,$CIEL3,2012-06-30,653861218,0,653861218
21733,398,$CIEL3,2012-09-30,654345737,0,654345737
21733,398,$CIEL3,2012-12-31,655096224,0,655096224
21733,398,$CIEL3,2013-03-31,655096224,0,655096224
21733,398,$CIEL3,2013-06-30,784523090,0,784523090
21733,398,$CIEL3,2013-09-30,786115469,0,786115469
21733,398,$CIEL3,2013-12-31,786115469,0,786115469
21733,398,$CIEL3,2014-03-31,1565901704,0,1565901704
21733,398,$CIEL3,2014-06-30,1565882893,0,1565882893
21733,398,$CIEL3,2014-09-30,1566258985,0,1566258985
21733,398,$CIEL3,2014-12-31,1566433971,0,1566433971
21733,398,$CIEL3,2015-03-31,1566764252,0,1566764252
21733,398,$CIEL3,2015-06-30,1880483926,0,1880483926
21733,398,$CIEL3,2015-09-30,1881696240,0,1881696240
21733,398,$CIEL3,2015-12-31,1881830814,0,1881830814
21733,398,$CIEL3,2016-03-31,1881443238,0,1881443238
21733,398,$CIEL3,2016-06-30,2258567830,0,2258567830
21733,398,$CIEL3,2016-09-30,2259623845,0,2259623845
21733,398,$CIEL3,2016-12-31,2259768045,0,2259768045
21733,398,$CIEL3,2017-03-31,2260253774,0,2260253774
21733,398,$CIEL3,2017-06-30,2712679297,0,2712679297
21733,398,$CIEL3,2017-09-30,2713932157,0,2713932157
21733,398,$CIEL3,2017-12-31,2716815061,0,2716815061
21733,398,$CIEL3,2018-03-31,2716815061,0,2716815061
21733,398,$CIEL3,2018-06-30,2716815061,0,2716815061
21733,398,$CIEL3,2018-09-30,2716815061,0,2716815061
21733,398,$CIEL3,2018-12-31,2716815061,0,2716815061
21733,398,$CIEL3,2019-03-31,2716815061,0,2716815061
21733,398,$CIEL3,2019-06-30,2716815061,0,2716815061
21733,398,$CIEL3,2019-09-30,2716815061,0,2716815061
21733,398,$CIEL3,2019-12-31,2716815061,0,2716815061
21733,398,$CIEL3,2020-03-31,2716815061,0,2716815061
21733,398,$CIEL3,2020-06-30,2716815061,0,2716815061
21733,398,$CIEL3,2020-09-30,2716815061,0,2716815061
21881,401,$FLRY3,2010-12-31,131298550,0,131298550
21881,401,$FLRY3,2011-03-31,131298550,0,131298550
21881,401,$FLRY3,2011-06-30,131298550,0,131298550
21881,401,$FLRY3,2011-09-30,131298550,0,131298550
21881,401,$FLRY3,2011-12-31,156203919,0,156203919
21881,401,$FLRY3,2012-03-31,156203919,0,156203919
21881,401,$FLRY3,2012-06-30,156293356,0,156293356
21881,401,$FLRY3,2012-09-30,156236544,0,156236544
21881,401,$FLRY3,2012-12-31,156318136,0,156318136
21881,401,$FLRY3,2013-03-31,156293356,0,156293356
21881,401,$FLRY3,2013-06-30,156293356,0,156293356
21881,401,$FLRY3,2013-09-30,156293356,0,156293356
21881,401,$FLRY3,2013-12-31,156293356,0,156293356
21881,401,$FLRY3,2014-03-31,156293356,0,156293356
21881,401,$FLRY3,2014-06-30,156293356,0,156293356
21881,401,$FLRY3,2014-09-30,156293356,0,156293356
21881,401,$FLRY3,2014-12-31,156293356,0,156293356
21881,401,$FLRY3,2015-03-31,156293356,0,156293356
21881,401,$FLRY3,2015-06-30,156293356,0,156293356
21881,401,$FLRY3,2015-09-30,156293356,0,156293356
21881,401,$FLRY3,2015-12-31,156293356,0,156293356
21881,401,$FLRY3,2016-03-31,156293356,0,156293356
21881,401,$FLRY3,2016-06-30,156293356,0,156293356
21881,401,$FLRY3,2016-09-30,156293356,0,156293356
21881,401,$FLRY3,2016-12-31,157115125,0,157115125
21881,401,$FLRY3,2017-03-31,157115125,0,157115125
21881,401,$FLRY3,2017-06-30,314791538,0,314791538
21881,401,$FLRY3,2017-09-30,314791538,0,314791538
21881,401,$FLRY3,2017-12-31,315312192,0,315312192
21881,401,$FLRY3,2018-03-31,315312192,0,315312192
21881,401,$FLRY3,2018-06-30,315312192,0,315312192
21881,401,$FLRY3,2018-09-30,315654796,0,315654796
21881,401,$FLRY3,2018-12-31,316113442,0,316113442
21881,401,$FLRY3,2019-03-31,316113442,0,316113442
21881,401,$FLRY3,2019-06-30,316113442,0,316113442
21881,401,$FLRY3,2019-09-30,316744460,0,316744460
21881,401,$FLRY3,2019-12-31,316744460,0,316744460
21881,401,$FLRY3,2020-03-31,316788210,0,316788210
21881,401,$FLRY3,2020-06-30,316788210,0,316788210
21881,401,$FLRY3,2020-09-30,317366103,0,317366103
22012,400,$MILS3,2010-12-31,125495,0,125495
22012,400,$MILS3,2011-03-31,125495,0,125495
22012,400,$MILS3,2011-06-30,125495,0,125495
22012,400,$MILS3,2011-09-30,125591,0,125591
22012,400,$MILS3,2011-12-31,125657,0,125657
22012,400,$MILS3,2012-03-31,125689646,0,125689646
22012,400,$MILS3,2012-06-30,126148646,0,126148646
22012,400,$MILS3,2012-09-30,126314250,0,126314250
22012,400,$MILS3,2012-12-31,126399,0,126399
22012,400,$MILS3,2013-03-31,126491654,0,126491654
22012,400,$MILS3,2013-06-30,127120372,0,127120372
22012,400,$MILS3,2013-09-30,127314202,0,127314202
22012,400,$MILS3,2013-12-31,127386,0,127386
22012,400,$MILS3,2014-03-31,127490508,0,127490508
22012,400,$MILS3,2014-06-30,128026080,0,128026080
22012,400,$MILS3,2014-09-30,128057925,0,128057925
22012,400,$MILS3,2014-12-31,128057,0,128057
22012,400,$MILS3,2015-03-31,128057925,0,128057925
22012,400,$MILS3,2015-06-30,128057925,0,128057925
22012,400,$MILS3,2015-09-30,128057095,0,128057095
22012,400,$MILS3,2015-12-31,128057,0,128057
22012,400,$MILS3,2016-03-31,128057,0,128057
22012,400,$MILS3,2016-06-30,175586,0,175586
22012,400,$MILS3,2016-09-30,175586,0,175586
22012,400,$MILS3,2016-12-31,175586,0,175586
22012,400,$MILS3,2017-03-31,175586,0,175586
22012,400,$MILS3,2017-06-30,175586,0,175586
22012,400,$MILS3,2017-09-30,175586,0,175586
22012,400,$MILS3,2017-12-31,175586,0,175586
22012,400,$MILS3,2018-03-31,175586,0,175586
22012,400,$MILS3,2018-06-30,175586,0,175586
22012,400,$MILS3,2018-09-30,175586,0,175586
22012,400,$MILS3,2018-12-31,175586,0,175586
22012,400,$MILS3,2019-03-31,175586,0,175586
22012,400,$MILS3,2019-06-30,251862,0,251862
22012,400,$MILS3,2019-09-30,251866,0,251866
22012,400,$MILS3,2019-12-31,251866,0,251866
22012,400,$MILS3,2020-03-31,251866,0,251866
22012,400,$MILS3,2020-06-30,251907,0,251907
22012,400,$MILS3,2020-09-30,251954,0,251954
22020,407,$JSLG3,2010-12-31,198890,0,198890
22020,407,$JSLG3,2011-03-31,198890,0,198890
22020,407,$JSLG3,2011-06-30,198890,0,198890
22020,407,$JSLG3,2011-09-30,198890,0,198890
22020,407,$JSLG3,2011-12-31,201329600,0,201329600
22020,407,$JSLG3,2012-03-31,216799134,0,216799134
22020,407,$JSLG3,2012-06-30,216799134,0,216799134
22020,407,$JSLG3,2012-09-30,216799134,0,216799134
22020,407,$JSLG3,2012-12-31,216799134,0,216799134
22020,407,$JSLG3,2013-03-31,216799134,0,216799134
22020,407,$JSLG3,2013-06-30,216799134,0,216799134
22020,407,$JSLG3,2013-09-30,216799134,0,216799134
22020,407,$JSLG3,2013-12-31,216799134,0,216799134
22020,407,$JSLG3,2014-03-31,216799134,0,216799134
22020,407,$JSLG3,2014-06-30,216799134,0,216799134
22020,407,$JSLG3,2014-09-30,216799134,0,216799134
22020,407,$JSLG3,2014-12-31,216799134,0,216799134
22020,407,$JSLG3,2015-03-31,216799134,0,216799134
22020,407,$JSLG3,2015-06-30,216799134,0,216799134
22020,407,$JSLG3,2015-09-30,211000000,0,211000000
22020,407,$JSLG3,2015-12-31,211000000,0,211000000
22020,407,$JSLG3,2016-03-31,211000000,0,211000000
22020,407,$JSLG3,2016-06-30,206000000,0,206000000
22020,407,$JSLG3,2016-09-30,202500000,0,202500000
22020,407,$JSLG3,2016-12-31,202500000,0,202500000
22020,407,$JSLG3,2017-03-31,202500000,0,202500000
22020,407,$JSLG3,2017-06-30,202500000,0,202500000
22020,407,$JSLG3,2017-09-30,202500000,0,202500000
22020,407,$JSLG3,2017-12-31,202500000,0,202500000
22020,407,$JSLG3,2018-03-31,202500000,0,202500000
22020,407,$JSLG3,2018-06-30,202500000,0,202500000
22020,407,$JSLG3,2018-09-30,202500000,0,202500000
22020,407,$JSLG3,2018-12-31,205114532,0,205114532
22020,407,$JSLG3,2019-03-31,205114532,0,205114532
22020,407,$JSLG3,2019-06-30,205537500,0,205537500
22020,407,$JSLG3,2019-09-30,206746161,0,206746161
22020,407,$JSLG3,2019-12-31,206788866,0,206788866
22020,407,$JSLG3,2020-03-31,206798715,0,206798715
22020,407,$JSLG3,2020-06-30,207735316,0,207735316
22020,407,$JSLG3,2020-09-30,279991078,0,279991078
22020,591,$JSLG11,2010-12-31,198890,0,198890
22020,591,$JSLG11,2011-03-31,198890,0,198890
22020,591,$JSLG11,2011-06-30,198890,0,198890
22020,591,$JSLG11,2011-09-30,198890,0,198890
22020,591,$JSLG11,2011-12-31,201329600,0,201329600
22020,591,$JSLG11,2012-03-31,216799134,0,216799134
22020,591,$JSLG11,2012-06-30,216799134,0,216799134
22020,591,$JSLG11,2012-09-30,216799134,0,216799134
22020,591,$JSLG11,2012-12-31,216799134,0,216799134
22020,591,$JSLG11,2013-03-31,216799134,0,216799134
22020,591,$JSLG11,2013-06-30,216799134,0,216799134
22020,591,$JSLG11,2013-09-30,216799134,0,216799134
22020,591,$JSLG11,2013-12-31,216799134,0,216799134
22020,591,$JSLG11,2014-03-31,216799134,0,216799134
22020,591,$JSLG11,2014-06-30,216799134,0,216799134
22020,591,$JSLG11,2014-09-30,216799134,0,216799134
22020,591,$JSLG11,2014-12-31,216799134,0,216799134
22020,591,$JSLG11,2015-03-31,216799134,0,216799134
22020,591,$JSLG11,2015-06-30,216799134,0,216799134
22020,591,$JSLG11,2015-09-30,211000000,0,211000000
22020,591,$JSLG11,2015-12-31,211000000,0,211000000
22020,591,$JSLG11,2016-03-31,211000000,0,211000000
22020,591,$JSLG11,2016-06-30,206000000,0,206000000
22020,591,$JSLG11,2016-09-30,202500000,0,202500000
22020,591,$JSLG11,2016-12-31,202500000,0,202500000
22020,591,$JSLG11,2017-03-31,202500000,0,202500000
22020,591,$JSLG11,2017-06-30,202500000,0,202500000
22020,591,$JSLG11,2017-09-30,202500000,0,202500000
22020,591,$JSLG11,2017-12-31,202500000,0,202500000
22020,591,$JSLG11,2018-03-31,202500000,0,202500000
22020,591,$JSLG11,2018-06-30,202500000,0,202500000
22020,591,$JSLG11,2018-09-30,202500000,0,202500000
22020,591,$JSLG11,2018-12-31,205114532,0,205114532
22020,591,$JSLG11,2019-03-31,205114532,0,205114532
22020,591,$JSLG11,2019-06-30,205537500,0,205537500
22020,591,$JSLG11,2019-09-30,206746161,0,206746161
22020,591,$JSLG11,2019-12-31,206788866,0,206788866
22020,591,$JSLG11,2020-03-31,206798715,0,206798715
22020,591,$JSLG11,2020-06-30,207735316,0,207735316
22020,591,$JSLG11,2020-09-30,279991078,0,279991078
22055,402,$022055,2010-12-31,184551,0,184551
22055,402,$022055,2011-03-31,184551,0,184551
22055,402,$022055,2011-06-30,184551,0,184551
22055,402,$022055,2011-09-30,184551,0,184551
22055,402,$022055,2011-12-31,184551,0,184551
22055,402,$022055,2012-03-31,185301,0,185301
22055,402,$022055,2012-06-30,185449,0,185449
22055,402,$022055,2012-09-30,185449,0,185449
22055,402,$022055,2012-12-31,185449,0,185449
22055,402,$022055,2013-03-31,185448,0,185448
22055,402,$022055,2013-06-30,185532,0,185532
22055,402,$022055,2013-09-30,185532,0,185532
22055,402,$022055,2013-12-31,185533,0,185533
22055,402,$022055,2014-03-31,185532,0,185532
22055,402,$022055,2014-06-30,185532,0,185532
22055,402,$022055,2014-09-30,185532,0,185532
22055,402,$022055,2014-12-31,185533,0,185533
22055,402,$022055,2015-03-31,185532,0,185532
22055,402,$022055,2015-06-30,185532,0,185532
22055,402,$022055,2015-09-30,204086,0,204086
22055,402,$022055,2015-12-31,204086,0,204086
22055,402,$022055,2016-03-31,204086,0,204086
22055,402,$022055,2016-06-30,204086,0,204086
22055,402,$022055,2016-09-30,204086,0,204086
22055,402,$022055,2016-12-31,204086,0,204086
22055,402,$022055,2017-03-31,204086,0,204086
22055,402,$022055,2017-06-30,899597,0,899597
22055,402,$022055,2017-09-30,204086,0,204086
22055,402,$022055,2017-12-31,204086,0,204086
22055,402,$022055,2018-03-31,204086,0,204086
22055,402,$022055,2018-06-30,204086,0,204086
22055,402,$022055,2018-09-30,204086,0,204086
22055,402,$022055,2018-12-31,204086,0,204086
22055,402,$022055,2019-03-31,204086,0,204086
22055,402,$022055,2019-06-30,204086,0,204086
22055,402,$022055,2019-09-30,204085999,0,204085999
22055,402,$022055,2019-12-31,260857,0,260857
22055,402,$022055,2020-03-31,261667,0,261667
22055,402,$022055,2020-06-30,261667,0,261667
22055,402,$022055,2020-09-30,261667,0,261667
22179,397,$AFLT3,2010-12-31,63085,0,63085
22179,397,$AFLT3,2011-03-31,63085,0,63085
22179,397,$AFLT3,2011-06-30,63085,0,63085
22179,397,$AFLT3,2011-09-30,63085,0,63085
22179,397,$AFLT3,2011-12-31,63085,0,63085
22179,397,$AFLT3,2012-03-31,63085,0,63085
22179,397,$AFLT3,2012-06-30,63085,0,63085
22179,397,$AFLT3,2012-09-30,63085,0,63085
22179,397,$AFLT3,2012-12-31,63085,0,63085
22179,397,$AFLT3,2013-03-31,63085,0,63085
22179,397,$AFLT3,2013-06-30,63095,0,63095
22179,397,$AFLT3,2013-09-30,63095,0,63095
22179,397,$AFLT3,2013-12-31,63085,0,63085
22179,397,$AFLT3,2014-03-31,63085,0,63085
22179,397,$AFLT3,2014-06-30,63085,0,63085
22179,397,$AFLT3,2014-09-30,63085,0,63085
22179,397,$AFLT3,2014-12-31,63085,0,63085
22179,397,$AFLT3,2015-03-31,63085,0,63085
22179,397,$AFLT3,2015-06-30,63085,0,63085
22179,397,$AFLT3,2015-09-30,63085,0,63085
22179,397,$AFLT3,2015-12-31,63085,0,63085
22179,397,$AFLT3,2016-03-31,63085,0,63085
22179,397,$AFLT3,2016-06-30,63085,0,63085
22179,397,$AFLT3,2016-09-30,63085,0,63085
22179,397,$AFLT3,2016-12-31,63085,0,63085
22179,397,$AFLT3,2017-03-31,63085,0,63085
22179,397,$AFLT3,2017-06-30,33085,0,33085
22179,397,$AFLT3,2017-09-30,63085,0,63085
22179,397,$AFLT3,2017-12-31,63085,0,63085
22179,397,$AFLT3,2018-03-31,63085,0,63085
22179,397,$AFLT3,2018-06-30,63085,0,63085
22179,397,$AFLT3,2018-09-30,63085,0,63085
22179,397,$AFLT3,2018-12-31,63085,0,63085
22179,397,$AFLT3,2019-03-31,63085,0,63085
22179,397,$AFLT3,2019-06-30,63084700,0,63084700
22179,397,$AFLT3,2019-09-30,63084700,0,63084700
22179,397,$AFLT3,2019-12-31,63085,0,63085
22179,397,$AFLT3,2020-03-31,63085,0,63085
22179,397,$AFLT3,2020-06-30,63085,0,63085
22179,397,$AFLT3,2020-09-30,63085,0,63085
22187,488,$PRIO3,2010-12-31,4619349,0,4619349
22187,488,$PRIO3,2011-03-31,4684758,0,4684758
22187,488,$PRIO3,2011-06-30,5547770,0,5547770
22187,488,$PRIO3,2011-09-30,5751372,0,5751372
22187,488,$PRIO3,2011-12-31,5856247,0,5856247
22187,488,$PRIO3,2012-03-31,5882409,0,5882409
22187,488,$PRIO3,2012-06-30,294308450,0,294308450
22187,488,$PRIO3,2012-09-30,294711250,0,294711250
22187,488,$PRIO3,2012-12-31,295412650,0,295412650
22187,488,$PRIO3,2013-03-31,296185963,0,296185963
22187,488,$PRIO3,2013-06-30,297462579,0,297462579
22187,488,$PRIO3,2013-09-30,297466746,0,297466746
22187,488,$PRIO3,2013-12-31,297466746,0,297466746
22187,488,$PRIO3,2014-03-31,297466746,0,297466746
22187,488,$PRIO3,2014-06-30,29746675,0,29746675
22187,488,$PRIO3,2014-09-30,29748449,0,29748449
22187,488,$PRIO3,2014-12-31,29748449,0,29748449
22187,488,$PRIO3,2015-03-31,29748449,0,29748449
22187,488,$PRIO3,2015-06-30,29748449,0,29748449
22187,488,$PRIO3,2015-09-30,29748449,0,29748449
22187,488,$PRIO3,2015-12-31,65940277,0,65940277
22187,488,$PRIO3,2016-03-31,65945675,0,65945675
22187,488,$PRIO3,2016-06-30,13790747,0,13790747
22187,488,$PRIO3,2016-09-30,13190747,0,13190747
22187,488,$PRIO3,2016-12-31,13190748,0,13190748
22187,488,$PRIO3,2017-03-31,13190748,0,13190748
22187,488,$PRIO3,2017-06-30,13190747,0,13190747
22187,488,$PRIO3,2017-09-30,13191869,0,13191869
22187,488,$PRIO3,2017-12-31,13191932,0,13191932
22187,488,$PRIO3,2018-03-31,13337039,0,13337039
22187,488,$PRIO3,2018-06-30,13336517,0,13336517
22187,488,$PRIO3,2018-09-30,13336517,0,13336517
22187,488,$PRIO3,2018-12-31,13336517,0,13336517
22187,488,$PRIO3,2019-03-31,137294543,0,137294543
22187,488,$PRIO3,2019-06-30,140964679,0,140964679
22187,488,$PRIO3,2019-09-30,140964679,0,140964679
22187,488,$PRIO3,2019-12-31,143185890,0,143185890
22187,488,$PRIO3,2020-03-31,144685660,0,144685660
22187,488,$PRIO3,2020-06-30,143185890,0,143185890
22187,488,$PRIO3,2020-09-30,144685660,0,144685660
22217,410,$BRIN3,2010-12-31,936216,0,936216
22217,410,$BRIN3,2011-03-31,936216,0,936216
22217,410,$BRIN3,2011-06-30,943314,0,943314
22217,410,$BRIN3,2011-09-30,90549130,0,90549130
22217,410,$BRIN3,2011-12-31,95028140,0,95028140
22217,410,$BRIN3,2012-03-31,95404983,0,95404983
22217,410,$BRIN3,2012-06-30,95961559,0,95961559
22217,410,$BRIN3,2012-09-30,96002504,0,96002504
22217,410,$BRIN3,2012-12-31,96743021,0,96743021
22217,410,$BRIN3,2013-03-31,97053961,0,97053961
22217,410,$BRIN3,2013-06-30,97601650,0,97601650
22217,410,$BRIN3,2013-09-30,97744763,0,97744763
22217,410,$BRIN3,2013-12-31,98312688,0,98312688
22217,410,$BRIN3,2014-03-31,99128905,0,99128905
22217,410,$BRIN3,2014-06-30,99512851,0,99512851
22217,410,$BRIN3,2014-09-30,99853019,0,99853019
22217,410,$BRIN3,2014-12-31,99953713,0,99953713
22217,410,$BRIN3,2015-03-31,96657589,0,96657589
22217,410,$BRIN3,2015-06-30,96823071,0,96823071
22217,410,$BRIN3,2015-09-30,97255431,0,97255431
22217,410,$BRIN3,2015-12-31,5172939,0,5172939
22217,410,$BRIN3,2016-03-31,7528449,0,7528449
22217,410,$BRIN3,2016-06-30,7581958,0,7581958
22217,410,$BRIN3,2016-09-30,7657970,0,7657970
22217,410,$BRIN3,2016-12-31,7657970,0,7657970
22217,410,$BRIN3,2017-03-31,7668192,0,7668192
22217,410,$BRIN3,2017-06-30,7668192,0,7668192
22217,410,$BRIN3,2017-09-30,7668716,0,7668716
22217,410,$BRIN3,2017-12-31,7668764,0,7668764
22217,410,$BRIN3,2018-03-31,7678388,0,7678388
22217,410,$BRIN3,2018-06-30,7678388,0,7678388
22217,410,$BRIN3,2018-09-30,7678388,0,7678388
22217,410,$BRIN3,2018-12-31,7678388,0,7678388
22217,410,$BRIN3,2019-03-31,7678388,0,7678388
22217,410,$BRIN3,2019-06-30,7678388,0,7678388
22217,410,$BRIN3,2019-09-30,7678388,0,7678388
22217,410,$BRIN3,2019-12-31,11480134,0,11480134
22217,410,$BRIN3,2020-03-31,11480134,0,11480134
22217,410,$BRIN3,2020-06-30,11480134,0,11480134
22217,410,$BRIN3,2020-09-30,11480134,0,11480134
22217,411,$APER3,2010-12-31,936216,0,936216
22217,411,$APER3,2011-03-31,936216,0,936216
22217,411,$APER3,2011-06-30,943314,0,943314
22217,411,$APER3,2011-09-30,90549130,0,90549130
22217,411,$APER3,2011-12-31,95028140,0,95028140
22217,411,$APER3,2012-03-31,95404983,0,95404983
22217,411,$APER3,2012-06-30,95961559,0,95961559
22217,411,$APER3,2012-09-30,96002504,0,96002504
22217,411,$APER3,2012-12-31,96743021,0,96743021
22217,411,$APER3,2013-03-31,97053961,0,97053961
22217,411,$APER3,2013-06-30,97601650,0,97601650
22217,411,$APER3,2013-09-30,97744763,0,97744763
22217,411,$APER3,2013-12-31,98312688,0,98312688
22217,411,$APER3,2014-03-31,99128905,0,99128905
22217,411,$APER3,2014-06-30,99512851,0,99512851
22217,411,$APER3,2014-09-30,99853019,0,99853019
22217,411,$APER3,2014-12-31,99953713,0,99953713
22217,411,$APER3,2015-03-31,96657589,0,96657589
22217,411,$APER3,2015-06-30,96823071,0,96823071
22217,411,$APER3,2015-09-30,97255431,0,97255431
22217,411,$APER3,2015-12-31,5172939,0,5172939
22217,411,$APER3,2016-03-31,7528449,0,7528449
22217,411,$APER3,2016-06-30,7581958,0,7581958
22217,411,$APER3,2016-09-30,7657970,0,7657970
22217,411,$APER3,2016-12-31,7657970,0,7657970
22217,411,$APER3,2017-03-31,7668192,0,7668192
22217,411,$APER3,2017-06-30,7668192,0,7668192
22217,411,$APER3,2017-09-30,7668716,0,7668716
22217,411,$APER3,2017-12-31,7668764,0,7668764
22217,411,$APER3,2018-03-31,7678388,0,7678388
22217,411,$APER3,2018-06-30,7678388,0,7678388
22217,411,$APER3,2018-09-30,7678388,0,7678388
22217,411,$APER3,2018-12-31,7678388,0,7678388
22217,411,$APER3,2019-03-31,7678388,0,7678388
22217,411,$APER3,2019-06-30,7678388,0,7678388
22217,411,$APER3,2019-09-30,7678388,0,7678388
22217,411,$APER3,2019-12-31,11480134,0,11480134
22217,411,$APER3,2020-03-31,11480134,0,11480134
22217,411,$APER3,2020-06-30,11480134,0,11480134
22217,411,$APER3,2020-09-30,11480134,0,11480134
22349,404,$ARZZ3,2010-12-31,78248,0,78248
22349,404,$ARZZ3,2011-03-31,88542,0,88542
22349,404,$ARZZ3,2011-06-30,88542,0,88542
22349,404,$ARZZ3,2011-09-30,88542,0,88542
22349,404,$ARZZ3,2011-12-31,88542,0,88542
22349,404,$ARZZ3,2012-03-31,88542,0,88542
22349,404,$ARZZ3,2012-06-30,88542,0,88542
22349,404,$ARZZ3,2012-09-30,88587,0,88587
22349,404,$ARZZ3,2012-12-31,88587,0,88587
22349,404,$ARZZ3,2013-03-31,88587,0,88587
22349,404,$ARZZ3,2013-06-30,88587,0,88587
22349,404,$ARZZ3,2013-09-30,88637,0,88637
22349,404,$ARZZ3,2013-12-31,88637,0,88637
22349,404,$ARZZ3,2014-03-31,88637,0,88637
22349,404,$ARZZ3,2014-06-30,88637,0,88637
22349,404,$ARZZ3,2014-09-30,88682,0,88682
22349,404,$ARZZ3,2014-12-31,88682,0,88682
22349,404,$ARZZ3,2015-03-31,88682,0,88682
22349,404,$ARZZ3,2015-06-30,88682,0,88682
22349,404,$ARZZ3,2015-09-30,88735,0,88735
22349,404,$ARZZ3,2015-12-31,88735,0,88735
22349,404,$ARZZ3,2016-03-31,88735,0,88735
22349,404,$ARZZ3,2016-06-30,88783,0,88783
22349,404,$ARZZ3,2016-09-30,88836,0,88836
22349,404,$ARZZ3,2016-12-31,88836,0,88836
22349,404,$ARZZ3,2017-03-31,88836,0,88836
22349,404,$ARZZ3,2017-06-30,89766,0,89766
22349,404,$ARZZ3,2017-09-30,89766,0,89766
22349,404,$ARZZ3,2017-12-31,89766,0,89766
22349,404,$ARZZ3,2018-03-31,89766,0,89766
22349,404,$ARZZ3,2018-06-30,90303,0,90303
22349,404,$ARZZ3,2018-09-30,90303,0,90303
22349,404,$ARZZ3,2018-12-31,90303,0,90303
22349,404,$ARZZ3,2019-03-31,90303,0,90303
22349,404,$ARZZ3,2019-06-30,90954,0,90954
22349,404,$ARZZ3,2019-09-30,90954,0,90954
22349,404,$ARZZ3,2019-12-31,90954,0,90954
22349,404,$ARZZ3,2020-03-31,90954,0,90954
22349,404,$ARZZ3,2020-06-30,90954,0,90954
22349,404,$ARZZ3,2020-09-30,90954,0,90954
22357,489,$SSBR3,2010-12-31,531728,0,531728
22357,489,$SSBR3,2011-03-31,76423831,0,76423831
22357,489,$SSBR3,2011-06-30,76423831,0,76423831
22357,489,$SSBR3,2011-09-30,76423831,0,76423831
22357,489,$SSBR3,2011-12-31,76423831,0,76423831
22357,489,$SSBR3,2012-03-31,76423831,0,76423831
22357,489,$SSBR3,2012-06-30,76423831,0,76423831
22357,489,$SSBR3,2012-09-30,76423831,0,76423831
22357,489,$SSBR3,2012-12-31,76423831,0,76423831
22357,489,$SSBR3,2013-03-31,76423831,0,76423831
22357,489,$SSBR3,2013-06-30,76423831,0,76423831
22357,489,$SSBR3,2013-09-30,76423831,0,76423831
22357,489,$SSBR3,2013-12-31,76423831,0,76423831
22357,489,$SSBR3,2014-03-31,76423831,0,76423831
22357,489,$SSBR3,2014-06-30,76423831,0,76423831
22357,489,$SSBR3,2014-09-30,76423831,0,76423831
22357,489,$SSBR3,2014-12-31,76423831,0,76423831
22357,489,$SSBR3,2015-03-31,76423831,0,76423831
22357,489,$SSBR3,2015-06-30,76423831,0,76423831
22357,489,$SSBR3,2015-09-30,76423831,0,76423831
22357,489,$SSBR3,2015-12-31,76423831,0,76423831
22357,489,$SSBR3,2016-03-31,76423831,0,76423831
22357,489,$SSBR3,2016-06-30,76423831,0,76423831
22357,489,$SSBR3,2016-09-30,76423831,0,76423831
22357,489,$SSBR3,2016-12-31,76423831,0,76423831
22357,489,$SSBR3,2017-03-31,76423831,0,76423831
22357,489,$SSBR3,2017-06-30,76423831,0,76423831
22357,489,$SSBR3,2017-09-30,76423831,0,76423831
22357,489,$SSBR3,2017-12-31,76423831,0,76423831
22357,489,$SSBR3,2018-03-31,76423831,0,76423831
22357,489,$SSBR3,2018-06-30,76423831,0,76423831
22357,489,$SSBR3,2018-09-30,76423831,0,76423831
22357,489,$SSBR3,2018-12-31,76423831,0,76423831
22357,489,$SSBR3,2019-03-31,76423831,0,76423831
22357,489,$SSBR3,2019-06-30,76423831,0,76423831
22357,489,$SSBR3,2019-09-30,238080470,0,238080470
22357,489,$SSBR3,2019-12-31,265772778,0,265772778
22357,489,$SSBR3,2020-03-31,265772778,0,265772778
22357,489,$SSBR3,2020-06-30,265785681,0,265785681
22357,489,$SSBR3,2020-09-30,265772778,0,265772778
22357,490,$ALSO3,2010-12-31,531728,0,531728
22357,490,$ALSO3,2011-03-31,76423831,0,76423831
22357,490,$ALSO3,2011-06-30,76423831,0,76423831
22357,490,$ALSO3,2011-09-30,76423831,0,76423831
22357,490,$ALSO3,2011-12-31,76423831,0,76423831
22357,490,$ALSO3,2012-03-31,76423831,0,76423831
22357,490,$ALSO3,2012-06-30,76423831,0,76423831
22357,490,$ALSO3,2012-09-30,76423831,0,76423831
22357,490,$ALSO3,2012-12-31,76423831,0,76423831
22357,490,$ALSO3,2013-03-31,76423831,0,76423831
22357,490,$ALSO3,2013-06-30,76423831,0,76423831
22357,490,$ALSO3,2013-09-30,76423831,0,76423831
22357,490,$ALSO3,2013-12-31,76423831,0,76423831
22357,490,$ALSO3,2014-03-31,76423831,0,76423831
22357,490,$ALSO3,2014-06-30,76423831,0,76423831
22357,490,$ALSO3,2014-09-30,76423831,0,76423831
22357,490,$ALSO3,2014-12-31,76423831,0,76423831
22357,490,$ALSO3,2015-03-31,76423831,0,76423831
22357,490,$ALSO3,2015-06-30,76423831,0,76423831
22357,490,$ALSO3,2015-09-30,76423831,0,76423831
22357,490,$ALSO3,2015-12-31,76423831,0,76423831
22357,490,$ALSO3,2016-03-31,76423831,0,76423831
22357,490,$ALSO3,2016-06-30,76423831,0,76423831
22357,490,$ALSO3,2016-09-30,76423831,0,76423831
22357,490,$ALSO3,2016-12-31,76423831,0,76423831
22357,490,$ALSO3,2017-03-31,76423831,0,76423831
22357,490,$ALSO3,2017-06-30,76423831,0,76423831
22357,490,$ALSO3,2017-09-30,76423831,0,76423831
22357,490,$ALSO3,2017-12-31,76423831,0,76423831
22357,490,$ALSO3,2018-03-31,76423831,0,76423831
22357,490,$ALSO3,2018-06-30,76423831,0,76423831
22357,490,$ALSO3,2018-09-30,76423831,0,76423831
22357,490,$ALSO3,2018-12-31,76423831,0,76423831
22357,490,$ALSO3,2019-03-31,76423831,0,76423831
22357,490,$ALSO3,2019-06-30,76423831,0,76423831
22357,490,$ALSO3,2019-09-30,238080470,0,238080470
22357,490,$ALSO3,2019-12-31,265772778,0,265772778
22357,490,$ALSO3,2020-03-31,265772778,0,265772778
22357,490,$ALSO3,2020-06-30,265785681,0,265785681
22357,490,$ALSO3,2020-09-30,265772778,0,265772778
22365,403,$QGEP3,2010-12-31,62021962,0,62021962
22365,403,$QGEP3,2011-03-31,265806905,0,265806905
22365,403,$QGEP3,2011-06-30,265806905,0,265806905
22365,403,$QGEP3,2011-09-30,265806905,0,265806905
22365,403,$QGEP3,2011-12-31,265806905,0,265806905
22365,403,$QGEP3,2012-03-31,265806905,0,265806905
22365,403,$QGEP3,2012-06-30,265806905,0,265806905
22365,403,$QGEP3,2012-09-30,265806905,0,265806905
22365,403,$QGEP3,2012-12-31,265806905,0,265806905
22365,403,$QGEP3,2013-03-31,265806905,0,265806905
22365,403,$QGEP3,2013-06-30,265806905,0,265806905
22365,403,$QGEP3,2013-09-30,265806905,0,265806905
22365,403,$QGEP3,2013-12-31,265806905,0,265806905
22365,403,$QGEP3,2014-03-31,265806905,0,265806905
22365,403,$QGEP3,2014-06-30,265806905,0,265806905
22365,403,$QGEP3,2014-09-30,265806905,0,265806905
22365,403,$QGEP3,2014-12-31,265806905,0,265806905
22365,403,$QGEP3,2015-03-31,265806905,0,265806905
22365,403,$QGEP3,2015-06-30,265806905,0,265806905
22365,403,$QGEP3,2015-09-30,265806905,0,265806905
22365,403,$QGEP3,2015-12-31,265806905,0,265806905
22365,403,$QGEP3,2016-03-31,265806905,0,265806905
22365,403,$QGEP3,2016-06-30,265806905,0,265806905
22365,403,$QGEP3,2016-09-30,265806905,0,265806905
22365,403,$QGEP3,2016-12-31,265806905,0,265806905
22365,403,$QGEP3,2017-03-31,265806905,0,265806905
22365,403,$QGEP3,2017-06-30,265806905,0,265806905
22365,403,$QGEP3,2017-09-30,265806905,0,265806905
22365,403,$QGEP3,2017-12-31,265806905,0,265806905
22365,403,$QGEP3,2018-03-31,265806805,0,265806805
22365,403,$QGEP3,2018-06-30,265806905,0,265806905
22365,403,$QGEP3,2018-09-30,265806905,0,265806905
22365,403,$QGEP3,2018-12-31,265806905,0,265806905
22365,403,$QGEP3,2019-03-31,265806905,0,265806905
22365,403,$QGEP3,2019-06-30,265806905,0,265806905
22365,403,$QGEP3,2019-09-30,265806905,0,265806905
22365,403,$QGEP3,2019-12-31,265806905,0,265806905
22365,403,$QGEP3,2020-03-31,265806905,0,265806905
22365,403,$QGEP3,2020-06-30,265806905,0,265806905
22365,403,$QGEP3,2020-09-30,265806905,0,265806905
22365,405,$ENAT3,2010-12-31,62021962,0,62021962
22365,405,$ENAT3,2011-03-31,265806905,0,265806905
22365,405,$ENAT3,2011-06-30,265806905,0,265806905
22365,405,$ENAT3,2011-09-30,265806905,0,265806905
22365,405,$ENAT3,2011-12-31,265806905,0,265806905
22365,405,$ENAT3,2012-03-31,265806905,0,265806905
22365,405,$ENAT3,2012-06-30,265806905,0,265806905
22365,405,$ENAT3,2012-09-30,265806905,0,265806905
22365,405,$ENAT3,2012-12-31,265806905,0,265806905
22365,405,$ENAT3,2013-03-31,265806905,0,265806905
22365,405,$ENAT3,2013-06-30,265806905,0,265806905
22365,405,$ENAT3,2013-09-30,265806905,0,265806905
22365,405,$ENAT3,2013-12-31,265806905,0,265806905
22365,405,$ENAT3,2014-03-31,265806905,0,265806905
22365,405,$ENAT3,2014-06-30,265806905,0,265806905
22365,405,$ENAT3,2014-09-30,265806905,0,265806905
22365,405,$ENAT3,2014-12-31,265806905,0,265806905
22365,405,$ENAT3,2015-03-31,265806905,0,265806905
22365,405,$ENAT3,2015-06-30,265806905,0,265806905
22365,405,$ENAT3,2015-09-30,265806905,0,265806905
22365,405,$ENAT3,2015-12-31,265806905,0,265806905
22365,405,$ENAT3,2016-03-31,265806905,0,265806905
22365,405,$ENAT3,2016-06-30,265806905,0,265806905
22365,405,$ENAT3,2016-09-30,265806905,0,265806905
22365,405,$ENAT3,2016-12-31,265806905,0,265806905
22365,405,$ENAT3,2017-03-31,265806905,0,265806905
22365,405,$ENAT3,2017-06-30,265806905,0,265806905
22365,405,$ENAT3,2017-09-30,265806905,0,265806905
22365,405,$ENAT3,2017-12-31,265806905,0,265806905
22365,405,$ENAT3,2018-03-31,265806805,0,265806805
22365,405,$ENAT3,2018-06-30,265806905,0,265806905
22365,405,$ENAT3,2018-09-30,265806905,0,265806905
22365,405,$ENAT3,2018-12-31,265806905,0,265806905
22365,405,$ENAT3,2019-03-31,265806905,0,265806905
22365,405,$ENAT3,2019-06-30,265806905,0,265806905
22365,405,$ENAT3,2019-09-30,265806905,0,265806905
22365,405,$ENAT3,2019-12-31,265806905,0,265806905
22365,405,$ENAT3,2020-03-31,265806905,0,265806905
22365,405,$ENAT3,2020-06-30,265806905,0,265806905
22365,405,$ENAT3,2020-09-30,265806905,0,265806905
22454,406,$SHOW3,2010-12-31,57466,0,57466
22454,406,$SHOW3,2011-03-31,57466,0,57466
22454,406,$SHOW3,2011-06-30,69190,0,69190
22454,406,$SHOW3,2011-09-30,69290,0,69290
22454,406,$SHOW3,2011-12-31,69290,0,69290
22454,406,$SHOW3,2012-03-31,69290,0,69290
22454,406,$SHOW3,2012-06-30,69290,0,69290
22454,406,$SHOW3,2012-09-30,69791,0,69791
22454,406,$SHOW3,2012-12-31,69791,0,69791
22454,406,$SHOW3,2013-03-31,69791,0,69791
22454,406,$SHOW3,2013-06-30,69791,0,69791
22454,406,$SHOW3,2013-09-30,69791,0,69791
22454,406,$SHOW3,2013-12-31,69791,0,69791
22454,406,$SHOW3,2014-03-31,69791,0,69791
22454,406,$SHOW3,2014-06-30,69791,0,69791
22454,406,$SHOW3,2014-09-30,69791,0,69791
22454,406,$SHOW3,2014-12-31,67949,0,67949
22454,406,$SHOW3,2015-03-31,67500,0,67500
22454,406,$SHOW3,2015-06-30,69728,0,69728
22454,406,$SHOW3,2015-09-30,67501,0,67501
22454,406,$SHOW3,2015-12-31,67501,0,67501
22454,406,$SHOW3,2016-03-31,67501,0,67501
22454,406,$SHOW3,2016-06-30,67501,0,67501
22454,406,$SHOW3,2016-09-30,67501,0,67501
22454,406,$SHOW3,2016-12-31,67501,0,67501
22454,406,$SHOW3,2017-03-31,67501,0,67501
22454,406,$SHOW3,2017-06-30,67501,0,67501
22454,406,$SHOW3,2017-09-30,67501,0,67501
22454,406,$SHOW3,2017-12-31,67501,0,67501
22454,406,$SHOW3,2018-03-31,67501,0,67501
22454,406,$SHOW3,2018-06-30,67501,0,67501
22454,406,$SHOW3,2018-09-30,67501,0,67501
22454,406,$SHOW3,2018-12-31,67501,0,67501
22454,406,$SHOW3,2019-03-31,67501,0,67501
22454,406,$SHOW3,2019-06-30,67501,0,67501
22454,406,$SHOW3,2019-09-30,67501,0,67501
22454,406,$SHOW3,2019-12-31,67501,0,67501
22454,406,$SHOW3,2020-03-31,67501,0,67501
22454,406,$SHOW3,2020-06-30,67501,0,67501
22454,406,$SHOW3,2020-09-30,67413,0,67413
22470,409,$MGLU3,2010-12-31,150000,0,150000
22470,409,$MGLU3,2011-03-31,150000,0,150000
22470,409,$MGLU3,2011-06-30,186494,0,186494
22470,409,$MGLU3,2011-09-30,186494,0,186494
22470,409,$MGLU3,2011-09-30,186494,0,186494
22470,409,$MGLU3,2011-12-31,186494,0,186494
22470,409,$MGLU3,2012-03-31,186494,0,186494
22470,409,$MGLU3,2012-03-31,186494,0,186494
22470,409,$MGLU3,2012-06-30,186494467,0,186494467
22470,409,$MGLU3,2012-06-30,186494467,0,186494467
22470,409,$MGLU3,2012-09-30,186494,0,186494
22470,409,$MGLU3,2012-12-31,186494,0,186494
22470,409,$MGLU3,2013-03-31,186494,0,186494
22470,409,$MGLU3,2013-06-30,186494,0,186494
22470,409,$MGLU3,2013-06-30,186494,0,186494
22470,409,$MGLU3,2013-09-30,186494,0,186494
22470,409,$MGLU3,2013-12-31,186494,0,186494
22470,409,$MGLU3,2014-03-31,186494467,0,186494467
22470,409,$MGLU3,2014-03-31,186494467,0,186494467
22470,409,$MGLU3,2014-06-30,181494467,0,181494467
22470,409,$MGLU3,2014-09-30,181494467,0,181494467
22470,409,$MGLU3,2014-12-31,181494467,0,181494467
22470,409,$MGLU3,2015-03-31,181494467,0,181494467
22470,409,$MGLU3,2015-06-30,177991467,0,177991467
22470,409,$MGLU3,2015-09-30,22248933,0,22248933
22470,409,$MGLU3,2015-12-31,22248933,0,22248933
22470,409,$MGLU3,2015-12-31,22248933,0,22248933
22470,409,$MGLU3,2016-03-31,22248933,0,22248933
22470,409,$MGLU3,2016-06-30,21623933,0,21623933
22470,409,$MGLU3,2016-09-30,21623933,0,21623933
22470,409,$MGLU3,2016-12-31,21623933,0,21623933
22470,409,$MGLU3,2016-12-31,21623933,0,21623933
22470,409,$MGLU3,2017-03-31,21623933,0,21623933
22470,409,$MGLU3,2017-03-31,21623933,0,21623933
22470,409,$MGLU3,2017-06-30,172991464,0,172991464
22470,409,$MGLU3,2017-06-30,21623933,0,21623933
22470,409,$MGLU3,2017-09-30,190591464,0,190591464
22470,409,$MGLU3,2017-12-31,190591464,0,190591464
22470,409,$MGLU3,2018-03-31,190591494,0,190591494
22470,409,$MGLU3,2018-06-30,190591464,0,190591464
22470,409,$MGLU3,2018-09-30,190591464,0,190591464
22470,409,$MGLU3,2018-12-31,190591464,0,190591464
22470,409,$MGLU3,2019-03-31,190591464,0,190591464
22470,409,$MGLU3,2019-06-30,1524731712,0,1524731712
22470,409,$MGLU3,2019-09-30,1524731712,0,1524731712
22470,409,$MGLU3,2019-12-31,1624731712,0,1624731712
22470,409,$MGLU3,2020-03-31,1624731712,0,1624731712
22470,409,$MGLU3,2020-06-30,1624731712,0,1624731712
22470,409,$MGLU3,2020-09-30,6498926848,0,6498926848
22497,491,$QUAL3,2010-12-31,1614883,0,1614883
22497,491,$QUAL3,2011-03-31,1614883,0,1614883
22497,491,$QUAL3,2011-06-30,258631234,0,258631234
22497,491,$QUAL3,2011-09-30,258631234,0,258631234
22497,491,$QUAL3,2011-12-31,260083463,0,260083463
22497,491,$QUAL3,2012-03-31,260083463,0,260083463
22497,491,$QUAL3,2012-06-30,263142831,0,263142831
22497,491,$QUAL3,2012-09-30,263329770,0,263329770
22497,491,$QUAL3,2012-12-31,263401198,0,263401198
22497,491,$QUAL3,2013-03-31,264115480,0,264115480
22497,491,$QUAL3,2013-06-30,265995495,0,265995495
22497,491,$QUAL3,2013-09-30,266209780,0,266209780
22497,491,$QUAL3,2013-12-31,266602637,0,266602637
22497,491,$QUAL3,2014-03-31,266602637,0,266602637
22497,491,$QUAL3,2014-06-30,267984987,0,267984987
22497,491,$QUAL3,2014-09-30,273387588,0,273387588
22497,491,$QUAL3,2014-12-31,273412588,0,273412588
22497,491,$QUAL3,2015-03-31,273662588,0,273662588
22497,491,$QUAL3,2015-06-30,274325088,0,274325088
22497,491,$QUAL3,2015-09-30,274325088,0,274325088
22497,491,$QUAL3,2015-12-31,274325088,0,274325088
22497,491,$QUAL3,2016-03-31,274325088,0,274325088
22497,491,$QUAL3,2016-06-30,274325088,0,274325088
22497,491,$QUAL3,2016-09-30,278794088,0,278794088
22497,491,$QUAL3,2016-12-31,278794088,0,278794088
22497,491,$QUAL3,2017-03-31,278794088,0,278794088
22497,491,$QUAL3,2017-06-30,285491088,0,285491088
22497,491,$QUAL3,2017-09-30,288332588,0,288332588
22497,491,$QUAL3,2017-12-31,288967088,0,288967088
22497,491,$QUAL3,2018-03-31,282176825,0,282176825
22497,491,$QUAL3,2018-06-30,283176825,0,283176825
22497,491,$QUAL3,2018-09-30,283176825,0,283176825
22497,491,$QUAL3,2018-12-31,283176825,0,283176825
22497,491,$QUAL3,2019-03-31,283176825,0,283176825
22497,491,$QUAL3,2019-06-30,283239325,0,283239325
22497,491,$QUAL3,2019-09-30,283339225,0,283339225
22497,491,$QUAL3,2019-12-31,284014325,0,284014325
22497,491,$QUAL3,2020-03-31,284014325,0,284014325
22497,491,$QUAL3,2020-06-30,284014325,0,284014325
22497,491,$QUAL3,2020-09-30,284014325,0,284014325
22500,493,$BPHA3,2010-12-31,73950000,0,73950000
22500,493,$BPHA3,2011-03-31,334008405,0,334008405
22500,493,$BPHA3,2011-06-30,79849579,0,79849579
22500,493,$BPHA3,2011-09-30,79849579,0,79849579
22500,493,$BPHA3,2011-12-31,159699158,0,159699158
22500,493,$BPHA3,2012-03-31,183711518,0,183711518
22500,493,$BPHA3,2012-06-30,230173719,0,230173719
22500,493,$BPHA3,2012-09-30,254649970,0,254649970
22500,493,$BPHA3,2012-12-31,254649970,0,254649970
22500,493,$BPHA3,2013-03-31,254649970,0,254649970
22500,493,$BPHA3,2013-06-30,256384419,0,256384419
22500,493,$BPHA3,2013-09-30,256384419,0,256384419
22500,493,$BPHA3,2013-12-31,256384419,0,256384419
22500,493,$BPHA3,2014-03-31,256384419,0,256384419
22500,493,$BPHA3,2014-06-30,363051086,0,363051086
22500,493,$BPHA3,2014-09-30,363051086,0,363051086
22500,493,$BPHA3,2014-12-31,363051086,0,363051086
22500,493,$BPHA3,2015-03-31,363051086,0,363051086
22500,493,$BPHA3,2015-06-30,363051086,0,363051086
22500,493,$BPHA3,2015-09-30,363051086,0,363051086
22500,493,$BPHA3,2015-12-31,7261021,0,7261021
22500,493,$BPHA3,2016-03-31,113081127,0,113081127
22500,493,$BPHA3,2016-06-30,113081127,0,113081127
22500,493,$BPHA3,2016-09-30,113081127,0,113081127
22500,493,$BPHA3,2016-12-31,113081127,0,113081127
22500,493,$BPHA3,2017-03-31,113081127,0,113081127
22500,493,$BPHA3,2017-06-30,113081127,0,113081127
22500,493,$BPHA3,2017-09-30,113081127,0,113081127
22500,493,$BPHA3,2017-12-31,113081127,0,113081127
22500,493,$BPHA3,2018-03-31,113081127,0,113081127
22500,493,$BPHA3,2018-06-30,113081027,0,113081027
22500,493,$BPHA3,2018-09-30,113081027,0,113081027
22500,493,$BPHA3,2018-12-31,113081127,0,113081127
22500,493,$BPHA3,2019-03-31,113081127,0,113081127
22519,492,$TECN3,2010-12-31,128591827,0,128591827
22519,492,$TECN3,2011-03-31,128591827,0,128591827
22519,492,$TECN3,2011-06-30,65229260,0,65229260
22519,492,$TECN3,2011-09-30,76175206,0,76175206
22519,492,$TECN3,2011-12-31,76175206,0,76175206
22519,492,$TECN3,2012-03-31,76175206,0,76175206
22519,492,$TECN3,2012-06-30,77094076,0,77094076
22519,492,$TECN3,2012-09-30,77183412,0,77183412
22519,492,$TECN3,2012-12-31,77183412,0,77183412
22519,492,$TECN3,2013-03-31,77183412,0,77183412
22519,492,$TECN3,2013-06-30,77636196,0,77636196
22519,492,$TECN3,2013-09-30,77636196,0,77636196
22519,492,$TECN3,2013-12-31,77636196,0,77636196
22519,492,$TECN3,2014-03-31,77749055,0,77749055
22519,492,$TECN3,2014-06-30,77964577,0,77964577
22519,492,$TECN3,2014-09-30,78506215,0,78506215
22519,492,$TECN3,2014-12-31,78506215,0,78506215
22519,492,$TECN3,2015-03-31,78506215,0,78506215
22519,492,$TECN3,2015-06-30,78506215,0,78506215
22519,492,$TECN3,2015-09-30,78506215,0,78506215
22519,492,$TECN3,2015-12-31,78506215,0,78506215
22519,492,$TECN3,2016-03-31,78506215,0,78506215
22519,492,$TECN3,2016-06-30,78506215,0,78506215
22519,492,$TECN3,2016-09-30,78506215,0,78506215
22519,492,$TECN3,2016-12-31,78506215,0,78506215
22519,492,$TECN3,2017-03-31,78506215,0,78506215
22519,492,$TECN3,2017-06-30,78506215,0,78506215
22519,492,$TECN3,2017-09-30,78506215,0,78506215
22519,492,$TECN3,2017-12-31,78506215,0,78506215
22519,492,$TECN3,2018-03-31,78506215,0,78506215
22519,492,$TECN3,2018-06-30,78506215,0,78506215
22519,492,$TECN3,2018-09-30,78506215,0,78506215
22519,492,$TECN3,2018-12-31,78506215,0,78506215
22519,492,$TECN3,2019-03-31,78506215,0,78506215
22519,492,$TECN3,2019-06-30,78506215,0,78506215
22519,492,$TECN3,2019-09-30,78506215,0,78506215
22519,492,$TECN3,2019-12-31,78506215,0,78506215
22519,492,$TECN3,2020-03-31,78506215,0,78506215
22519,492,$TECN3,2020-06-30,78506215,0,78506215
22519,492,$TECN3,2020-09-30,78506215,0,78506215
22594,408,$STKF3,2010-12-31,100000000,0,100000000
22594,408,$STKF3,2011-03-31,100000000,0,100000000
22594,408,$STKF3,2011-06-30,100000000,0,100000000
22594,408,$STKF3,2011-09-30,100000000,0,100000000
22594,408,$STKF3,2011-12-31,100000000,0,100000000
22594,408,$STKF3,2012-03-31,107439555,0,107439555
22594,408,$STKF3,2012-06-30,107439555,0,107439555
22594,408,$STKF3,2012-09-30,107439555,0,107439555
22594,408,$STKF3,2012-12-31,107439555,0,107439555
22594,408,$STKF3,2013-03-31,107439555,0,107439555
22594,408,$STKF3,2013-06-30,107439555,0,107439555
22594,408,$STKF3,2013-09-30,107439555,0,107439555
22594,408,$STKF3,2013-12-31,117001722,0,117001722
22594,408,$STKF3,2014-03-31,117001722,0,117001722
22594,408,$STKF3,2014-06-30,117001722,0,117001722
22594,408,$STKF3,2014-09-30,117001722,0,117001722
22594,408,$STKF3,2014-12-31,117001722,0,117001722
22594,408,$STKF3,2015-03-31,117001722,0,117001722
22594,408,$STKF3,2015-06-30,123120677,0,123120677
22594,408,$STKF3,2015-09-30,143347224,0,143347224
22594,408,$STKF3,2015-12-31,143347224,0,143347224
22594,408,$STKF3,2016-03-31,143347224,0,143347224
22594,408,$STKF3,2016-06-30,143347224,0,143347224
22594,408,$STKF3,2016-09-30,143347224,0,143347224
22594,408,$STKF3,2016-12-31,143347224,0,143347224
22594,408,$STKF3,2017-03-31,143347224,0,143347224
22594,408,$STKF3,2017-06-30,143347224,0,143347224
22594,408,$STKF3,2017-09-30,143347224,0,143347224
22594,408,$STKF3,2017-12-31,143347224,0,143347224
22594,408,$STKF3,2018-03-31,143347224,0,143347224
22594,408,$STKF3,2018-06-30,143347224,0,143347224
22594,408,$STKF3,2018-09-30,143347224,0,143347224
22594,408,$STKF3,2018-12-31,218370694,0,218370694
22594,408,$STKF3,2019-03-31,218370694,0,218370694
22594,408,$STKF3,2019-06-30,218370694,0,218370694
22594,408,$STKF3,2019-09-30,218370694,0,218370694
22594,408,$STKF3,2019-12-31,218370694,0,218370694
22594,408,$STKF3,2020-03-31,218370694,0,218370694
22594,408,$STKF3,2020-06-30,218370694,0,218370694
22594,408,$STKF3,2020-09-30,218370694,0,218370694
22675,593,$HBSA3,2010-12-31,395000,0,395000
22675,593,$HBSA3,2011-03-31,16795000,0,16795000
22675,593,$HBSA3,2011-06-30,16795000,0,16795000
22675,593,$HBSA3,2011-09-30,108000000,0,108000000
22675,593,$HBSA3,2011-12-31,108000,0,108000
22675,593,$HBSA3,2012-03-31,162874,0,162874
22675,593,$HBSA3,2012-06-30,162874,0,162874
22675,593,$HBSA3,2012-09-30,219974,0,219974
22675,593,$HBSA3,2012-12-31,219974,0,219974
22675,593,$HBSA3,2013-03-31,219974,0,219974
22675,593,$HBSA3,2013-06-30,283095,0,283095
22675,593,$HBSA3,2013-09-30,334031,0,334031
22675,593,$HBSA3,2013-12-31,404165,0,404165
22675,593,$HBSA3,2014-03-31,538822,0,538822
22675,593,$HBSA3,2014-06-30,538822,0,538822
22675,593,$HBSA3,2014-09-30,538822,0,538822
22675,593,$HBSA3,2014-12-31,538822389,0,538822389
22675,593,$HBSA3,2015-03-31,584829,0,584829
22675,593,$HBSA3,2015-06-30,584829,0,584829
22675,593,$HBSA3,2015-09-30,630835,0,630835
22675,593,$HBSA3,2015-12-31,630834792,0,630834792
22675,593,$HBSA3,2016-03-31,630835,0,630835
22675,593,$HBSA3,2016-06-30,630835,0,630835
22675,593,$HBSA3,2016-09-30,630835,0,630835
22675,593,$HBSA3,2016-12-31,692483,0,692483
22675,593,$HBSA3,2017-03-31,692483,0,692483
22675,593,$HBSA3,2017-06-30,692483,0,692483
22675,593,$HBSA3,2017-09-30,692483,0,692483
22675,593,$HBSA3,2017-12-31,721006,0,721006
22675,593,$HBSA3,2018-03-31,721006,0,721006
22675,593,$HBSA3,2018-06-30,721006,0,721006
22675,593,$HBSA3,2018-09-30,721006,0,721006
22675,593,$HBSA3,2018-12-31,748610,0,748610
22675,593,$HBSA3,2019-03-31,748610,0,748610
22675,593,$HBSA3,2019-06-30,748610,0,748610
22675,593,$HBSA3,2019-09-30,748610,0,748610
22675,593,$HBSA3,2019-12-31,748610,0,748610
22675,593,$HBSA3,2020-03-31,748610,0,748610
22675,593,$HBSA3,2020-06-30,748610,0,748610
22675,593,$HBSA3,2020-09-30,760382,0,760382
22691,496,$LCAM3,2010-12-31,20390561,10799329,31189890
22691,496,$LCAM3,2011-03-31,20390561,10799329,31189890
22691,496,$LCAM3,2011-06-30,20390561,10799329,31189890
22691,496,$LCAM3,2011-09-30,20390000,10799000,31189000
22691,496,$LCAM3,2011-12-31,20390561,10799329,31189890
22691,496,$LCAM3,2012-03-31,46784835,0,46784835
22691,496,$LCAM3,2012-06-30,64966653,0,64966653
22691,496,$LCAM3,2012-09-30,64991199,0,64991199
22691,496,$LCAM3,2012-12-31,65044293,0,65044293
22691,496,$LCAM3,2013-03-31,65044293,0,65044293
22691,496,$LCAM3,2013-06-30,65044293,0,65044293
22691,496,$LCAM3,2013-09-30,65052757,0,65052757
22691,496,$LCAM3,2013-12-31,65075322,0,65075322
22691,496,$LCAM3,2014-03-31,65075322,0,65075322
22691,496,$LCAM3,2014-06-30,64838922,0,64838922
22691,496,$LCAM3,2014-09-30,65075322,0,65075322
22691,496,$LCAM3,2014-12-31,65075322,0,65075322
22691,496,$LCAM3,2015-03-31,65075322,0,65075322
22691,496,$LCAM3,2015-06-30,65075322,0,65075322
22691,496,$LCAM3,2015-09-30,65075322,0,65075322
22691,496,$LCAM3,2015-12-31,65075322,0,65075322
22691,496,$LCAM3,2016-03-31,65075322,0,65075322
22691,496,$LCAM3,2016-06-30,65075322,0,65075322
22691,496,$LCAM3,2016-09-30,65075322,0,65075322
22691,496,$LCAM3,2016-12-31,65075322,0,65075322
22691,496,$LCAM3,2017-03-31,65075322,0,65075322
22691,496,$LCAM3,2017-06-30,82469138,0,82469138
22691,496,$LCAM3,2017-09-30,82469138,0,82469138
22691,496,$LCAM3,2017-12-31,82469138,0,82469138
22691,496,$LCAM3,2018-03-31,116863827,0,116863827
22691,496,$LCAM3,2018-06-30,116863827,0,116863827
22691,496,$LCAM3,2018-09-30,116863827,0,116863827
22691,496,$LCAM3,2018-12-31,147863827,0,147863827
22691,496,$LCAM3,2019-03-31,149243137,0,149243137
22691,496,$LCAM3,2019-06-30,149243137,0,149243137
22691,496,$LCAM3,2019-09-30,149243137,0,149243137
22691,496,$LCAM3,2019-12-31,508729411,0,508729411
22691,496,$LCAM3,2020-03-31,508729411,0,508729411
22691,496,$LCAM3,2020-06-30,508729411,0,508729411
22691,496,$LCAM3,2020-09-30,508729411,0,508729411
22780,497,$UCAS3,2011-12-31,5499900,0,5499900
22780,497,$UCAS3,2012-03-31,56950000,0,56950000
22780,497,$UCAS3,2012-06-30,66086364,0,66086364
22780,497,$UCAS3,2012-09-30,66086364,0,66086364
22780,497,$UCAS3,2012-12-31,66086364,0,66086364
22780,497,$UCAS3,2013-03-31,66086364,0,66086364
22780,497,$UCAS3,2013-06-30,66086364,0,66086364
22780,497,$UCAS3,2013-09-30,66086364,0,66086364
22780,497,$UCAS3,2013-12-31,66086364,0,66086364
22780,497,$UCAS3,2014-03-31,66086364,0,66086364
22780,497,$UCAS3,2014-06-30,66086364,0,66086364
22780,497,$UCAS3,2014-09-30,66086364,0,66086364
22780,497,$UCAS3,2014-12-31,66086364,0,66086364
22780,497,$UCAS3,2015-03-31,66086364,0,66086364
22780,497,$UCAS3,2015-06-30,66086364,0,66086364
22780,497,$UCAS3,2015-09-30,66086364,0,66086364
22780,497,$UCAS3,2015-12-31,66086364,0,66086364
22780,497,$UCAS3,2016-03-31,66086346,0,66086346
22780,497,$UCAS3,2016-06-30,66086346,0,66086346
22780,497,$UCAS3,2016-09-30,66086346,0,66086346
22780,497,$UCAS3,2016-12-31,66086364,0,66086364
22780,497,$UCAS3,2017-03-31,66086346,0,66086346
22780,497,$UCAS3,2017-06-30,66086346,0,66086346
22780,497,$UCAS3,2017-09-30,66086346,0,66086346
22780,497,$UCAS3,2017-12-31,66086364,0,66086364
22780,497,$UCAS3,2018-03-31,66086364,0,66086364
22780,497,$UCAS3,2018-06-30,66086364,0,66086364
22780,497,$UCAS3,2018-09-30,66086364,0,66086364
22780,497,$UCAS3,2018-12-31,66086364,0,66086364
22780,497,$UCAS3,2019-03-31,66086364,0,66086364
22780,497,$UCAS3,2019-06-30,66086364,0,66086364
22780,497,$UCAS3,2019-09-30,66086364,0,66086364
22780,497,$UCAS3,2019-12-31,66086364,0,66086364
22780,497,$UCAS3,2020-03-31,66086364,0,66086364
22780,497,$UCAS3,2020-06-30,66086364,0,66086364
22780,497,$UCAS3,2020-09-30,66086364,0,66086364
22780,497,$UCAS3,2020-09-30,66086364,0,66086364
22799,498,$SNSL3,2011-12-31,805539,220387,1025926
22799,498,$SNSL3,2012-03-31,805539,220387,1025926
22799,498,$SNSL3,2012-06-30,805539,220387,1025926
22799,498,$SNSL3,2012-09-30,1025926,0,1025926
22799,498,$SNSL3,2012-12-31,8207408,0,8207408
22799,498,$SNSL3,2013-03-31,11655683,0,11655683
22799,498,$SNSL3,2013-06-30,11655683,0,11655683
22799,498,$SNSL3,2013-09-30,11787203,0,11787203
22799,498,$SNSL3,2013-12-31,11655683,0,11655683
22799,498,$SNSL3,2014-03-31,11787203,0,11787203
22799,498,$SNSL3,2014-06-30,11787203,0,11787203
22799,498,$SNSL3,2014-09-30,11787203,0,11787203
22799,498,$SNSL3,2014-12-31,11787203,0,11787203
22799,498,$SNSL3,2015-03-31,11787203,0,11787203
22799,498,$SNSL3,2015-06-30,11787203,0,11787203
22799,498,$SNSL3,2015-09-30,11787203,0,11787203
22799,498,$SNSL3,2015-12-31,11787203,0,11787203
22799,498,$SNSL3,2016-03-31,11787203,0,11787203
22799,498,$SNSL3,2016-06-30,11787203,0,11787203
22799,498,$SNSL3,2016-09-30,11787203,0,11787203
22799,498,$SNSL3,2016-12-31,11787203,0,11787203
22799,498,$SNSL3,2017-03-31,11787203,0,11787203
22799,498,$SNSL3,2017-06-30,11787203,0,11787203
22799,498,$SNSL3,2017-09-30,11787203,0,11787203
22799,498,$SNSL3,2017-12-31,11787203,0,11787203
22799,498,$SNSL3,2018-03-31,11787203,0,11787203
22799,498,$SNSL3,2018-06-30,11787203,0,11787203
22799,498,$SNSL3,2018-09-30,11787203,0,11787203
22799,498,$SNSL3,2018-12-31,11787203,0,11787203
22799,498,$SNSL3,2019-03-31,11787203,0,11787203
22799,498,$SNSL3,2019-06-30,11787203,0,11787203
22799,498,$SNSL3,2019-09-30,70548812,0,70548812
22799,498,$SNSL3,2019-12-31,70548812,0,70548812
22799,498,$SNSL3,2020-03-31,70548812,0,70548812
22799,498,$SNSL3,2020-06-30,70548812,0,70548812
22799,498,$SNSL3,2020-09-30,70548812,0,70548812
22799,499,$SQIA3,2011-12-31,805539,220387,1025926
22799,499,$SQIA3,2012-03-31,805539,220387,1025926
22799,499,$SQIA3,2012-06-30,805539,220387,1025926
22799,499,$SQIA3,2012-09-30,1025926,0,1025926
22799,499,$SQIA3,2012-12-31,8207408,0,8207408
22799,499,$SQIA3,2013-03-31,11655683,0,11655683
22799,499,$SQIA3,2013-06-30,11655683,0,11655683
22799,499,$SQIA3,2013-09-30,11787203,0,11787203
22799,499,$SQIA3,2013-12-31,11655683,0,11655683
22799,499,$SQIA3,2014-03-31,11787203,0,11787203
22799,499,$SQIA3,2014-06-30,11787203,0,11787203
22799,499,$SQIA3,2014-09-30,11787203,0,11787203
22799,499,$SQIA3,2014-12-31,11787203,0,11787203
22799,499,$SQIA3,2015-03-31,11787203,0,11787203
22799,499,$SQIA3,2015-06-30,11787203,0,11787203
22799,499,$SQIA3,2015-09-30,11787203,0,11787203
22799,499,$SQIA3,2015-12-31,11787203,0,11787203
22799,499,$SQIA3,2016-03-31,11787203,0,11787203
22799,499,$SQIA3,2016-06-30,11787203,0,11787203
22799,499,$SQIA3,2016-09-30,11787203,0,11787203
22799,499,$SQIA3,2016-12-31,11787203,0,11787203
22799,499,$SQIA3,2017-03-31,11787203,0,11787203
22799,499,$SQIA3,2017-06-30,11787203,0,11787203
22799,499,$SQIA3,2017-09-30,11787203,0,11787203
22799,499,$SQIA3,2017-12-31,11787203,0,11787203
22799,499,$SQIA3,2018-03-31,11787203,0,11787203
22799,499,$SQIA3,2018-06-30,11787203,0,11787203
22799,499,$SQIA3,2018-09-30,11787203,0,11787203
22799,499,$SQIA3,2018-12-31,11787203,0,11787203
22799,499,$SQIA3,2019-03-31,11787203,0,11787203
22799,499,$SQIA3,2019-06-30,11787203,0,11787203
22799,499,$SQIA3,2019-09-30,70548812,0,70548812
22799,499,$SQIA3,2019-12-31,70548812,0,70548812
22799,499,$SQIA3,2020-03-31,70548812,0,70548812
22799,499,$SQIA3,2020-06-30,70548812,0,70548812
22799,499,$SQIA3,2020-09-30,70548812,0,70548812
22845,500,$BSEV3,2012-03-31,10800757666,848913804,11649671470
22845,500,$BSEV3,2012-06-30,11178970585,848913804,12027884389
22845,500,$BSEV3,2012-09-30,11178970585,848913804,12027884389
22845,500,$BSEV3,2012-12-31,11178970585,817774304,11996744889
22845,500,$BSEV3,2013-03-31,15196620363,817774304,16014394667
22845,500,$BSEV3,2013-06-30,206810613,0,206810613
22845,500,$BSEV3,2013-09-30,206810613,0,206810613
22845,500,$BSEV3,2013-12-31,206810613,0,206810613
22845,500,$BSEV3,2014-03-31,206810613,0,206810613
22845,500,$BSEV3,2014-06-30,206810613,0,206810613
22845,500,$BSEV3,2014-09-30,206810613,0,206810613
22845,500,$BSEV3,2014-12-31,206810613,0,206810613
22845,500,$BSEV3,2015-03-31,219628363,0,219628363
22845,500,$BSEV3,2015-06-30,219628363,0,219628363
22845,500,$BSEV3,2015-09-30,219628363,0,219628363
22845,500,$BSEV3,2015-12-31,219628363,0,219628363
22845,500,$BSEV3,2016-03-31,219628363,0,219628363
22845,500,$BSEV3,2016-06-30,219628363,0,219628363
22845,500,$BSEV3,2016-09-30,219628363,0,219628363
22845,500,$BSEV3,2016-12-31,219628363,0,219628363
22845,500,$BSEV3,2017-03-31,219628363,0,219628363
22845,500,$BSEV3,2017-06-30,219628363,0,219628363
22845,500,$BSEV3,2017-09-30,219628363,0,219628363
22845,500,$BSEV3,2017-12-31,219628363,0,219628363
22845,500,$BSEV3,2018-03-31,1020380677,0,1020380677
22845,500,$BSEV3,2018-06-30,1020429426,0,1020429426
22845,500,$BSEV3,2018-09-30,1020429426,0,1020429426
22845,500,$BSEV3,2018-12-31,1020429426,0,1020429426
22845,500,$BSEV3,2019-03-31,1020429426,0,1020429426
22845,500,$BSEV3,2019-06-30,1020429426,0,1020429426
22845,500,$BSEV3,2019-09-30,1020429426,0,1020429426
22845,500,$BSEV3,2019-12-31,1020429426,0,1020429426
22845,500,$BSEV3,2020-03-31,1020429426,0,1020429426
22845,500,$BSEV3,2020-06-30,1020429426,0,1020429426
22845,500,$BSEV3,2020-09-30,1020429426,0,1020429426
23035,424,$LINX3,2011-12-31,7829987,5694902,13524889
23035,424,$LINX3,2012-03-31,7829987,5694902,13524889
23035,424,$LINX3,2012-06-30,7829987,5694902,13524889
23035,424,$LINX3,2012-09-30,7829989,5694902,13524891
23035,424,$LINX3,2012-12-31,7829987,5694902,13524889
23035,424,$LINX3,2013-03-31,46519720,0,46519720
23035,424,$LINX3,2013-06-30,46520,0,46520
23035,424,$LINX3,2013-09-30,46556,0,46556
23035,424,$LINX3,2013-12-31,46556,0,46556
23035,424,$LINX3,2014-03-31,46576,0,46576
23035,424,$LINX3,2014-06-30,46576,0,46576
23035,424,$LINX3,2014-09-30,46765,0,46765
23035,424,$LINX3,2014-12-31,46765,0,46765
23035,424,$LINX3,2015-03-31,46773377,0,46773377
23035,424,$LINX3,2015-06-30,46773377,0,46773377
23035,424,$LINX3,2015-09-30,46836541,0,46836541
23035,424,$LINX3,2015-12-31,46837,0,46837
23035,424,$LINX3,2016-03-31,47069132,0,47069132
23035,424,$LINX3,2016-06-30,141207396,0,141207396
23035,424,$LINX3,2016-09-30,165207396,0,165207396
23035,424,$LINX3,2016-12-31,165609951,0,165609951
23035,424,$LINX3,2017-03-31,165820161,0,165820161
23035,424,$LINX3,2017-06-30,165820161,0,165820161
23035,424,$LINX3,2017-09-30,166110342,0,166110342
23035,424,$LINX3,2017-12-31,166110342,0,166110342
23035,424,$LINX3,2018-03-31,166212210,0,166212210
23035,424,$LINX3,2018-06-30,166212210,0,166212210
23035,424,$LINX3,2018-09-30,166283382,0,166283382
23035,424,$LINX3,2018-12-31,166283382,0,166283382
23035,424,$LINX3,2019-03-31,166308960,0,166308960
23035,424,$LINX3,2019-06-30,189408960,0,189408960
23035,424,$LINX3,2019-09-30,189408960,0,189408960
23035,424,$LINX3,2019-12-31,189408960,0,189408960
23035,424,$LINX3,2020-03-31,189408960,0,189408960
23035,424,$LINX3,2020-06-30,189408960,0,189408960
23035,424,$LINX3,2020-09-30,189408960,0,189408960
23159,501,$BBSE3,2012-12-31,470563927,0,470563927
23159,501,$BBSE3,2013-03-31,2000000000,0,2000000000
23159,501,$BBSE3,2013-06-30,2000000000,0,2000000000
23159,501,$BBSE3,2013-09-30,2000000000,0,2000000000
23159,501,$BBSE3,2013-12-31,2000000000,0,2000000000
23159,501,$BBSE3,2014-03-31,2000000000,0,2000000000
23159,501,$BBSE3,2014-06-30,2000000000,0,2000000000
23159,501,$BBSE3,2014-09-30,2000000000,0,2000000000
23159,501,$BBSE3,2014-12-31,2000000000,0,2000000000
23159,501,$BBSE3,2015-03-31,2000000000,0,2000000000
23159,501,$BBSE3,2015-06-30,2000000000,0,2000000000
23159,501,$BBSE3,2015-09-30,2000000000,0,2000000000
23159,501,$BBSE3,2015-12-31,2000000000,0,2000000000
23159,501,$BBSE3,2016-03-31,2000000000,0,2000000000
23159,501,$BBSE3,2016-06-30,2000000000,0,2000000000
23159,501,$BBSE3,2016-09-30,2000000000,0,2000000000
23159,501,$BBSE3,2016-12-31,2000000000,0,2000000000
23159,501,$BBSE3,2017-03-31,2000000000,0,2000000000
23159,501,$BBSE3,2017-06-30,2000000000,0,2000000000
23159,501,$BBSE3,2017-09-30,2000000000,0,2000000000
23159,501,$BBSE3,2017-12-31,2000000000,0,2000000000
23159,501,$BBSE3,2018-03-31,2000000000,0,2000000000
23159,501,$BBSE3,2018-06-30,2000000000,0,2000000000
23159,501,$BBSE3,2018-09-30,2000000000,0,2000000000
23159,501,$BBSE3,2018-12-31,2000000000,0,2000000000
23159,501,$BBSE3,2019-03-31,2000000000,0,2000000000
23159,501,$BBSE3,2019-06-30,2000000000,0,2000000000
23159,501,$BBSE3,2019-09-30,2000000000,0,2000000000
23159,501,$BBSE3,2019-12-31,2000000000,0,2000000000
23159,501,$BBSE3,2020-03-31,2000000000,0,2000000000
23159,501,$BBSE3,2020-06-30,2000000000,0,2000000000
23159,501,$BBSE3,2020-09-30,2000000000,0,2000000000
23175,502,$023175,2012-12-31,61266737,0,61266737
23175,502,$023175,2013-03-31,61266737,0,61266737
23175,502,$023175,2013-06-30,61266737,0,61266737
23175,502,$023175,2013-09-30,61266737,0,61266737
23175,502,$023175,2013-12-31,61266737,0,61266737
23175,502,$023175,2014-03-31,61266737,0,61266737
23175,502,$023175,2014-06-30,61266737,0,61266737
23175,502,$023175,2014-09-30,61266737,0,61266737
23175,502,$023175,2014-12-31,61266737,0,61266737
23175,502,$023175,2015-03-31,61266737,0,61266737
23175,502,$023175,2015-06-30,61266737,0,61266737
23175,502,$023175,2015-09-30,61266737,0,61266737
23175,502,$023175,2015-12-31,61266737,0,61266737
23175,502,$023175,2016-03-31,61266737,0,61266737
23175,502,$023175,2016-06-30,61266737,0,61266737
23175,502,$023175,2016-09-30,61266737,0,61266737
23175,502,$023175,2016-12-31,61266737,0,61266737
23175,502,$023175,2017-03-31,61266737,0,61266737
23175,502,$023175,2017-06-30,61266737,0,61266737
23175,502,$023175,2017-09-30,129436505,0,129436505
23175,502,$023175,2017-12-31,129436505,0,129436505
23175,502,$023175,2018-03-31,129436505,0,129436505
23175,502,$023175,2018-06-30,129436505,0,129436505
23175,502,$023175,2018-09-30,129436505,0,129436505
23175,502,$023175,2018-12-31,169739941,0,169739941
23175,502,$023175,2019-03-31,177800628,0,177800628
23175,502,$023175,2019-06-30,185861315,0,185861315
23175,502,$023175,2019-09-30,199192402,0,199192402
23175,502,$023175,2019-12-31,199192402,0,199192402
23175,502,$023175,2020-03-31,199192402,0,199192402
23175,502,$023175,2020-06-30,199192402,0,199192402
23175,502,$023175,2020-09-30,207017884,0,207017884
23221,503,$SEER3,2010-12-31,107515296,0,107515296
23221,503,$SEER3,2011-12-31,107515296,0,107515296
23221,503,$SEER3,2012-12-31,107515296,0,107515296
23221,503,$SEER3,2013-03-31,107515296,0,107515296
23221,503,$SEER3,2013-06-30,107515296,0,107515296
23221,503,$SEER3,2013-09-30,122904816,0,122904816
23221,503,$SEER3,2013-12-31,125213244,0,125213244
23221,503,$SEER3,2014-03-31,125213244,0,125213244
23221,503,$SEER3,2014-06-30,125213244,0,125213244
23221,503,$SEER3,2014-09-30,125213244,0,125213244
23221,503,$SEER3,2014-12-31,125213244,0,125213244
23221,503,$SEER3,2015-03-31,124863944,0,124863944
23221,503,$SEER3,2015-06-30,124863944,0,124863944
23221,503,$SEER3,2015-09-30,125213244,0,125213244
23221,503,$SEER3,2015-12-31,125213244,0,125213244
23221,503,$SEER3,2016-03-31,125213244,0,125213244
23221,503,$SEER3,2016-06-30,125213244,0,125213244
23221,503,$SEER3,2016-09-30,125213244,0,125213244
23221,503,$SEER3,2016-12-31,125213244,0,125213244
23221,503,$SEER3,2017-03-31,125213244,0,125213244
23221,503,$SEER3,2017-06-30,125213244,0,125213244
23221,503,$SEER3,2017-09-30,125213244,0,125213244
23221,503,$SEER3,2017-12-31,138812000,0,138812000
23221,503,$SEER3,2018-03-31,138812000,0,138812000
23221,503,$SEER3,2018-06-30,138812000,0,138812000
23221,503,$SEER3,2018-09-30,138812000,0,138812000
23221,503,$SEER3,2018-12-31,132951860,0,132951860
23221,503,$SEER3,2019-03-31,132951860,0,132951860
23221,503,$SEER3,2019-06-30,128721560,0,128721560
23221,503,$SEER3,2019-09-30,128721560,0,128721560
23221,503,$SEER3,2019-12-31,128721560,0,128721560
23221,503,$SEER3,2020-03-31,128721560,0,128721560
23221,503,$SEER3,2020-06-30,128721560,0,128721560
23221,503,$SEER3,2020-09-30,128721560,0,128721560
23248,504,$ANIM3,2012-12-31,1693109,0,1693109
23248,504,$ANIM3,2013-03-31,1742380,0,1742380
23248,504,$ANIM3,2013-06-30,1735487,0,1735487
23248,504,$ANIM3,2013-09-30,59838232,0,59838232
23248,504,$ANIM3,2013-12-31,82866371,0,82866371
23248,504,$ANIM3,2014-03-31,82866371,0,82866371
23248,504,$ANIM3,2014-06-30,82866371,0,82866371
23248,504,$ANIM3,2014-09-30,82865891,0,82865891
23248,504,$ANIM3,2014-12-31,82865891,0,82865891
23248,504,$ANIM3,2015-03-31,82865982,0,82865982
23248,504,$ANIM3,2015-06-30,82865982,0,82865982
23248,504,$ANIM3,2015-09-30,82865982,0,82865982
23248,504,$ANIM3,2015-12-31,82592482,0,82592482
23248,504,$ANIM3,2016-03-31,81872582,0,81872582
23248,504,$ANIM3,2016-06-30,82866371,0,82866371
23248,504,$ANIM3,2016-09-30,82866371,0,82866371
23248,504,$ANIM3,2016-12-31,80944571,0,80944571
23248,504,$ANIM3,2017-03-31,80944571,0,80944571
23248,504,$ANIM3,2017-06-30,80944571,0,80944571
23248,504,$ANIM3,2017-09-30,80944571,0,80944571
23248,504,$ANIM3,2017-12-31,80944571,0,80944571
23248,504,$ANIM3,2018-03-31,80944571,0,80944571
23248,504,$ANIM3,2018-06-30,80944571,0,80944571
23248,504,$ANIM3,2018-09-30,78556015,0,78556015
23248,504,$ANIM3,2018-12-31,77632254,0,77632254
23248,504,$ANIM3,2019-03-31,78556015,0,78556015
23248,504,$ANIM3,2019-06-30,78556015,0,78556015
23248,504,$ANIM3,2019-09-30,78556015,0,78556015
23248,504,$ANIM3,2019-12-31,80208517,0,80208517
23248,504,$ANIM3,2020-03-31,110559237,0,110559237
23248,504,$ANIM3,2020-06-30,111122935,0,111122935
23248,504,$ANIM3,2020-09-30,107622935,0,107622935
23264,507,$ABEV3,2012-12-31,249061,0,249061
23264,507,$ABEV3,2013-03-31,249061,0,249061
23264,507,$ABEV3,2013-06-30,9693598,0,9693598
23264,507,$ABEV3,2013-09-30,9693598,0,9693598
23264,507,$ABEV3,2013-12-31,15644280,0,15644280
23264,507,$ABEV3,2014-03-31,15666170,0,15666170
23264,507,$ABEV3,2014-06-30,15670883,0,15670883
23264,507,$ABEV3,2014-09-30,15699508,0,15699508
23264,507,$ABEV3,2014-12-31,15712619,0,15712619
23264,507,$ABEV3,2015-03-31,15717615,0,15717615
23264,507,$ABEV3,2015-06-30,15717615,0,15717615
23264,507,$ABEV3,2015-09-30,15717615,0,15717615
23264,507,$ABEV3,2015-12-31,15717615,0,15717615
23264,507,$ABEV3,2016-03-31,15717615,0,15717615
23264,507,$ABEV3,2016-06-30,15717615,0,15717615
23264,507,$ABEV3,2016-09-30,15717615,0,15717615
23264,507,$ABEV3,2016-12-31,15717615,0,15717615
23264,507,$ABEV3,2017-03-31,15717615,0,15717615
23264,507,$ABEV3,2017-06-30,15717615,0,15717615
23264,507,$ABEV3,2017-09-30,15717615,0,15717615
23264,507,$ABEV3,2017-12-31,15717615,0,15717615
23264,507,$ABEV3,2018-03-31,15722147,0,15722147
23264,507,$ABEV3,2018-06-30,15722147,0,15722147
23264,507,$ABEV3,2018-09-30,15722147,0,15722147
23264,507,$ABEV3,2018-12-31,15722147,0,15722147
23264,507,$ABEV3,2019-03-31,15726842,0,15726842
23264,507,$ABEV3,2019-06-30,15727523,0,15727523
23264,507,$ABEV3,2019-09-30,15733575,0,15733575
23264,507,$ABEV3,2019-12-31,15733575,0,15733575
23264,507,$ABEV3,2020-03-31,15735118,0,15735118
23264,507,$ABEV3,2020-06-30,15735118,0,15735118
23264,507,$ABEV3,2020-09-30,15735118,0,15735118
23272,506,$LOGG3,2012-12-31,134362,0,134362
23272,506,$LOGG3,2013-03-31,134362,0,134362
23272,506,$LOGG3,2013-06-30,171453,0,171453
23272,506,$LOGG3,2013-09-30,171453,0,171453
23272,506,$LOGG3,2013-12-31,171453,0,171453
23272,506,$LOGG3,2014-03-31,171453,0,171453
23272,506,$LOGG3,2014-06-30,171453,0,171453
23272,506,$LOGG3,2014-09-30,171844,0,171844
23272,506,$LOGG3,2014-12-31,171844,0,171844
23272,506,$LOGG3,2015-03-31,171844,0,171844
23272,506,$LOGG3,2015-06-30,174557,0,174557
23272,506,$LOGG3,2015-09-30,174557,0,174557
23272,506,$LOGG3,2015-12-31,174557,0,174557
23272,506,$LOGG3,2016-03-31,174557,0,174557
23272,506,$LOGG3,2016-06-30,174732,0,174732
23272,506,$LOGG3,2016-09-30,174732,0,174732
23272,506,$LOGG3,2016-12-31,203402,0,203402
23272,506,$LOGG3,2017-03-31,50851,0,50851
23272,506,$LOGG3,2017-06-30,50851,0,50851
23272,506,$LOGG3,2017-09-30,60204,0,60204
23272,506,$LOGG3,2017-12-31,64977,0,64977
23272,506,$LOGG3,2018-03-31,69068,0,69068
23272,506,$LOGG3,2018-06-30,69068,0,69068
23272,506,$LOGG3,2018-09-30,69230,0,69230
23272,506,$LOGG3,2018-12-31,69230,0,69230
23272,506,$LOGG3,2019-03-31,73784,0,73784
23272,506,$LOGG3,2019-06-30,73784,0,73784
23272,506,$LOGG3,2019-09-30,73809,0,73809
23272,506,$LOGG3,2019-12-31,102159,0,102159
23272,506,$LOGG3,2020-03-31,102159,0,102159
23272,506,$LOGG3,2020-06-30,102159,0,102159
23272,506,$LOGG3,2020-09-30,102159,0,102159
23302,505,$QUSW3,2012-12-31,400000,147945,547945
23302,505,$QUSW3,2013-03-31,400000,147945,547945
23302,505,$QUSW3,2013-06-30,400000,147945,547945
23302,505,$QUSW3,2013-09-30,400000,147945,547945
23302,505,$QUSW3,2013-12-31,400000,147945,547945
23302,505,$QUSW3,2014-03-31,400000,147945,547945
23302,505,$QUSW3,2014-06-30,400000,147945,547945
23302,505,$QUSW3,2014-09-30,400000,147945,547945
23302,505,$QUSW3,2014-12-31,400000,147945,547945
23302,505,$QUSW3,2015-03-31,400000,147945,547945
23302,505,$QUSW3,2015-06-30,547945,0,547945
23302,505,$QUSW3,2015-09-30,547945,0,547945
23302,505,$QUSW3,2015-12-31,400000,147945,547945
23302,505,$QUSW3,2016-03-31,663218,0,663218
23302,505,$QUSW3,2016-06-30,690180,0,690180
23302,505,$QUSW3,2016-09-30,690180,0,690180
23302,505,$QUSW3,2016-12-31,690180,0,690180
23302,505,$QUSW3,2017-03-31,830919,0,830919
23302,505,$QUSW3,2017-06-30,830919,0,830919
23302,505,$QUSW3,2017-09-30,830919,0,830919
23302,505,$QUSW3,2017-12-31,830919,0,830919
23302,505,$QUSW3,2018-03-31,830919,0,830919
23302,505,$QUSW3,2018-06-30,830919,0,830919
23302,505,$QUSW3,2018-09-30,830919,0,830919
23302,505,$QUSW3,2018-12-31,830919,0,830919
23302,505,$QUSW3,2019-03-31,830919,0,830919
23302,505,$QUSW3,2019-06-30,830919,0,830919
23302,505,$QUSW3,2019-09-30,830919,0,830919
23302,505,$QUSW3,2019-12-31,861605,0,861605
23302,505,$QUSW3,2020-03-31,861605,0,861605
23302,505,$QUSW3,2020-06-30,861605,0,861605
23302,505,$QUSW3,2020-09-30,861605,0,861605
23310,509,$CVCB3,2012-12-31,43527,0,43527
23310,509,$CVCB3,2013-03-31,43527,0,43527
23310,509,$CVCB3,2013-06-30,43527,0,43527
23310,509,$CVCB3,2013-09-30,43527,0,43527
23310,509,$CVCB3,2013-12-31,129729000,0,129729000
23310,509,$CVCB3,2014-03-31,129729000,0,129729000
23310,509,$CVCB3,2014-06-30,131465335,0,131465335
23310,509,$CVCB3,2014-09-30,131465335,0,131465335
23310,509,$CVCB3,2014-12-31,131465335,0,131465335
23310,509,$CVCB3,2015-03-31,131465335,0,131465335
23310,509,$CVCB3,2015-06-30,133302195,0,133302195
23310,509,$CVCB3,2015-09-30,134330243,0,134330243
23310,509,$CVCB3,2015-12-31,134330243,0,134330243
23310,509,$CVCB3,2016-03-31,132757443,0,132757443
23310,509,$CVCB3,2016-06-30,132830343,0,132830343
23310,509,$CVCB3,2016-09-30,134330243,0,134330243
23310,509,$CVCB3,2016-12-31,134330243,0,134330243
23310,509,$CVCB3,2017-03-31,134330243,0,134330243
23310,509,$CVCB3,2017-06-30,134330243,0,134330243
23310,509,$CVCB3,2017-09-30,135485103,0,135485103
23310,509,$CVCB3,2017-12-31,141700212,0,141700212
23310,509,$CVCB3,2018-03-31,146343772,0,146343772
23310,509,$CVCB3,2018-06-30,146472872,0,146472872
23310,509,$CVCB3,2018-09-30,146477872,0,146477872
23310,509,$CVCB3,2018-12-31,146511872,0,146511872
23310,509,$CVCB3,2019-03-31,148591079,0,148591079
23310,509,$CVCB3,2019-06-30,148609579,0,148609579
23310,509,$CVCB3,2019-09-30,149080579,0,149080579
23310,509,$CVCB3,2019-12-31,149181579,0,149181579
23310,509,$CVCB3,2020-03-31,149328579,0,149328579
23310,509,$CVCB3,2020-06-30,149328579,0,149328579
23310,509,$CVCB3,2020-09-30,172828579,0,172828579
23426,508,$OMGE3,2013-12-31,312610024,0,312610024
23426,508,$OMGE3,2014-03-31,312610,0,312610
23426,508,$OMGE3,2014-06-30,312610,0,312610
23426,508,$OMGE3,2014-09-30,312610,0,312610
23426,508,$OMGE3,2014-12-31,312610,0,312610
23426,508,$OMGE3,2015-03-31,312610,0,312610
23426,508,$OMGE3,2015-06-30,312610,0,312610
23426,508,$OMGE3,2015-09-30,312610,0,312610
23426,508,$OMGE3,2015-12-31,312610,0,312610
23426,508,$OMGE3,2016-03-31,312610,0,312610
23426,508,$OMGE3,2016-06-30,312610,0,312610
23426,508,$OMGE3,2016-09-30,312610,0,312610
23426,508,$OMGE3,2016-12-31,312610,0,312610
23426,508,$OMGE3,2017-03-31,312610,0,312610
23426,508,$OMGE3,2017-06-30,448622,0,448622
23426,508,$OMGE3,2017-09-30,79384,0,79384
23426,508,$OMGE3,2017-12-31,117800,0,117800
23426,508,$OMGE3,2018-03-31,117800,0,117800
23426,508,$OMGE3,2018-06-30,117800,0,117800
23426,508,$OMGE3,2018-09-30,117800,0,117800
23426,508,$OMGE3,2018-12-31,117800,0,117800
23426,508,$OMGE3,2019-03-31,124367,0,124367
23426,508,$OMGE3,2019-06-30,137047,0,137047
23426,508,$OMGE3,2019-09-30,164849,0,164849
23426,508,$OMGE3,2019-12-31,164849,0,164849
23426,508,$OMGE3,2020-03-31,169964,0,169964
23426,508,$OMGE3,2020-06-30,170133,0,170133
23426,508,$OMGE3,2020-09-30,195754,0,195754
23485,510,$RLOG3,2013-12-31,939753176,0,939753176
23485,510,$RLOG3,2014-03-31,979753176,0,979753176
23485,510,$RLOG3,2014-06-30,939753176,0,939753176
23485,510,$RLOG3,2014-09-30,940753176,0,940753176
23485,510,$RLOG3,2014-12-31,405856814,0,405856814
23485,510,$RLOG3,2015-03-31,405856814,0,405856814
23485,510,$RLOG3,2015-06-30,405856814,0,405856814
23485,510,$RLOG3,2015-09-30,405856814,0,405856814
23485,510,$RLOG3,2015-12-31,405856814,0,405856814
23485,510,$RLOG3,2016-03-31,405856814,0,405856814
23485,510,$RLOG3,2016-06-30,365100567,0,365100567
23485,510,$RLOG3,2016-09-30,365429943,0,365429943
23485,510,$RLOG3,2016-12-31,366490593,0,366490593
23485,510,$RLOG3,2017-03-31,366490593,0,366490593
23485,510,$RLOG3,2017-06-30,368046576,0,368046576
23485,510,$RLOG3,2017-09-30,368046576,0,368046576
23485,510,$RLOG3,2017-12-31,463224241,0,463224241
23485,510,$RLOG3,2018-03-31,463224241,0,463224241
23485,510,$RLOG3,2018-06-30,463224241,0,463224241
23485,510,$RLOG3,2018-09-30,463224241,0,463224241
23485,510,$RLOG3,2018-12-31,463224241,0,463224241
23485,510,$RLOG3,2019-03-31,463224241,0,463224241
23485,510,$RLOG3,2019-06-30,463224241,0,463224241
23485,510,$RLOG3,2019-09-30,463224241,0,463224241
23485,510,$RLOG3,2019-12-31,463224241,0,463224241
23485,510,$RLOG3,2020-03-31,463224241,0,463224241
23485,510,$RLOG3,2020-06-30,463224241,0,463224241
23485,510,$RLOG3,2020-09-30,463224241,0,463224241
23493,511,$DMMO,2013-12-31,8476908148,0,8476908148
23493,511,$DMMO,2014-03-31,8493388831,0,8493388831
23493,511,$DMMO,2014-06-30,8476908148,0,8476908148
23493,511,$DMMO,2014-09-30,8606483363,0,8606483363
23493,511,$DMMO,2014-12-31,120758380,0,120758380
23493,511,$DMMO,2015-03-31,120758380,0,120758380
23493,511,$DMMO,2015-06-30,120758380,0,120758380
23493,511,$DMMO,2015-09-30,120758380,0,120758380
23493,511,$DMMO,2015-12-31,120758380,0,120758380
23493,511,$DMMO,2016-03-31,120758380,0,120758380
23493,511,$DMMO,2016-06-30,133272201,0,133272201
23493,511,$DMMO,2016-09-30,133272201,0,133272201
23493,511,$DMMO,2016-12-31,133272201,0,133272201
23493,511,$DMMO,2017-03-31,133272201,0,133272201
23493,511,$DMMO,2017-06-30,133272201,0,133272201
23493,511,$DMMO,2017-09-30,133272201,0,133272201
23493,511,$DMMO,2017-12-31,2665444020,0,2665444020
23493,511,$DMMO,2018-03-31,2665444020,0,2665444020
23493,511,$DMMO,2018-06-30,2665444020,0,2665444020
23493,511,$DMMO,2018-09-30,2665444020,0,2665444020
23493,511,$DMMO,2018-12-31,2700398881,0,2700398881
23493,511,$DMMO,2019-03-31,2700398881,0,2700398881
23493,511,$DMMO,2019-06-30,270040228,0,270040228
23493,511,$DMMO,2019-09-30,270040228,0,270040228
23493,511,$DMMO,2019-12-31,270040228,0,270040228
23493,511,$DMMO,2020-03-31,270040228,0,270040228
23493,511,$DMMO,2020-06-30,270040228,0,270040228
23493,511,$DMMO,2020-09-30,270040228,0,270040228
23507,512,$OFSA3,2014-06-30,188627485,0,188627485
23507,512,$OFSA3,2014-09-30,50000000,0,50000000
23507,512,$OFSA3,2014-12-31,53942307,0,53942307
23507,512,$OFSA3,2015-03-31,53942307,0,53942307
23507,512,$OFSA3,2015-06-30,53942307,0,53942307
23507,512,$OFSA3,2015-09-30,53942307,0,53942307
23507,512,$OFSA3,2015-12-31,53942307,0,53942307
23507,512,$OFSA3,2016-03-31,53942307,0,53942307
23507,512,$OFSA3,2016-06-30,53942307,0,53942307
23507,512,$OFSA3,2016-09-30,53949006,0,53949006
23507,512,$OFSA3,2016-12-31,53949006,0,53949006
23507,512,$OFSA3,2017-03-31,53949006,0,53949006
23507,512,$OFSA3,2017-06-30,53949006,0,53949006
23507,512,$OFSA3,2017-09-30,53949006,0,53949006
23507,512,$OFSA3,2017-12-31,53949006,0,53949006
23507,512,$OFSA3,2018-03-31,53949006,0,53949006
23507,512,$OFSA3,2018-06-30,53949006,0,53949006
23507,512,$OFSA3,2018-09-30,53949006,0,53949006
23507,512,$OFSA3,2018-12-31,53949006,0,53949006
23507,512,$OFSA3,2019-03-31,53949006,0,53949006
23507,512,$OFSA3,2019-06-30,53949006,0,53949006
23507,512,$OFSA3,2019-09-30,53949006,0,53949006
23507,512,$OFSA3,2019-12-31,53949006,0,53949006
23507,512,$OFSA3,2020-03-31,53949006,0,53949006
23507,512,$OFSA3,2020-06-30,53949006,0,53949006
23507,512,$OFSA3,2020-09-30,53949006,0,53949006
23574,515,$23574,2011-12-31,67636917,0,67636917
23574,515,$23574,2012-12-31,68536917,0,68536917
23574,515,$23574,2013-12-31,68536917,0,68536917
23574,515,$23574,2014-03-31,68536917,0,68536917
23574,515,$23574,2014-06-30,68536917,0,68536917
23574,515,$23574,2014-09-30,68536917,0,68536917
23574,515,$23574,2014-12-31,84482793,0,84482793
23574,515,$23574,2015-03-31,84482793,0,84482793
23574,515,$23574,2015-06-30,84482793,0,84482793
23574,515,$23574,2015-09-30,84482793,0,84482793
23574,515,$23574,2015-12-31,84482793,0,84482793
23574,515,$23574,2016-03-31,166531600,0,166531600
23574,515,$23574,2016-06-30,166531600,0,166531600
23574,515,$23574,2016-09-30,166531600,0,166531600
23574,515,$23574,2016-12-31,166531600,0,166531600
23574,515,$23574,2017-03-31,166531600,0,166531600
23574,515,$23574,2017-06-30,166531600,0,166531600
23574,515,$23574,2017-09-30,166531600,0,166531600
23574,515,$23574,2017-12-31,166531600,0,166531600
23574,515,$23574,2018-03-31,166531600,0,166531600
23574,515,$23574,2018-06-30,166531600,0,166531600
23574,515,$23574,2018-09-30,166531600,0,166531600
23574,515,$23574,2018-12-31,166531600,0,166531600
23574,515,$23574,2019-03-31,166531600,0,166531600
23574,515,$23574,2019-06-30,166531600,0,166531600
23574,515,$23574,2019-09-30,166531600,0,166531600
23574,515,$23574,2019-12-31,195919530,0,195919530
23574,515,$23574,2020-03-31,195919530,0,195919530
23574,515,$23574,2020-06-30,195919530,0,195919530
23574,515,$23574,2020-09-30,286369530,0,286369530
23574,517,$MEAL3,2011-12-31,67636917,0,67636917
23574,517,$MEAL3,2012-12-31,68536917,0,68536917
23574,517,$MEAL3,2013-12-31,68536917,0,68536917
23574,517,$MEAL3,2014-03-31,68536917,0,68536917
23574,517,$MEAL3,2014-06-30,68536917,0,68536917
23574,517,$MEAL3,2014-09-30,68536917,0,68536917
23574,517,$MEAL3,2014-12-31,84482793,0,84482793
23574,517,$MEAL3,2015-03-31,84482793,0,84482793
23574,517,$MEAL3,2015-06-30,84482793,0,84482793
23574,517,$MEAL3,2015-09-30,84482793,0,84482793
23574,517,$MEAL3,2015-12-31,84482793,0,84482793
23574,517,$MEAL3,2016-03-31,166531600,0,166531600
23574,517,$MEAL3,2016-06-30,166531600,0,166531600
23574,517,$MEAL3,2016-09-30,166531600,0,166531600
23574,517,$MEAL3,2016-12-31,166531600,0,166531600
23574,517,$MEAL3,2017-03-31,166531600,0,166531600
23574,517,$MEAL3,2017-06-30,166531600,0,166531600
23574,517,$MEAL3,2017-09-30,166531600,0,166531600
23574,517,$MEAL3,2017-12-31,166531600,0,166531600
23574,517,$MEAL3,2018-03-31,166531600,0,166531600
23574,517,$MEAL3,2018-06-30,166531600,0,166531600
23574,517,$MEAL3,2018-09-30,166531600,0,166531600
23574,517,$MEAL3,2018-12-31,166531600,0,166531600
23574,517,$MEAL3,2019-03-31,166531600,0,166531600
23574,517,$MEAL3,2019-06-30,166531600,0,166531600
23574,517,$MEAL3,2019-09-30,166531600,0,166531600
23574,517,$MEAL3,2019-12-31,195919530,0,195919530
23574,517,$MEAL3,2020-03-31,195919530,0,195919530
23574,517,$MEAL3,2020-06-30,195919530,0,195919530
23574,517,$MEAL3,2020-09-30,286369530,0,286369530
23590,513,$WIZS3,2014-12-31,159907,0,159907
23590,513,$WIZS3,2015-03-31,159907,0,159907
23590,513,$WIZS3,2015-06-30,159907,0,159907
23590,513,$WIZS3,2015-09-30,159907,0,159907
23590,513,$WIZS3,2015-12-31,159907,0,159907
23590,513,$WIZS3,2016-03-31,159907,0,159907
23590,513,$WIZS3,2016-06-30,159907,0,159907
23590,513,$WIZS3,2016-09-30,159907,0,159907
23590,513,$WIZS3,2016-12-31,159907282,0,159907282
23590,513,$WIZS3,2017-03-31,159907,0,159907
23590,513,$WIZS3,2017-06-30,159907,0,159907
23590,513,$WIZS3,2017-09-30,159907,0,159907
23590,513,$WIZS3,2017-12-31,159907282,0,159907282
23590,513,$WIZS3,2018-03-31,159907282,0,159907282
23590,513,$WIZS3,2018-06-30,159907282,0,159907282
23590,513,$WIZS3,2018-09-30,159907282,0,159907282
23590,513,$WIZS3,2018-12-31,159907282,0,159907282
23590,513,$WIZS3,2019-03-31,159907282,0,159907282
23590,513,$WIZS3,2019-06-30,159907282,0,159907282
23590,513,$WIZS3,2019-09-30,159907282,0,159907282
23590,513,$WIZS3,2019-12-31,159907282,0,159907282
23590,513,$WIZS3,2020-03-31,159907182,0,159907182
23590,513,$WIZS3,2020-06-30,159907282,0,159907282
23590,513,$WIZS3,2020-09-30,159907282,0,159907282
23604,516,$YOUC3,2014-12-31,17984539,44961,18029500
23604,516,$YOUC3,2015-03-31,17984539,4496134,22480673
23604,516,$YOUC3,2015-06-30,17984539,4496134,22480673
23604,516,$YOUC3,2015-09-30,17984539,4496134,22480673
23604,516,$YOUC3,2015-12-31,17984539,44961,18029500
23604,516,$YOUC3,2016-03-31,17984539,4496134,22480673
23604,516,$YOUC3,2016-06-30,17984539,4496134,22480673
23604,516,$YOUC3,2016-09-30,17984539,4496134,22480673
23604,516,$YOUC3,2016-12-31,17984539,44961,18029500
23604,516,$YOUC3,2017-03-31,4496134,17984539,22480673
23604,516,$YOUC3,2017-06-30,4496134,17984539,22480673
23604,516,$YOUC3,2017-09-30,4496134,17984539,22480673
23604,516,$YOUC3,2017-12-31,17984539,4496134,22480673
23604,516,$YOUC3,2018-03-31,17985,4496,22481
23604,516,$YOUC3,2018-06-30,17985,4496,22481
23604,516,$YOUC3,2018-09-30,17985,4496,22481
23604,516,$YOUC3,2018-12-31,17984539,4496134,22480673
23604,516,$YOUC3,2019-03-31,18406600,4496134,22902734
23604,516,$YOUC3,2019-06-30,19780763,4111889,23892652
23604,516,$YOUC3,2019-09-30,19780763,4111889,23892652
23604,516,$YOUC3,2019-12-31,32317,0,32317
23604,516,$YOUC3,2020-03-31,32317,0,32317
23604,516,$YOUC3,2020-06-30,32317,0,32317
23604,516,$YOUC3,2020-09-30,32317,0,32317
23612,514,$MSRO3,2014-12-31,1733988,0,1733988
23612,514,$MSRO3,2015-03-31,1733988,0,1733988
23612,514,$MSRO3,2015-06-30,1733988,0,1733988
23612,514,$MSRO3,2015-09-30,1733988,0,1733988
23612,514,$MSRO3,2015-12-31,1733988,0,1733988
23612,514,$MSRO3,2016-03-31,1733988,0,1733988
23612,514,$MSRO3,2016-06-30,1733988,0,1733988
23612,514,$MSRO3,2016-09-30,1733988,0,1733988
23612,514,$MSRO3,2016-12-31,1733988,0,1733988
23612,514,$MSRO3,2017-03-31,1733988,0,1733988
23612,514,$MSRO3,2017-06-30,1733988,0,1733988
23612,514,$MSRO3,2017-09-30,1733988,0,1733988
23612,514,$MSRO3,2017-12-31,1733988,0,1733988
23612,514,$MSRO3,2018-03-31,1733988,0,1733988
23612,514,$MSRO3,2018-06-30,1733988,0,1733988
23612,514,$MSRO3,2018-09-30,1733988,0,1733988
23612,514,$MSRO3,2018-12-31,1733988,0,1733988
23612,514,$MSRO3,2019-03-31,1733988,0,1733988
23612,514,$MSRO3,2019-06-30,1733988,0,1733988
23612,514,$MSRO3,2019-09-30,1733988,0,1733988
23612,514,$MSRO3,2019-12-31,1733988,0,1733988
23612,514,$MSRO3,2020-03-31,1733988,0,1733988
23612,514,$MSRO3,2020-06-30,1733988,0,1733988
23612,514,$MSRO3,2020-09-30,26009820,0,26009820
23825,518,$MOVI3,2014-12-31,600241000,0,600241000
23825,518,$MOVI3,2015-03-31,624250000,0,624250000
23825,518,$MOVI3,2015-06-30,624250000,0,624250000
23825,518,$MOVI3,2015-09-30,624250000,0,624250000
23825,518,$MOVI3,2015-12-31,624250238,0,624250238
23825,518,$MOVI3,2016-03-31,624250238,0,624250238
23825,518,$MOVI3,2016-06-30,624250238,0,624250238
23825,518,$MOVI3,2016-09-30,715629238,0,715629238
23825,518,$MOVI3,2016-12-31,715629238,0,715629238
23825,518,$MOVI3,2017-03-31,213491586,0,213491586
23825,518,$MOVI3,2017-06-30,213491586,0,213491586
23825,518,$MOVI3,2017-09-30,213491586,0,213491586
23825,518,$MOVI3,2017-12-31,213491586,0,213491586
23825,518,$MOVI3,2018-03-31,213491586,0,213491586
23825,518,$MOVI3,2018-06-30,213491586,0,213491586
23825,518,$MOVI3,2018-09-30,212846643,0,212846643
23825,518,$MOVI3,2018-12-31,263421014,0,263421014
23825,518,$MOVI3,2019-03-31,263421014,0,263421014
23825,518,$MOVI3,2019-06-30,263421014,0,263421014
23825,518,$MOVI3,2019-09-30,298921014,0,298921014
23825,518,$MOVI3,2019-12-31,298921014,0,298921014
23825,518,$MOVI3,2020-03-31,298921014,0,298921014
23825,518,$MOVI3,2020-06-30,298921014,0,298921014
23825,518,$MOVI3,2020-09-30,298921014,0,298921014
23981,520,$CTCA3,2016-03-31,760001,0,760001
23981,520,$CTCA3,2016-06-30,760001,0,760001
23981,520,$CTCA3,2016-09-30,760001,0,760001
23981,520,$CTCA3,2016-12-31,801870,0,801870
23981,520,$CTCA3,2017-03-31,801870,0,801870
23981,520,$CTCA3,2017-06-30,801870,0,801870
23981,520,$CTCA3,2017-09-30,760001,0,760001
23981,520,$CTCA3,2017-12-31,760001,0,760001
23981,520,$CTCA3,2018-03-31,760001,0,760001
23981,520,$CTCA3,2018-06-30,760001,0,760001
23981,520,$CTCA3,2018-09-30,760001,0,760001
23981,520,$CTCA3,2018-12-31,801870,0,801870
23981,520,$CTCA3,2019-03-31,801870,0,801870
23981,520,$CTCA3,2019-06-30,801870,0,801870
23981,520,$CTCA3,2019-09-30,801870,0,801870
23981,520,$CTCA3,2019-12-31,801870,0,801870
23981,520,$CTCA3,2020-03-31,801870,0,801870
23981,520,$CTCA3,2020-06-30,801870,0,801870
23981,520,$CTCA3,2020-09-30,801870,0,801870
24058,522,$AALR3,2015-12-31,49923660,49923660,99847320
24058,522,$AALR3,2016-03-31,49923660,49923660,99847320
24058,522,$AALR3,2016-06-30,49923660,49923660,99847320
24058,522,$AALR3,2016-09-30,49923660,50032820,99956480
24058,522,$AALR3,2016-12-31,114898767,0,114898767
24058,522,$AALR3,2017-03-31,114898767,0,114898767
24058,522,$AALR3,2017-06-30,118292816,0,118292816
24058,522,$AALR3,2017-09-30,118292816,0,118292816
24058,522,$AALR3,2017-12-31,118292816,0,118292816
24058,522,$AALR3,2018-03-31,118292816,0,118292816
24058,522,$AALR3,2018-06-30,118292816,0,118292816
24058,522,$AALR3,2018-09-30,118292816,0,118292816
24058,522,$AALR3,2018-12-31,118292816,0,118292816
24058,522,$AALR3,2019-03-31,118292816,0,118292816
24058,522,$AALR3,2019-06-30,118292816,0,118292816
24058,522,$AALR3,2019-09-30,118292816,0,118292816
24058,522,$AALR3,2019-12-31,118292816,0,118292816
24058,522,$AALR3,2020-03-31,118292816,0,118292816
24058,522,$AALR3,2020-06-30,118292816,0,118292816
24058,522,$AALR3,2020-09-30,118292816,0,118292816
24090,521,$PARD3,2016-03-31,3634,0,3634
24090,521,$PARD3,2016-06-30,3634,0,3634
24090,521,$PARD3,2016-09-30,3634,0,3634
24090,521,$PARD3,2016-12-31,3634,0,3634
24090,521,$PARD3,2017-03-31,130979,0,130979
24090,521,$PARD3,2017-06-30,130979,0,130979
24090,521,$PARD3,2017-09-30,130979,0,130979
24090,521,$PARD3,2017-12-31,130909,0,130909
24090,521,$PARD3,2018-03-31,130979,0,130979
24090,521,$PARD3,2018-06-30,130979,0,130979
24090,521,$PARD3,2018-09-30,130979,0,130979
24090,521,$PARD3,2018-12-31,130979,0,130979
24090,521,$PARD3,2019-03-31,130979,0,130979
24090,521,$PARD3,2019-06-30,130979,0,130979
24090,521,$PARD3,2019-09-30,130979,0,130979
24090,521,$PARD3,2019-12-31,130979,0,130979
24090,521,$PARD3,2020-03-31,130979,0,130979
24090,521,$PARD3,2020-06-30,130979,0,130979
24090,521,$PARD3,2020-09-30,130979,0,130979
24112,523,$AZUL4,2016-12-31,928965058,254571226,1183536284
24112,523,$AZUL4,2017-03-31,928965058,254571266,1183536324
24112,523,$AZUL4,2017-06-30,928965058,317571266,1246536324
24112,523,$AZUL4,2017-09-30,928965058,320086893,1249051951
24112,523,$AZUL4,2017-12-31,928965058,321650720,1250615778
24112,523,$AZUL4,2018-03-31,928965058,323965337,1252930395
24112,523,$AZUL4,2018-06-30,928965058,325992745,1254957803
24112,523,$AZUL4,2018-09-30,928965058,326063741,1255028799
24112,523,$AZUL4,2018-12-31,928965058,326631190,1255596248
24112,523,$AZUL4,2019-03-31,928965058,327175146,1256140204
24112,523,$AZUL4,2019-06-30,928965058,329115383,1258080441
24112,523,$AZUL4,2019-09-30,928965058,329359720,1258324778
24112,523,$AZUL4,2019-12-31,928965058,329568166,1258533224
24112,523,$AZUL4,2020-03-31,928965058,329703517,1258668575
24112,523,$AZUL4,2020-06-30,928965058,329703517,1258668575
24112,523,$AZUL4,2020-09-30,928965058,329904767,1258869825
24171,524,$CRFB3,2016-12-31,1775076589,0,1775076589
24171,524,$CRFB3,2017-03-31,1775076589,0,1775076589
24171,524,$CRFB3,2017-06-30,1775076589,0,1775076589
24171,524,$CRFB3,2017-09-30,1980958942,0,1980958942
24171,524,$CRFB3,2017-12-31,1980958942,0,1980958942
24171,524,$CRFB3,2018-03-31,1981709041,0,1981709041
24171,524,$CRFB3,2018-06-30,1981844854,0,1981844854
24171,524,$CRFB3,2018-09-30,1982672519,0,1982672519
24171,524,$CRFB3,2018-12-31,1983437967,0,1983437967
24171,524,$CRFB3,2019-03-31,1983527147,0,1983527147
24171,524,$CRFB3,2019-06-30,1983727443,0,1983727443
24171,524,$CRFB3,2019-09-30,1984106480,0,1984106480
24171,524,$CRFB3,2019-12-31,1984655599,0,1984655599
24171,524,$CRFB3,2020-03-31,1984942648,0,1984942648
24171,524,$CRFB3,2020-06-30,1985019050,0,1985019050
24171,524,$CRFB3,2020-09-30,1985199050,0,1985199050
24180,526,$IRBR3,2016-12-31,310698900,1,310698901
24180,526,$IRBR3,2017-03-31,310698900,1,310698901
24180,526,$IRBR3,2017-06-30,310698900,1,310698901
24180,526,$IRBR3,2017-09-30,310698900,1,310698901
24180,526,$IRBR3,2017-12-31,310415400,0,310415400
24180,526,$IRBR3,2018-03-31,310698900,0,310698900
24180,526,$IRBR3,2018-06-30,310698900,0,310698900
24180,526,$IRBR3,2018-09-30,310415400,0,310415400
24180,526,$IRBR3,2018-12-31,312000000,1,312000001
24180,526,$IRBR3,2019-03-31,312000000,1,312000001
24180,526,$IRBR3,2019-03-31,312000000,1,312000001
24180,526,$IRBR3,2019-06-30,312000000,1,312000001
24180,526,$IRBR3,2019-09-30,936000000,1,936000001
24180,526,$IRBR3,2019-12-31,936000000,1,936000001
24180,526,$IRBR3,2020-03-31,936000000,1,936000001
24180,526,$IRBR3,2020-03-31,936000000,1,936000001
24180,526,$IRBR3,2020-06-30,936000000,1,936000001
24180,526,$IRBR3,2020-09-30,1267890331,1,1267890332
24201,525,$24201A,2016-12-31,297498383,0,297498383
24201,525,$24201A,2017-03-31,297498383,0,297498383
24201,525,$24201A,2017-06-30,297498383,0,297498383
24201,525,$24201A,2017-09-30,297498383,0,297498383
24201,525,$24201A,2017-12-31,297498383,0,297498383
24201,525,$24201A,2018-03-31,297498383,0,297498383
24201,525,$24201A,2018-06-30,297498383,0,297498383
24201,525,$24201A,2018-09-30,297498383,0,297498383
24201,525,$24201A,2018-12-31,297498383,0,297498383
24201,525,$24201A,2019-03-31,297498383,0,297498383
24201,525,$24201A,2019-06-30,297498383,0,297498383
24201,525,$24201A,2019-09-30,297498383,0,297498383
24201,525,$24201A,2019-12-31,297498383,0,297498383
24201,525,$24201A,2020-03-31,297498383,0,297498383
24201,525,$24201A,2020-06-30,297498383,0,297498383
24201,525,$24201A,2020-09-30,297498383,0,297498383
24228,527,$CAML3,2017-02-28,123017292,0,123017292
24228,527,$CAML3,2017-05-31,123017292,0,123017292
24228,527,$CAML3,2017-08-31,369051876,0,369051876
24228,527,$CAML3,2017-11-30,410051876,0,410051876
24228,527,$CAML3,2018-02-28,410051876,0,410051876
24228,527,$CAML3,2018-05-31,410051876,0,410051876
24228,527,$CAML3,2018-08-31,410051876,0,410051876
24228,527,$CAML3,2018-11-30,410051876,0,410051876
24228,527,$CAML3,2019-02-28,410051876,0,410051876
24228,527,$CAML3,2019-05-31,410051876,0,410051876
24228,527,$CAML3,2019-08-31,410051876,0,410051876
24228,527,$CAML3,2019-11-30,370000000,0,370000000
24228,527,$CAML3,2020-02-29,370000000,0,370000000
24228,527,$CAML3,2020-05-31,370000000,0,370000000
24228,527,$CAML3,2020-08-31,370000000,0,370000000
24236,528,$PRNR3,2016-12-31,93077010,0,93077010
24236,528,$PRNR3,2017-03-31,93077010,0,93077010
24236,528,$PRNR3,2017-06-30,93077010,0,93077010
24236,528,$PRNR3,2017-09-30,93077010,0,93077010
24236,528,$PRNR3,2017-12-31,93708314,0,93708314
24236,528,$PRNR3,2018-03-31,93708314,0,93708314
24236,528,$PRNR3,2018-06-30,104873362,0,104873362
24236,528,$PRNR3,2018-09-30,104873362,0,104873362
24236,528,$PRNR3,2018-12-31,104873362,0,104873362
24236,528,$PRNR3,2019-03-31,104873362,0,104873362
24236,528,$PRNR3,2019-06-30,104873362,0,104873362
24236,528,$PRNR3,2019-09-30,104873362,0,104873362
24236,528,$PRNR3,2019-12-31,20653497,0,20653497
24236,528,$PRNR3,2020-03-31,38044801,0,38044801
24236,528,$PRNR3,2020-06-30,38044801,0,38044801
24236,528,$PRNR3,2020-09-30,38748616,0,38748616
24252,529,$SMLS3,2016-12-31,475477090,0,475477090
24252,529,$SMLS3,2017-03-31,475477090,0,475477090
24252,529,$SMLS3,2017-06-30,1,0,1
24252,529,$SMLS3,2017-09-30,123856953,0,123856953
24252,529,$SMLS3,2017-12-31,123856953,0,123856953
24252,529,$SMLS3,2018-03-31,124007953,0,124007953
24252,529,$SMLS3,2018-06-30,124007953,0,124007953
24252,529,$SMLS3,2018-09-30,124007953,0,124007953
24252,529,$SMLS3,2018-12-31,124007953,0,124007953
24252,529,$SMLS3,2019-03-31,124158953,0,124158953
24252,529,$SMLS3,2019-06-30,124158953,0,124158953
24252,529,$SMLS3,2019-09-30,124158953,0,124158953
24252,529,$SMLS3,2019-12-31,124158953,0,124158953
24252,529,$SMLS3,2020-03-31,124158953,0,124158953
24252,529,$SMLS3,2020-06-30,124158953,0,124158953
24252,529,$SMLS3,2020-09-30,124158953,0,124158953
24260,531,$SMFT,2016-12-31,11058,3552,14610
24260,531,$SMFT,2017-03-31,11058,3552,14610
24260,531,$SMFT,2017-06-30,11058,3552,14610
24260,531,$SMFT,2017-09-30,11058,3552,14610
24260,531,$SMFT,2017-12-31,11058,3552,14610
24260,531,$SMFT,2018-03-31,11058,4311,15369
24260,531,$SMFT,2018-06-30,11058,4054,15112
24260,531,$SMFT,2018-09-30,11058,5144,16202
24260,531,$SMFT,2018-12-31,11058,7314,18372
24260,531,$SMFT,2019-03-31,11058,7314,18372
24260,531,$SMFT,2019-06-30,11058,7146,18204
24260,531,$SMFT,2019-09-30,11058,7146,18204
24260,531,$SMFT,2019-12-31,14602,6464,21066
24260,531,$SMFT,2020-03-31,14712,6464,21176
24260,531,$SMFT,2020-06-30,14602,6464,21066
24260,531,$SMFT,2020-09-30,14602,6464,21066
24260,609,$SMFT3,2016-12-31,11058,3552,14610
24260,609,$SMFT3,2017-03-31,11058,3552,14610
24260,609,$SMFT3,2017-06-30,11058,3552,14610
24260,609,$SMFT3,2017-09-30,11058,3552,14610
24260,609,$SMFT3,2017-12-31,11058,3552,14610
24260,609,$SMFT3,2018-03-31,11058,4311,15369
24260,609,$SMFT3,2018-06-30,11058,4054,15112
24260,609,$SMFT3,2018-09-30,11058,5144,16202
24260,609,$SMFT3,2018-12-31,11058,7314,18372
24260,609,$SMFT3,2019-03-31,11058,7314,18372
24260,609,$SMFT3,2019-06-30,11058,7146,18204
24260,609,$SMFT3,2019-09-30,11058,7146,18204
24260,609,$SMFT3,2019-12-31,14602,6464,21066
24260,609,$SMFT3,2020-03-31,14712,6464,21176
24260,609,$SMFT3,2020-06-30,14602,6464,21066
24260,609,$SMFT3,2020-09-30,14602,6464,21066
24279,532,$INNT3,2016-12-31,12371189,0,12371189
24279,532,$INNT3,2017-03-31,12371189,0,12371189
24279,532,$INNT3,2017-06-30,12371189,0,12371189
24279,532,$INNT3,2017-09-30,12371189,0,12371189
24279,532,$INNT3,2017-12-31,12371189,0,12371189
24279,532,$INNT3,2018-03-31,12371189,0,12371189
24279,532,$INNT3,2018-06-30,20060181,0,20060181
24279,532,$INNT3,2018-09-30,20060081,0,20060081
24279,532,$INNT3,2018-12-31,20260784,0,20260784
24279,532,$INNT3,2019-03-31,50651956,0,50651956
24279,532,$INNT3,2019-06-30,50651956,0,50651956
24279,532,$INNT3,2019-09-30,50651956,0,50651956
24279,532,$INNT3,2019-12-31,50651957,0,50651957
24279,532,$INNT3,2020-03-31,86885350,0,86885350
24279,532,$INNT3,2020-06-30,86885350,0,86885350
24279,532,$INNT3,2020-09-30,86885350,0,86885350
24295,534,$BRDT3,2016-12-31,1165000,0,1165000
24295,534,$BRDT3,2017-03-31,1165000,0,1165000
24295,534,$BRDT3,2017-06-30,1165000,0,1165000
24295,534,$BRDT3,2017-09-30,1165000,0,1165000
24295,534,$BRDT3,2017-12-31,1165000,0,1165000
24295,534,$BRDT3,2018-03-31,1165000,0,1165000
24295,534,$BRDT3,2018-06-30,1165000,0,1165000
24295,534,$BRDT3,2018-09-30,1165000,0,1165000
24295,534,$BRDT3,2018-12-31,1165000,0,1165000
24295,534,$BRDT3,2019-03-31,1165000,0,1165000
24295,534,$BRDT3,2019-06-30,1165000,0,1165000
24295,534,$BRDT3,2019-09-30,1165000,0,1165000
24295,534,$BRDT3,2019-12-31,1165000,0,1165000
24295,534,$BRDT3,2020-03-31,1165000,0,1165000
24295,534,$BRDT3,2020-06-30,1165000,0,1165000
24295,534,$BRDT3,2020-09-30,1165000,0,1165000
24317,533,$BKBR3,2016-12-31,114706400,20674200,135380600
24317,533,$BKBR3,2017-03-31,114706400,20674200,135380600
24317,533,$BKBR3,2017-06-30,120713800,20674200,141388000
24317,533,$BKBR3,2017-09-30,120713800,36179800,156893600
24317,533,$BKBR3,2017-12-31,222278169,0,222278169
24317,533,$BKBR3,2018-03-31,222278169,0,222278169
24317,533,$BKBR3,2018-06-30,222278169,0,222278169
24317,533,$BKBR3,2018-09-30,222525821,0,222525821
24317,533,$BKBR3,2018-12-31,222525821,0,222525821
24317,533,$BKBR3,2019-03-31,227074970,0,227074970
24317,533,$BKBR3,2019-06-30,227381070,0,227381070
24317,533,$BKBR3,2019-09-30,228105447,0,228105447
24317,533,$BKBR3,2019-12-31,228105447,0,228105447
24317,533,$BKBR3,2020-03-31,228105447,0,228105447
24317,533,$BKBR3,2020-06-30,228105447,0,228105447
24317,533,$BKBR3,2020-09-30,228105447,0,228105447
24350,535,$FLEX,2016-12-31,3141,0,3141
24350,535,$FLEX,2017-03-31,3141,0,3141
24350,535,$FLEX,2017-06-30,3141,0,3141
24350,535,$FLEX,2017-09-30,3248,0,3248
24350,535,$FLEX,2017-12-31,3248,0,3248
24350,535,$FLEX,2018-03-31,3248,0,3248
24350,535,$FLEX,2018-06-30,3248,0,3248
24350,535,$FLEX,2018-09-30,3248,0,3248
24350,535,$FLEX,2018-12-31,3248,0,3248
24350,535,$FLEX,2019-03-31,3248,0,3248
24350,535,$FLEX,2019-06-30,3248,0,3248
24350,535,$FLEX,2019-09-30,3248,0,3248
24350,535,$FLEX,2019-12-31,3248,0,3248
24350,535,$FLEX,2020-03-31,3248,0,3248
24350,535,$FLEX,2020-06-30,3248,0,3248
24350,535,$FLEX,2020-09-30,3248,0,3248
24384,536,$GNDI3,2017-12-31,467591549,0,467591549
24384,536,$GNDI3,2018-03-31,467591549,0,467591549
24384,536,$GNDI3,2018-06-30,488281204,0,488281204
24384,536,$GNDI3,2018-09-30,488281204,0,488281204
24384,536,$GNDI3,2018-12-31,528783790,0,528783790
24384,536,$GNDI3,2019-03-31,528783790,0,528783790
24384,536,$GNDI3,2019-06-30,528783790,0,528783790
24384,536,$GNDI3,2019-09-30,528475691,0,528475691
24384,536,$GNDI3,2019-12-31,603385083,0,603385083
24384,536,$GNDI3,2020-03-31,603385083,0,603385083
24384,536,$GNDI3,2020-06-30,603385083,0,603385083
24384,536,$GNDI3,2020-09-30,609479408,0,609479408
24392,539,$HAPV3,2017-12-31,560000000,0,560000000
24392,539,$HAPV3,2018-03-31,560000000,0,560000000
24392,539,$HAPV3,2018-06-30,671958573,0,671958573
24392,539,$HAPV3,2018-09-30,671958573,0,671958573
24392,539,$HAPV3,2018-12-31,671958573,0,671958573
24392,539,$HAPV3,2019-03-31,671958573,0,671958573
24392,539,$HAPV3,2019-06-30,671958573,0,671958573
24392,539,$HAPV3,2019-09-30,734652573,0,734652573
24392,539,$HAPV3,2019-12-31,742985906,0,742985906
24392,539,$HAPV3,2020-03-31,742985906,0,742985906
24392,539,$HAPV3,2020-06-30,742985906,0,742985906
24392,539,$HAPV3,2020-09-30,742985906,0,742985906
24406,537,$BIDI4,2017-12-31,6030415,5867641,11898056
24406,537,$BIDI4,2018-03-31,46402418,24985918,71388336
24406,537,$BIDI4,2018-06-30,50341992,49784638,100126630
24406,537,$BIDI4,2018-09-30,50767085,50643959,101411044
24406,537,$BIDI4,2018-12-31,50767085,50643959,101411044
24406,537,$BIDI4,2019-03-31,50767085,50643959,101411044
24406,537,$BIDI4,2019-06-30,50767085,50767082,101534167
24406,537,$BIDI4,2019-09-30,364451252,338353750,702805002
24406,537,$BIDI4,2019-12-31,365244096,339939438,705183534
24406,537,$BIDI4,2020-03-31,365833928,341119102,706953030
24406,537,$BIDI4,2020-06-30,365833928,341119102,706953030
24406,537,$BIDI4,2020-09-30,382116929,378322416,760439345
24406,540,$BIDI3,2017-12-31,6030415,5867641,11898056
24406,540,$BIDI3,2018-03-31,46402418,24985918,71388336
24406,540,$BIDI3,2018-06-30,50341992,49784638,100126630
24406,540,$BIDI3,2018-09-30,50767085,50643959,101411044
24406,540,$BIDI3,2018-12-31,50767085,50643959,101411044
24406,540,$BIDI3,2019-03-31,50767085,50643959,101411044
24406,540,$BIDI3,2019-06-30,50767085,50767082,101534167
24406,540,$BIDI3,2019-09-30,364451252,338353750,702805002
24406,540,$BIDI3,2019-12-31,365244096,339939438,705183534
24406,540,$BIDI3,2020-03-31,365833928,341119102,706953030
24406,540,$BIDI3,2020-06-30,365833928,341119102,706953030
24406,540,$BIDI3,2020-09-30,382116929,378322416,760439345
24406,604,$BIDI11,2017-12-31,6030415,5867641,11898056
24406,604,$BIDI11,2018-03-31,46402418,24985918,71388336
24406,604,$BIDI11,2018-06-30,50341992,49784638,100126630
24406,604,$BIDI11,2018-09-30,50767085,50643959,101411044
24406,604,$BIDI11,2018-12-31,50767085,50643959,101411044
24406,604,$BIDI11,2019-03-31,50767085,50643959,101411044
24406,604,$BIDI11,2019-06-30,50767085,50767082,101534167
24406,604,$BIDI11,2019-09-30,364451252,338353750,702805002
24406,604,$BIDI11,2019-12-31,365244096,339939438,705183534
24406,604,$BIDI11,2020-03-31,365833928,341119102,706953030
24406,604,$BIDI11,2020-06-30,365833928,341119102,706953030
24406,604,$BIDI11,2020-09-30,382116929,378322416,760439345
24546,542,$PTCA3,2018-09-30,3355031,373242,3728273
24546,542,$PTCA3,2018-12-31,3355031,373242,3728273
24546,542,$PTCA3,2019-03-31,3355031,373242,3728273
24546,542,$PTCA3,2019-06-30,3355031,373242,3728273
24546,542,$PTCA3,2019-09-30,3355031,373242,3728273
24546,542,$PTCA3,2019-12-31,3355031,373242,3728273
24546,542,$PTCA3,2020-03-31,3355031,373242,3728273
24546,542,$PTCA3,2020-06-30,3355031,373242,3728273
24546,542,$PTCA3,2020-09-30,3355031,373242,3728273
24546,543,$PTCA4,2018-09-30,3355031,373242,3728273
24546,543,$PTCA4,2018-12-31,3355031,373242,3728273
24546,543,$PTCA4,2019-03-31,3355031,373242,3728273
24546,543,$PTCA4,2019-06-30,3355031,373242,3728273
24546,543,$PTCA4,2019-09-30,3355031,373242,3728273
24546,543,$PTCA4,2019-12-31,3355031,373242,3728273
24546,543,$PTCA4,2020-03-31,3355031,373242,3728273
24546,543,$PTCA4,2020-06-30,3355031,373242,3728273
24546,543,$PTCA4,2020-09-30,3355031,373242,3728273
24546,544,$PTCA11,2018-09-30,3355031,373242,3728273
24546,544,$PTCA11,2018-12-31,3355031,373242,3728273
24546,544,$PTCA11,2019-03-31,3355031,373242,3728273
24546,544,$PTCA11,2019-06-30,3355031,373242,3728273
24546,544,$PTCA11,2019-09-30,3355031,373242,3728273
24546,544,$PTCA11,2019-12-31,3355031,373242,3728273
24546,544,$PTCA11,2020-03-31,3355031,373242,3728273
24546,544,$PTCA11,2020-06-30,3355031,373242,3728273
24546,544,$PTCA11,2020-09-30,3355031,373242,3728273
24600,549,$BMGB4,2018-12-31,400007354,100000000,500007354
24600,549,$BMGB4,2019-03-31,400007354,100000000,500007354
24600,549,$BMGB4,2019-06-30,400007354,100000000,500007354
24600,549,$BMGB4,2019-09-30,400007354,100000000,500007354
24600,549,$BMGB4,2019-12-31,400007354,203448277,603455631
24600,549,$BMGB4,2020-03-31,400007354,191467177,591474531
24600,549,$BMGB4,2020-06-30,400007354,191467177,591474531
24600,549,$BMGB4,2020-09-30,400007354,191467177,591474531
24694,546,$CNTO3,2019-03-31,153035846,0,153035846
24694,546,$CNTO3,2019-06-30,210140608,0,210140608
24694,546,$CNTO3,2019-09-30,210140608,0,210140608
24694,546,$CNTO3,2019-12-31,210140608,0,210140608
24694,546,$CNTO3,2020-03-31,241015279,0,241015279
24694,546,$CNTO3,2020-06-30,241784625,0,241784625
24694,546,$CNTO3,2020-09-30,241808625,0,241808625
24759,550,$LTLA,2019-09-30,196713,0,196713
24759,550,$LTLA,2019-12-31,196713,0,196713
24759,550,$LTLA,2020-03-31,196713,0,196713
24759,550,$LTLA,2020-06-30,196713,0,196713
24759,550,$LTLA,2020-09-30,196713,0,196713
24783,551,$NTCO3,2019-09-30,100,0,100
24783,551,$NTCO3,2019-12-31,865659,0,865659
24783,551,$NTCO3,2020-03-31,1188271,0,1188271
24783,551,$NTCO3,2020-06-30,1251240,0,1251240
24783,551,$NTCO3,2020-09-30,1253618,0,1253618
24805,552,$VIVA3,2019-09-30,217303107,0,217303107
24805,552,$VIVA3,2019-12-31,236197769,0,236197769
24805,552,$VIVA3,2020-03-31,236197769,0,236197769
24805,552,$VIVA3,2020-06-30,236197769,0,236197769
24805,552,$VIVA3,2020-09-30,236197769,0,236197769
24848,553,$CEAB3,2019-03-31,1035720,0,1035720
24848,553,$CEAB3,2019-09-30,1035720,0,1035720
24848,553,$CEAB3,2019-12-31,308245068,0,308245068
24848,553,$CEAB3,2020-03-31,308245068,0,308245068
24848,553,$CEAB3,2020-06-30,308245068,0,308245068
24848,553,$CEAB3,2020-09-30,308245068,0,308245068
24902,556,$MTRE3,2019-12-31,56100,0,56100
24902,556,$MTRE3,2020-03-31,105774820,0,105774820
24902,556,$MTRE3,2020-06-30,105774820,0,105774820
24902,556,$MTRE3,2020-09-30,105774820,0,105774820
24910,555,$LWSA3,2019-12-31,91596653,0,91596653
24910,555,$LWSA3,2020-03-31,125172486,0,125172486
24910,555,$LWSA3,2020-06-30,125172486,0,125172486
24910,555,$LWSA3,2020-09-30,125890296,0,125890296
24961,557,$AMBP3,2020-03-31,69202254,0,69202254
24961,557,$AMBP3,2020-06-30,69202254,0,69202254
24961,557,$AMBP3,2020-09-30,112935588,0,112935588
25003,592,$SIMH3,2020-06-30,107491070,0,107491070
25003,592,$SIMH3,2020-09-30,206032081,0,206032081
25038,426,$LJQQ3,2020-06-30,148109,0,148109
25038,426,$LJQQ3,2020-09-30,187290,0,187290
25046,425,$DMVF3,2019-12-31,675473,0,675473
25046,425,$DMVF3,2020-06-30,676666,0,676666
25046,425,$DMVF3,2020-09-30,50602,0,50602
25062,596,$LAVV3,2020-09-30,214628652,0,214628652
25070,611,$PLPL3,2020-09-30,204256,0,204256
25089,597,$PETZ3,2020-09-30,372856,0,372856
25100,594,$CURY3,2020-09-30,291875088,0,291875088
25119,595,$MELK3,2020-09-30,207969341,0,207969341
25232,600,$CASH3,2020-09-30,92965249,0,92965249
25283,599,$AERI3,2020-09-30,615828842,0,615828842
90581,554,$0000,2018-12-31,1000,0,1000
90581,554,$0000,2018-12-31,23351,0,23351
90581,554,$0000,2019-03-31,1000,0,1000
90581,554,$0000,2019-03-31,26084,0,26084
90581,554,$0000,2019-06-30,26084,0,26084
90581,554,$0000,2019-09-30,56100,0,56100
